ID,Флаг дозвона,Флаг продажи,Расходы,PV,NPV
0,1,0,80,0,-80
1,0,0,3,0,-3
2,0,0,49,0,-49
3,1,1,1429,1275,-154
4,1,1,190,1571,1381
5,1,1,417,1273,856
6,0,0,4,0,-4
7,1,0,94,0,-94
8,1,0,78,0,-78
9,0,0,119,0,-119
10,0,0,20,0,-20
11,1,1,648,1383,735
12,1,1,617,1221,604
13,0,0,28,0,-28
14,1,0,78,0,-78
15,1,0,55,0,-55
16,1,1,851,1223,372
17,1,0,101,0,-101
18,0,0,43,0,-43
19,1,0,54,0,-54
20,1,0,115,0,-115
21,1,0,5,0,-5
22,0,0,3,0,-3
23,1,0,53,0,-53
24,1,0,1,0,-1
25,1,1,558,1210,652
26,1,1,254,1660,1406
27,1,0,77,0,-77
28,1,0,4,0,-4
29,1,1,787,1380,593
30,0,0,2,0,-2
31,1,0,14,0,-14
32,0,0,30,0,-30
33,1,1,829,1685,856
34,0,0,44,0,-44
35,1,1,374,1265,891
36,1,1,815,1978,1163
37,1,0,60,0,-60
38,1,0,9,0,-9
39,1,1,252,1507,1255
40,0,0,171,0,-171
41,1,1,1067,1459,392
42,1,1,2029,1215,-814
43,0,0,16,0,-16
44,1,0,5,0,-5
45,1,0,84,0,-84
46,0,0,53,0,-53
47,1,1,425,1320,895
48,1,0,17,0,-17
49,1,1,693,3362,2669
50,0,0,26,0,-26
51,0,0,57,0,-57
52,1,0,42,0,-42
53,0,0,82,0,-82
54,0,0,44,0,-44
55,1,1,451,1320,869
56,1,1,207,1781,1574
57,0,0,72,0,-72
58,0,0,24,0,-24
59,1,0,127,0,-127
60,0,0,67,0,-67
61,1,0,25,0,-25
62,0,0,8,0,-8
63,0,0,17,0,-17
64,1,1,218,1202,984
65,0,0,1,0,-1
66,0,0,62,0,-62
67,1,1,271,1306,1035
68,1,1,451,1203,752
69,1,1,257,1226,969
70,1,0,194,0,-194
71,1,1,502,1276,774
72,1,0,40,0,-40
73,1,0,27,0,-27
74,1,0,13,0,-13
75,1,0,4,0,-4
76,1,0,3,0,-3
77,1,1,261,1321,1060
78,1,1,162,1947,1785
79,1,1,875,1280,405
80,0,0,27,0,-27
81,1,1,518,1561,1043
82,1,0,15,0,-15
83,1,0,5,0,-5
84,0,0,6,0,-6
85,1,0,12,0,-12
86,0,0,72,0,-72
87,1,1,187,1263,1076
88,0,0,40,0,-40
89,0,0,36,0,-36
90,1,0,16,0,-16
91,1,1,271,1205,934
92,1,0,30,0,-30
93,0,0,130,0,-130
94,0,0,26,0,-26
95,0,0,49,0,-49
96,1,1,950,1657,707
97,0,0,33,0,-33
98,1,0,35,0,-35
99,0,0,10,0,-10
100,0,0,8,0,-8
101,0,0,10,0,-10
102,1,1,369,1311,942
103,1,0,2,0,-2
104,1,1,188,1250,1062
105,1,0,8,0,-8
106,0,0,55,0,-55
107,1,0,18,0,-18
108,1,0,18,0,-18
109,1,0,39,0,-39
110,1,0,37,0,-37
111,0,0,28,0,-28
112,1,0,17,0,-17
113,1,0,65,0,-65
114,1,0,119,0,-119
115,0,0,33,0,-33
116,1,0,19,0,-19
117,0,0,350,0,-350
118,1,1,274,1752,1478
119,1,0,9,0,-9
120,1,1,529,1774,1245
121,1,1,671,1259,588
122,1,0,84,0,-84
123,1,1,567,1269,702
124,1,1,390,1295,905
125,0,0,32,0,-32
126,0,0,38,0,-38
127,0,0,23,0,-23
128,1,0,24,0,-24
129,0,0,0,0,0
130,0,0,40,0,-40
131,1,0,226,0,-226
132,0,0,5,0,-5
133,1,1,482,1711,1229
134,0,0,53,0,-53
135,1,1,122,1236,1114
136,1,1,980,1332,352
137,0,0,9,0,-9
138,0,0,24,0,-24
139,1,1,192,1320,1128
140,1,0,23,0,-23
141,1,1,345,1330,985
142,1,0,1,0,-1
143,1,0,4,0,-4
144,1,0,3,0,-3
145,0,0,16,0,-16
146,1,0,100,0,-100
147,1,0,120,0,-120
148,0,0,47,0,-47
149,0,0,66,0,-66
150,1,0,109,0,-109
151,0,0,12,0,-12
152,1,0,164,0,-164
153,1,1,416,1316,900
154,1,1,48,1425,1377
155,0,0,209,0,-209
156,1,1,2034,1203,-831
157,0,0,6,0,-6
158,0,0,15,0,-15
159,1,0,3,0,-3
160,1,0,30,0,-30
161,1,1,863,2315,1452
162,0,0,72,0,-72
163,0,0,57,0,-57
164,1,0,132,0,-132
165,0,0,164,0,-164
166,0,0,169,0,-169
167,0,0,102,0,-102
168,1,1,808,1261,453
169,1,1,910,1776,866
170,1,0,15,0,-15
171,1,0,2,0,-2
172,1,1,617,1351,734
173,1,0,69,0,-69
174,0,0,54,0,-54
175,0,0,181,0,-181
176,1,1,49,1548,1499
177,0,0,128,0,-128
178,0,0,30,0,-30
179,1,0,29,0,-29
180,1,0,13,0,-13
181,1,1,217,1717,1500
182,1,1,329,1202,873
183,0,0,18,0,-18
184,1,1,690,1267,577
185,1,1,274,1510,1236
186,0,0,7,0,-7
187,1,0,150,0,-150
188,0,0,8,0,-8
189,1,0,37,0,-37
190,1,0,58,0,-58
191,1,0,136,0,-136
192,1,0,25,0,-25
193,1,0,2,0,-2
194,1,1,121,1208,1087
195,1,1,284,2417,2133
196,0,0,17,0,-17
197,0,0,44,0,-44
198,1,1,43,1344,1301
199,1,0,100,0,-100
200,1,0,95,0,-95
201,1,0,33,0,-33
202,1,1,188,2333,2145
203,1,0,2,0,-2
204,1,1,435,1389,954
205,0,0,46,0,-46
206,0,0,5,0,-5
207,1,0,25,0,-25
208,1,1,213,1217,1004
209,1,0,31,0,-31
210,1,0,71,0,-71
211,0,0,47,0,-47
212,1,1,632,1262,630
213,1,1,125,1288,1163
214,0,0,2,0,-2
215,0,0,13,0,-13
216,1,1,934,1847,913
217,0,0,110,0,-110
218,1,0,27,0,-27
219,1,0,131,0,-131
220,1,1,682,1852,1170
221,0,0,25,0,-25
222,1,0,36,0,-36
223,1,1,237,1911,1674
224,0,0,20,0,-20
225,1,1,463,1719,1256
226,1,0,6,0,-6
227,1,0,32,0,-32
228,0,0,7,0,-7
229,1,1,259,1369,1110
230,1,1,424,1343,919
231,1,0,0,0,0
232,1,1,357,2054,1697
233,1,0,73,0,-73
234,0,0,97,0,-97
235,0,0,33,0,-33
236,1,0,90,0,-90
237,1,1,473,1617,1144
238,1,0,47,0,-47
239,1,0,128,0,-128
240,0,0,10,0,-10
241,1,1,126,1296,1170
242,1,1,622,1347,725
243,0,0,19,0,-19
244,0,0,62,0,-62
245,1,1,478,1308,830
246,1,1,642,1378,736
247,1,0,6,0,-6
248,1,0,26,0,-26
249,0,0,62,0,-62
250,1,0,8,0,-8
251,0,0,58,0,-58
252,1,1,152,1316,1164
253,0,0,11,0,-11
254,1,1,236,1332,1096
255,1,0,214,0,-214
256,0,0,169,0,-169
257,0,0,13,0,-13
258,0,0,81,0,-81
259,1,0,74,0,-74
260,0,0,116,0,-116
261,1,0,179,0,-179
262,1,1,273,1350,1077
263,1,1,235,1530,1295
264,1,1,810,2237,1427
265,1,0,74,0,-74
266,1,1,833,1294,461
267,1,0,18,0,-18
268,1,1,885,1409,524
269,0,0,83,0,-83
270,0,0,35,0,-35
271,1,0,38,0,-38
272,1,0,219,0,-219
273,1,0,1,0,-1
274,1,1,1163,1345,182
275,1,1,343,1783,1440
276,1,1,377,2000,1623
277,1,0,0,0,0
278,0,0,56,0,-56
279,1,0,44,0,-44
280,1,0,139,0,-139
281,0,0,161,0,-161
282,0,0,11,0,-11
283,1,0,296,0,-296
284,0,0,53,0,-53
285,1,0,145,0,-145
286,1,1,214,1596,1382
287,1,0,57,0,-57
288,1,0,1,0,-1
289,0,0,86,0,-86
290,0,0,56,0,-56
291,1,0,68,0,-68
292,0,0,9,0,-9
293,1,1,121,1396,1275
294,1,1,207,2182,1975
295,1,0,1,0,-1
296,0,0,0,0,0
297,1,0,116,0,-116
298,1,0,12,0,-12
299,0,0,160,0,-160
300,1,0,25,0,-25
301,0,0,3,0,-3
302,1,1,151,1222,1071
303,1,0,70,0,-70
304,0,0,5,0,-5
305,0,0,80,0,-80
306,0,0,40,0,-40
307,1,0,4,0,-4
308,1,0,48,0,-48
309,0,0,85,0,-85
310,0,0,23,0,-23
311,1,0,45,0,-45
312,1,1,760,1457,697
313,1,0,11,0,-11
314,1,0,132,0,-132
315,1,0,23,0,-23
316,0,0,8,0,-8
317,1,0,78,0,-78
318,0,0,9,0,-9
319,1,1,277,1655,1378
320,0,0,47,0,-47
321,0,0,24,0,-24
322,1,0,6,0,-6
323,0,0,78,0,-78
324,1,0,198,0,-198
325,1,0,13,0,-13
326,1,0,21,0,-21
327,1,0,69,0,-69
328,1,1,458,1373,915
329,1,1,418,1847,1429
330,1,0,312,0,-312
331,1,0,25,0,-25
332,0,0,56,0,-56
333,0,0,120,0,-120
334,1,1,185,1730,1545
335,1,1,386,1224,838
336,0,0,30,0,-30
337,0,0,15,0,-15
338,1,0,4,0,-4
339,1,0,4,0,-4
340,0,0,124,0,-124
341,0,0,31,0,-31
342,1,0,162,0,-162
343,0,0,21,0,-21
344,1,1,1471,1348,-123
345,1,1,824,1277,453
346,0,0,61,0,-61
347,0,0,26,0,-26
348,1,0,30,0,-30
349,1,0,135,0,-135
350,0,0,27,0,-27
351,1,1,216,1876,1660
352,1,0,103,0,-103
353,1,1,336,1329,993
354,0,0,82,0,-82
355,1,0,40,0,-40
356,0,0,11,0,-11
357,1,1,1016,1602,586
358,1,0,12,0,-12
359,0,0,9,0,-9
360,0,0,16,0,-16
361,1,1,126,1357,1231
362,0,0,17,0,-17
363,1,0,19,0,-19
364,0,0,17,0,-17
365,1,1,2019,1273,-746
366,0,0,49,0,-49
367,1,1,40,1205,1165
368,1,1,364,1375,1011
369,1,1,354,1218,864
370,0,0,41,0,-41
371,0,0,47,0,-47
372,1,0,9,0,-9
373,1,0,10,0,-10
374,1,0,39,0,-39
375,0,0,60,0,-60
376,0,0,21,0,-21
377,0,0,23,0,-23
378,1,1,127,1387,1260
379,0,0,10,0,-10
380,0,0,48,0,-48
381,1,1,477,1234,757
382,1,0,72,0,-72
383,0,0,173,0,-173
384,1,0,106,0,-106
385,0,0,8,0,-8
386,0,0,5,0,-5
387,0,0,18,0,-18
388,0,0,66,0,-66
389,0,0,177,0,-177
390,1,0,31,0,-31
391,0,0,1,0,-1
392,1,0,166,0,-166
393,0,0,39,0,-39
394,1,1,107,1450,1343
395,1,1,373,1229,856
396,0,0,29,0,-29
397,1,1,170,2290,2120
398,0,0,85,0,-85
399,1,1,395,1224,829
400,1,0,58,0,-58
401,0,0,97,0,-97
402,0,0,40,0,-40
403,0,0,10,0,-10
404,1,0,23,0,-23
405,0,0,118,0,-118
406,0,0,30,0,-30
407,1,0,25,0,-25
408,0,0,57,0,-57
409,1,0,21,0,-21
410,1,0,33,0,-33
411,1,1,1068,1270,202
412,1,1,192,1269,1077
413,1,0,96,0,-96
414,1,1,797,1324,527
415,1,0,42,0,-42
416,1,0,170,0,-170
417,0,0,38,0,-38
418,1,1,134,1746,1612
419,1,1,676,1245,569
420,0,0,64,0,-64
421,1,0,117,0,-117
422,1,0,1,0,-1
423,1,1,848,2149,1301
424,1,0,127,0,-127
425,1,0,4,0,-4
426,0,0,249,0,-249
427,0,0,7,0,-7
428,1,0,38,0,-38
429,0,0,58,0,-58
430,1,1,247,1744,1497
431,0,0,117,0,-117
432,0,0,230,0,-230
433,1,0,116,0,-116
434,0,0,53,0,-53
435,0,0,59,0,-59
436,1,1,649,1265,616
437,0,0,25,0,-25
438,0,0,9,0,-9
439,1,0,41,0,-41
440,0,0,74,0,-74
441,1,1,118,1304,1186
442,0,0,9,0,-9
443,1,0,8,0,-8
444,0,0,44,0,-44
445,1,1,236,1245,1009
446,0,0,4,0,-4
447,0,0,31,0,-31
448,0,0,19,0,-19
449,1,0,20,0,-20
450,1,0,48,0,-48
451,1,1,477,1521,1044
452,0,0,102,0,-102
453,1,1,931,1228,297
454,0,0,48,0,-48
455,1,0,128,0,-128
456,1,1,69,1486,1417
457,1,1,788,1387,599
458,1,0,27,0,-27
459,0,0,18,0,-18
460,0,0,28,0,-28
461,1,1,173,2289,2116
462,1,1,106,1487,1381
463,1,1,473,1786,1313
464,0,0,5,0,-5
465,1,1,178,1891,1713
466,1,0,9,0,-9
467,1,1,129,1370,1241
468,0,0,38,0,-38
469,0,0,67,0,-67
470,1,1,665,1349,684
471,0,0,43,0,-43
472,1,1,1312,1348,36
473,1,0,59,0,-59
474,1,0,32,0,-32
475,1,0,5,0,-5
476,0,0,24,0,-24
477,0,0,111,0,-111
478,0,0,134,0,-134
479,1,1,471,2568,2097
480,0,0,44,0,-44
481,1,1,2059,1407,-652
482,0,0,35,0,-35
483,1,0,99,0,-99
484,0,0,76,0,-76
485,0,0,34,0,-34
486,1,0,21,0,-21
487,1,0,22,0,-22
488,0,0,8,0,-8
489,1,0,5,0,-5
490,1,1,87,1316,1229
491,0,0,34,0,-34
492,1,1,238,1246,1008
493,0,0,130,0,-130
494,1,1,188,1290,1102
495,1,1,1395,1875,480
496,1,1,446,1360,914
497,1,1,193,1539,1346
498,0,0,0,0,0
499,1,0,51,0,-51
500,1,0,4,0,-4
501,1,1,214,1448,1234
502,1,0,157,0,-157
503,1,0,13,0,-13
504,1,0,62,0,-62
505,1,0,3,0,-3
506,0,0,64,0,-64
507,1,1,445,1425,980
508,1,0,89,0,-89
509,1,1,127,1251,1124
510,1,1,224,1416,1192
511,1,1,857,1748,891
512,0,0,6,0,-6
513,1,0,88,0,-88
514,1,0,33,0,-33
515,0,0,2,0,-2
516,0,0,104,0,-104
517,0,0,46,0,-46
518,1,1,905,1263,358
519,1,1,1277,2097,820
520,0,0,7,0,-7
521,1,1,548,1440,892
522,0,0,12,0,-12
523,1,1,607,1363,756
524,0,0,104,0,-104
525,0,0,50,0,-50
526,1,0,56,0,-56
527,0,0,76,0,-76
528,0,0,20,0,-20
529,1,0,1,0,-1
530,1,0,9,0,-9
531,1,0,78,0,-78
532,0,0,47,0,-47
533,1,0,1,0,-1
534,1,0,4,0,-4
535,0,0,15,0,-15
536,1,0,1,0,-1
537,0,0,23,0,-23
538,0,0,107,0,-107
539,0,0,9,0,-9
540,1,1,472,1476,1004
541,1,1,172,1278,1106
542,0,0,49,0,-49
543,1,0,5,0,-5
544,0,0,6,0,-6
545,1,1,748,1370,622
546,1,1,172,1303,1131
547,1,0,22,0,-22
548,1,0,125,0,-125
549,1,1,745,1495,750
550,1,0,2,0,-2
551,0,0,57,0,-57
552,0,0,36,0,-36
553,0,0,125,0,-125
554,0,0,94,0,-94
555,1,0,16,0,-16
556,1,0,3,0,-3
557,1,0,165,0,-165
558,0,0,20,0,-20
559,1,0,23,0,-23
560,1,1,1803,1960,157
561,1,0,4,0,-4
562,1,1,1258,1806,548
563,1,1,28,1430,1402
564,0,0,54,0,-54
565,1,1,58,2179,2121
566,0,0,36,0,-36
567,1,1,203,1663,1460
568,1,1,620,2178,1558
569,0,0,56,0,-56
570,1,0,8,0,-8
571,1,0,12,0,-12
572,0,0,5,0,-5
573,1,1,1303,1374,71
574,1,0,78,0,-78
575,1,0,14,0,-14
576,1,0,199,0,-199
577,1,1,169,1406,1237
578,1,0,128,0,-128
579,0,0,91,0,-91
580,0,0,178,0,-178
581,0,0,114,0,-114
582,0,0,119,0,-119
583,1,1,463,2388,1925
584,1,0,11,0,-11
585,1,1,207,1914,1707
586,1,0,24,0,-24
587,1,1,347,1358,1011
588,1,0,13,0,-13
589,1,1,207,1249,1042
590,1,0,21,0,-21
591,1,0,64,0,-64
592,1,1,1014,1279,265
593,1,1,175,1392,1217
594,1,0,67,0,-67
595,0,0,27,0,-27
596,0,0,31,0,-31
597,1,0,98,0,-98
598,1,0,85,0,-85
599,0,0,4,0,-4
600,1,1,14,2402,2388
601,1,0,2,0,-2
602,0,0,22,0,-22
603,0,0,72,0,-72
604,1,0,23,0,-23
605,1,1,618,1235,617
606,1,1,300,2268,1968
607,1,1,63,2100,2037
608,1,1,1220,1726,506
609,0,0,9,0,-9
610,0,0,53,0,-53
611,0,0,74,0,-74
612,0,0,19,0,-19
613,0,0,17,0,-17
614,1,0,10,0,-10
615,0,0,56,0,-56
616,0,0,120,0,-120
617,1,0,89,0,-89
618,0,0,59,0,-59
619,0,0,22,0,-22
620,1,1,284,1411,1127
621,0,0,24,0,-24
622,0,0,46,0,-46
623,1,1,44,3146,3102
624,1,1,616,1629,1013
625,0,0,36,0,-36
626,1,1,774,1276,502
627,1,1,391,1811,1420
628,1,0,2,0,-2
629,0,0,13,0,-13
630,1,0,25,0,-25
631,0,0,1,0,-1
632,0,0,204,0,-204
633,0,0,8,0,-8
634,1,0,42,0,-42
635,1,0,9,0,-9
636,1,1,135,1256,1121
637,1,1,101,1209,1108
638,1,0,81,0,-81
639,1,0,16,0,-16
640,0,0,80,0,-80
641,1,1,331,1510,1179
642,0,0,26,0,-26
643,1,1,171,1260,1089
644,1,0,7,0,-7
645,0,0,9,0,-9
646,1,0,76,0,-76
647,1,1,480,1352,872
648,1,1,9,1248,1239
649,1,1,545,1450,905
650,1,1,498,2290,1792
651,1,1,422,3090,2668
652,1,1,323,1776,1453
653,1,0,44,0,-44
654,0,0,42,0,-42
655,1,1,149,1230,1081
656,1,1,284,1285,1001
657,1,1,1305,1206,-99
658,1,0,58,0,-58
659,1,0,146,0,-146
660,1,1,300,1203,903
661,0,0,41,0,-41
662,0,0,47,0,-47
663,0,0,14,0,-14
664,1,0,81,0,-81
665,0,0,206,0,-206
666,0,0,6,0,-6
667,1,0,18,0,-18
668,1,1,165,2758,2593
669,0,0,33,0,-33
670,1,0,118,0,-118
671,0,0,18,0,-18
672,1,1,414,2432,2018
673,1,1,1297,1374,77
674,0,0,7,0,-7
675,1,0,32,0,-32
676,1,0,33,0,-33
677,0,0,113,0,-113
678,1,1,883,1233,350
679,1,1,464,1266,802
680,1,1,667,1230,563
681,1,0,35,0,-35
682,0,0,2,0,-2
683,1,0,6,0,-6
684,1,1,251,1587,1336
685,1,1,459,1506,1047
686,1,1,1197,1474,277
687,0,0,89,0,-89
688,1,1,79,1533,1454
689,1,1,1534,1608,74
690,0,0,68,0,-68
691,1,1,681,1929,1248
692,1,0,6,0,-6
693,1,0,108,0,-108
694,0,0,158,0,-158
695,0,0,4,0,-4
696,0,0,201,0,-201
697,1,0,136,0,-136
698,0,0,113,0,-113
699,1,1,284,1583,1299
700,1,1,269,1201,932
701,1,1,1149,1201,52
702,1,0,3,0,-3
703,0,0,1,0,-1
704,0,0,26,0,-26
705,0,0,79,0,-79
706,1,0,0,0,0
707,0,0,3,0,-3
708,0,0,32,0,-32
709,0,0,72,0,-72
710,1,0,145,0,-145
711,1,1,1157,1294,137
712,1,1,901,2048,1147
713,1,1,154,2731,2577
714,1,0,132,0,-132
715,1,0,52,0,-52
716,1,1,863,1744,881
717,0,0,73,0,-73
718,0,0,15,0,-15
719,1,0,135,0,-135
720,0,0,9,0,-9
721,1,1,804,1883,1079
722,0,0,7,0,-7
723,0,0,72,0,-72
724,0,0,140,0,-140
725,1,1,38,1735,1697
726,0,0,3,0,-3
727,1,1,205,1348,1143
728,0,0,0,0,0
729,1,1,331,1568,1237
730,1,0,13,0,-13
731,0,0,25,0,-25
732,1,0,21,0,-21
733,1,1,732,2055,1323
734,0,0,54,0,-54
735,1,0,12,0,-12
736,0,0,62,0,-62
737,1,0,49,0,-49
738,0,0,4,0,-4
739,0,0,77,0,-77
740,0,0,32,0,-32
741,1,1,364,1833,1469
742,0,0,21,0,-21
743,0,0,97,0,-97
744,1,0,19,0,-19
745,1,1,74,1873,1799
746,0,0,71,0,-71
747,1,1,237,1200,963
748,1,1,50,1279,1229
749,1,1,1230,1373,143
750,1,1,229,1449,1220
751,0,0,26,0,-26
752,0,0,6,0,-6
753,1,0,23,0,-23
754,1,1,667,1582,915
755,0,0,34,0,-34
756,1,0,11,0,-11
757,0,0,22,0,-22
758,0,0,20,0,-20
759,1,0,8,0,-8
760,0,0,125,0,-125
761,1,1,118,1459,1341
762,0,0,47,0,-47
763,1,0,26,0,-26
764,1,1,2765,1260,-1505
765,1,1,187,1461,1274
766,1,1,434,1754,1320
767,0,0,16,0,-16
768,1,1,59,2048,1989
769,0,0,11,0,-11
770,1,0,29,0,-29
771,0,0,44,0,-44
772,1,0,77,0,-77
773,1,1,238,1381,1143
774,0,0,56,0,-56
775,1,1,267,1247,980
776,1,0,4,0,-4
777,0,0,29,0,-29
778,1,1,19,1957,1938
779,1,1,267,1837,1570
780,1,0,13,0,-13
781,1,1,384,1649,1265
782,1,0,6,0,-6
783,1,0,2,0,-2
784,1,1,631,1438,807
785,0,0,21,0,-21
786,0,0,11,0,-11
787,0,0,41,0,-41
788,0,0,9,0,-9
789,0,0,41,0,-41
790,0,0,25,0,-25
791,0,0,37,0,-37
792,0,0,13,0,-13
793,1,1,644,1281,637
794,1,1,314,1296,982
795,0,0,9,0,-9
796,1,1,629,2144,1515
797,0,0,8,0,-8
798,1,1,784,1972,1188
799,0,0,44,0,-44
800,1,0,60,0,-60
801,1,0,33,0,-33
802,1,1,442,1443,1001
803,0,0,19,0,-19
804,1,1,688,1224,536
805,0,0,151,0,-151
806,0,0,105,0,-105
807,1,0,30,0,-30
808,1,0,21,0,-21
809,1,0,79,0,-79
810,0,0,94,0,-94
811,0,0,79,0,-79
812,1,1,126,1449,1323
813,1,1,220,1322,1102
814,1,1,606,1245,639
815,0,0,33,0,-33
816,0,0,6,0,-6
817,0,0,90,0,-90
818,0,0,149,0,-149
819,1,1,2193,1233,-960
820,1,1,344,3060,2716
821,1,1,492,1840,1348
822,1,0,18,0,-18
823,1,0,0,0,0
824,0,0,97,0,-97
825,1,0,22,0,-22
826,1,0,173,0,-173
827,1,0,15,0,-15
828,1,1,1323,1227,-96
829,0,0,48,0,-48
830,0,0,3,0,-3
831,1,0,19,0,-19
832,0,0,59,0,-59
833,0,0,30,0,-30
834,0,0,17,0,-17
835,0,0,61,0,-61
836,0,0,41,0,-41
837,0,0,68,0,-68
838,0,0,80,0,-80
839,0,0,1,0,-1
840,1,1,323,1462,1139
841,0,0,26,0,-26
842,1,1,655,1543,888
843,1,1,734,2299,1565
844,1,1,670,2154,1484
845,1,1,56,1957,1901
846,0,0,34,0,-34
847,1,0,13,0,-13
848,1,0,111,0,-111
849,1,0,12,0,-12
850,1,0,16,0,-16
851,1,1,1096,1534,438
852,1,1,221,1483,1262
853,0,0,135,0,-135
854,0,0,37,0,-37
855,1,1,106,1936,1830
856,1,0,50,0,-50
857,0,0,17,0,-17
858,1,0,14,0,-14
859,1,1,1244,2185,941
860,0,0,11,0,-11
861,1,0,48,0,-48
862,0,0,103,0,-103
863,1,1,391,1227,836
864,1,0,7,0,-7
865,1,0,9,0,-9
866,1,1,167,1206,1039
867,0,0,77,0,-77
868,1,1,628,1668,1040
869,1,1,877,1452,575
870,0,0,19,0,-19
871,0,0,21,0,-21
872,0,0,49,0,-49
873,0,0,45,0,-45
874,0,0,8,0,-8
875,1,0,5,0,-5
876,1,1,379,1256,877
877,0,0,91,0,-91
878,0,0,12,0,-12
879,1,1,379,1606,1227
880,1,0,2,0,-2
881,1,0,38,0,-38
882,1,0,18,0,-18
883,1,0,8,0,-8
884,1,0,8,0,-8
885,1,1,472,1237,765
886,1,1,523,1230,707
887,1,0,211,0,-211
888,0,0,6,0,-6
889,0,0,69,0,-69
890,0,0,4,0,-4
891,1,0,35,0,-35
892,0,0,48,0,-48
893,1,0,73,0,-73
894,0,0,23,0,-23
895,0,0,2,0,-2
896,1,1,918,1210,292
897,0,0,23,0,-23
898,0,0,60,0,-60
899,0,0,11,0,-11
900,1,0,53,0,-53
901,0,0,35,0,-35
902,1,0,28,0,-28
903,1,1,558,1331,773
904,0,0,61,0,-61
905,1,1,345,1419,1074
906,1,1,227,1343,1116
907,1,1,826,2910,2084
908,0,0,87,0,-87
909,1,0,13,0,-13
910,0,0,209,0,-209
911,1,0,60,0,-60
912,1,1,408,1550,1142
913,1,0,35,0,-35
914,0,0,49,0,-49
915,0,0,0,0,0
916,0,0,14,0,-14
917,0,0,13,0,-13
918,1,0,6,0,-6
919,0,0,43,0,-43
920,1,1,176,1331,1155
921,1,0,2,0,-2
922,0,0,49,0,-49
923,1,0,78,0,-78
924,0,0,28,0,-28
925,0,0,28,0,-28
926,1,0,4,0,-4
927,1,1,1533,1862,329
928,1,1,822,1526,704
929,0,0,108,0,-108
930,0,0,27,0,-27
931,1,0,43,0,-43
932,0,0,119,0,-119
933,1,1,189,1477,1288
934,1,1,148,1984,1836
935,0,0,1,0,-1
936,0,0,13,0,-13
937,1,0,26,0,-26
938,1,1,689,1387,698
939,1,1,1041,1205,164
940,1,1,564,1355,791
941,1,1,138,5740,5602
942,1,1,1141,1312,171
943,1,1,1096,1520,424
944,1,1,129,1274,1145
945,0,0,173,0,-173
946,0,0,113,0,-113
947,1,1,1405,1367,-38
948,0,0,9,0,-9
949,1,1,421,2533,2112
950,1,0,26,0,-26
951,1,0,12,0,-12
952,0,0,137,0,-137
953,1,0,70,0,-70
954,1,0,104,0,-104
955,1,0,5,0,-5
956,0,0,42,0,-42
957,0,0,21,0,-21
958,1,1,1344,1288,-56
959,1,1,419,1216,797
960,1,1,334,1321,987
961,0,0,47,0,-47
962,1,0,160,0,-160
963,1,0,141,0,-141
964,0,0,53,0,-53
965,1,1,217,2061,1844
966,0,0,8,0,-8
967,0,0,15,0,-15
968,0,0,55,0,-55
969,1,0,49,0,-49
970,1,0,2,0,-2
971,0,0,14,0,-14
972,0,0,14,0,-14
973,1,0,33,0,-33
974,1,1,1196,1209,13
975,0,0,86,0,-86
976,1,0,0,0,0
977,1,0,225,0,-225
978,1,1,136,1826,1690
979,0,0,7,0,-7
980,0,0,5,0,-5
981,1,1,770,1328,558
982,0,0,89,0,-89
983,0,0,10,0,-10
984,0,0,8,0,-8
985,1,1,386,1488,1102
986,0,0,80,0,-80
987,1,1,327,1200,873
988,1,1,430,1350,920
989,1,0,0,0,0
990,1,1,750,1261,511
991,1,1,228,1573,1345
992,0,0,128,0,-128
993,0,0,30,0,-30
994,0,0,103,0,-103
995,0,0,204,0,-204
996,1,0,72,0,-72
997,1,1,116,4403,4287
998,1,0,14,0,-14
999,1,0,7,0,-7
1000,1,1,989,3162,2173
1001,0,0,34,0,-34
1002,0,0,164,0,-164
1003,1,0,56,0,-56
1004,0,0,9,0,-9
1005,1,1,454,1249,795
1006,0,0,132,0,-132
1007,1,0,47,0,-47
1008,1,1,387,1235,848
1009,0,0,31,0,-31
1010,1,0,31,0,-31
1011,0,0,1,0,-1
1012,0,0,20,0,-20
1013,1,1,1030,1521,491
1014,0,0,163,0,-163
1015,1,1,722,1320,598
1016,1,1,59,1419,1360
1017,1,0,104,0,-104
1018,1,0,33,0,-33
1019,0,0,48,0,-48
1020,0,0,110,0,-110
1021,0,0,7,0,-7
1022,0,0,47,0,-47
1023,1,1,246,1397,1151
1024,1,1,103,2867,2764
1025,0,0,21,0,-21
1026,0,0,2,0,-2
1027,0,0,73,0,-73
1028,1,1,1758,1751,-7
1029,1,1,148,1343,1195
1030,1,1,1255,1863,608
1031,0,0,7,0,-7
1032,0,0,31,0,-31
1033,0,0,139,0,-139
1034,0,0,58,0,-58
1035,1,0,30,0,-30
1036,0,0,123,0,-123
1037,0,0,65,0,-65
1038,0,0,114,0,-114
1039,0,0,64,0,-64
1040,0,0,7,0,-7
1041,1,1,951,1335,384
1042,0,0,74,0,-74
1043,1,1,441,1236,795
1044,0,0,36,0,-36
1045,1,1,248,1753,1505
1046,1,0,30,0,-30
1047,1,0,13,0,-13
1048,1,0,1,0,-1
1049,0,0,177,0,-177
1050,1,1,238,1731,1493
1051,1,0,83,0,-83
1052,1,0,57,0,-57
1053,0,0,109,0,-109
1054,1,0,60,0,-60
1055,1,1,880,1201,321
1056,0,0,32,0,-32
1057,1,1,680,2361,1681
1058,0,0,55,0,-55
1059,1,1,573,1278,705
1060,1,1,740,1613,873
1061,1,1,1017,1578,561
1062,0,0,150,0,-150
1063,1,1,552,1240,688
1064,1,1,226,1385,1159
1065,0,0,35,0,-35
1066,0,0,29,0,-29
1067,0,0,20,0,-20
1068,1,1,862,1289,427
1069,1,0,80,0,-80
1070,1,0,61,0,-61
1071,0,0,53,0,-53
1072,1,1,550,1630,1080
1073,1,0,33,0,-33
1074,1,0,4,0,-4
1075,1,1,483,1939,1456
1076,0,0,26,0,-26
1077,1,0,32,0,-32
1078,1,1,238,1755,1517
1079,1,1,130,1292,1162
1080,0,0,133,0,-133
1081,1,1,73,1720,1647
1082,0,0,21,0,-21
1083,0,0,3,0,-3
1084,0,0,20,0,-20
1085,0,0,51,0,-51
1086,1,0,35,0,-35
1087,0,0,19,0,-19
1088,0,0,9,0,-9
1089,0,0,4,0,-4
1090,1,0,50,0,-50
1091,1,0,103,0,-103
1092,0,0,31,0,-31
1093,1,1,154,1970,1816
1094,1,0,49,0,-49
1095,1,0,23,0,-23
1096,1,1,1258,1347,89
1097,1,0,131,0,-131
1098,1,0,50,0,-50
1099,0,0,30,0,-30
1100,1,1,461,1486,1025
1101,0,0,21,0,-21
1102,0,0,12,0,-12
1103,1,1,1436,1590,154
1104,1,0,120,0,-120
1105,0,0,56,0,-56
1106,1,0,8,0,-8
1107,0,0,53,0,-53
1108,0,0,0,0,0
1109,1,0,77,0,-77
1110,1,0,4,0,-4
1111,1,1,474,1473,999
1112,0,0,61,0,-61
1113,0,0,107,0,-107
1114,1,1,793,1330,537
1115,1,0,17,0,-17
1116,0,0,107,0,-107
1117,1,1,442,1357,915
1118,1,0,104,0,-104
1119,1,0,50,0,-50
1120,1,0,27,0,-27
1121,1,0,48,0,-48
1122,0,0,100,0,-100
1123,1,0,116,0,-116
1124,0,0,38,0,-38
1125,0,0,81,0,-81
1126,1,0,63,0,-63
1127,1,1,813,1495,682
1128,1,1,1383,1278,-105
1129,0,0,114,0,-114
1130,1,1,1644,1313,-331
1131,1,0,75,0,-75
1132,1,1,623,2588,1965
1133,1,1,460,1205,745
1134,1,1,347,1230,883
1135,1,0,3,0,-3
1136,1,1,610,1693,1083
1137,1,1,402,1631,1229
1138,1,1,666,1374,708
1139,1,0,1,0,-1
1140,1,0,66,0,-66
1141,0,0,116,0,-116
1142,0,0,18,0,-18
1143,1,1,634,1790,1156
1144,0,0,3,0,-3
1145,1,1,265,1628,1363
1146,1,0,320,0,-320
1147,0,0,7,0,-7
1148,1,0,57,0,-57
1149,0,0,93,0,-93
1150,0,0,152,0,-152
1151,0,0,32,0,-32
1152,1,0,51,0,-51
1153,0,0,16,0,-16
1154,1,1,290,1248,958
1155,1,1,111,1251,1140
1156,0,0,3,0,-3
1157,0,0,32,0,-32
1158,1,0,26,0,-26
1159,1,0,84,0,-84
1160,1,1,394,1423,1029
1161,1,0,28,0,-28
1162,0,0,193,0,-193
1163,1,1,192,1288,1096
1164,0,0,12,0,-12
1165,0,0,0,0,0
1166,1,0,9,0,-9
1167,1,1,211,1278,1067
1168,0,0,25,0,-25
1169,1,0,37,0,-37
1170,1,1,1540,1228,-312
1171,1,0,11,0,-11
1172,1,0,69,0,-69
1173,1,0,11,0,-11
1174,1,1,165,1409,1244
1175,0,0,79,0,-79
1176,1,0,64,0,-64
1177,0,0,25,0,-25
1178,1,1,162,2076,1914
1179,1,0,5,0,-5
1180,1,1,621,1278,657
1181,0,0,41,0,-41
1182,0,0,21,0,-21
1183,0,0,29,0,-29
1184,1,0,36,0,-36
1185,1,1,861,1402,541
1186,0,0,84,0,-84
1187,1,0,137,0,-137
1188,0,0,70,0,-70
1189,0,0,88,0,-88
1190,0,0,45,0,-45
1191,0,0,82,0,-82
1192,0,0,60,0,-60
1193,0,0,3,0,-3
1194,1,0,13,0,-13
1195,0,0,63,0,-63
1196,0,0,91,0,-91
1197,1,1,1632,1280,-352
1198,0,0,49,0,-49
1199,0,0,107,0,-107
1200,1,0,22,0,-22
1201,1,0,2,0,-2
1202,1,1,216,1616,1400
1203,1,0,10,0,-10
1204,1,1,277,1692,1415
1205,1,1,444,1448,1004
1206,1,1,467,2867,2400
1207,0,0,89,0,-89
1208,1,1,1372,1394,22
1209,1,0,31,0,-31
1210,1,1,410,1454,1044
1211,0,0,75,0,-75
1212,1,1,289,1239,950
1213,1,1,207,1378,1171
1214,0,0,29,0,-29
1215,1,1,77,1354,1277
1216,1,1,648,1248,600
1217,1,0,98,0,-98
1218,1,0,36,0,-36
1219,1,1,223,1616,1393
1220,0,0,49,0,-49
1221,1,0,78,0,-78
1222,1,0,29,0,-29
1223,0,0,33,0,-33
1224,0,0,78,0,-78
1225,1,0,31,0,-31
1226,1,0,25,0,-25
1227,1,1,1232,1270,38
1228,0,0,6,0,-6
1229,0,0,44,0,-44
1230,1,1,483,1639,1156
1231,1,1,1598,1482,-116
1232,1,0,42,0,-42
1233,1,0,5,0,-5
1234,1,1,215,1206,991
1235,1,1,781,1301,520
1236,0,0,141,0,-141
1237,0,0,39,0,-39
1238,1,1,1050,1613,563
1239,1,0,27,0,-27
1240,0,0,23,0,-23
1241,0,0,14,0,-14
1242,0,0,97,0,-97
1243,1,1,150,1355,1205
1244,1,0,57,0,-57
1245,0,0,18,0,-18
1246,1,0,23,0,-23
1247,1,0,31,0,-31
1248,0,0,0,0,0
1249,0,0,84,0,-84
1250,0,0,73,0,-73
1251,0,0,67,0,-67
1252,1,0,104,0,-104
1253,1,1,401,1494,1093
1254,1,0,2,0,-2
1255,1,0,0,0,0
1256,1,1,1517,1230,-287
1257,0,0,30,0,-30
1258,1,0,76,0,-76
1259,1,0,29,0,-29
1260,1,1,960,1982,1022
1261,1,0,45,0,-45
1262,1,0,8,0,-8
1263,1,1,75,1782,1707
1264,1,0,48,0,-48
1265,1,0,6,0,-6
1266,0,0,14,0,-14
1267,0,0,11,0,-11
1268,1,0,192,0,-192
1269,1,0,15,0,-15
1270,1,0,66,0,-66
1271,1,1,32,3253,3221
1272,0,0,10,0,-10
1273,1,0,15,0,-15
1274,1,0,80,0,-80
1275,1,1,220,2205,1985
1276,0,0,9,0,-9
1277,0,0,5,0,-5
1278,0,0,59,0,-59
1279,1,0,128,0,-128
1280,0,0,12,0,-12
1281,1,1,262,1693,1431
1282,0,0,51,0,-51
1283,1,1,202,1311,1109
1284,1,0,20,0,-20
1285,1,0,102,0,-102
1286,1,1,151,1672,1521
1287,0,0,40,0,-40
1288,1,0,129,0,-129
1289,1,0,36,0,-36
1290,0,0,37,0,-37
1291,0,0,18,0,-18
1292,1,0,52,0,-52
1293,1,0,32,0,-32
1294,1,1,9,1302,1293
1295,0,0,74,0,-74
1296,0,0,24,0,-24
1297,0,0,36,0,-36
1298,0,0,5,0,-5
1299,1,0,31,0,-31
1300,0,0,43,0,-43
1301,1,0,125,0,-125
1302,0,0,2,0,-2
1303,0,0,70,0,-70
1304,0,0,39,0,-39
1305,1,1,403,1433,1030
1306,0,0,72,0,-72
1307,0,0,30,0,-30
1308,1,0,41,0,-41
1309,1,1,428,1262,834
1310,0,0,21,0,-21
1311,0,0,13,0,-13
1312,1,0,41,0,-41
1313,0,0,19,0,-19
1314,0,0,74,0,-74
1315,0,0,256,0,-256
1316,1,0,39,0,-39
1317,0,0,107,0,-107
1318,1,1,447,1799,1352
1319,1,1,717,1285,568
1320,1,1,72,2410,2338
1321,1,0,20,0,-20
1322,0,0,24,0,-24
1323,0,0,68,0,-68
1324,0,0,8,0,-8
1325,0,0,12,0,-12
1326,1,1,604,1357,753
1327,1,0,18,0,-18
1328,1,0,66,0,-66
1329,1,0,13,0,-13
1330,1,0,20,0,-20
1331,1,1,87,1488,1401
1332,1,0,39,0,-39
1333,0,0,6,0,-6
1334,0,0,12,0,-12
1335,1,0,18,0,-18
1336,1,0,59,0,-59
1337,0,0,30,0,-30
1338,1,0,0,0,0
1339,1,0,49,0,-49
1340,1,1,23,1282,1259
1341,0,0,38,0,-38
1342,0,0,59,0,-59
1343,1,1,102,1795,1693
1344,0,0,118,0,-118
1345,0,0,1,0,-1
1346,0,0,0,0,0
1347,0,0,20,0,-20
1348,1,0,32,0,-32
1349,1,1,1492,1234,-258
1350,0,0,13,0,-13
1351,1,0,107,0,-107
1352,1,0,102,0,-102
1353,1,1,24,1988,1964
1354,1,1,952,1850,898
1355,1,0,62,0,-62
1356,0,0,7,0,-7
1357,0,0,91,0,-91
1358,1,0,22,0,-22
1359,0,0,60,0,-60
1360,1,1,705,1378,673
1361,1,1,506,1223,717
1362,1,1,233,1205,972
1363,1,0,28,0,-28
1364,1,0,53,0,-53
1365,1,1,855,1282,427
1366,1,0,237,0,-237
1367,0,0,179,0,-179
1368,1,1,977,1218,241
1369,1,1,937,1445,508
1370,1,0,89,0,-89
1371,1,1,201,1410,1209
1372,1,1,1945,1276,-669
1373,1,0,6,0,-6
1374,1,1,925,1214,289
1375,1,1,602,1477,875
1376,0,0,37,0,-37
1377,1,0,8,0,-8
1378,1,0,6,0,-6
1379,1,1,274,1540,1266
1380,1,1,1170,1318,148
1381,1,0,26,0,-26
1382,1,0,35,0,-35
1383,1,1,270,1213,943
1384,1,1,1430,1534,104
1385,0,0,72,0,-72
1386,1,0,75,0,-75
1387,1,1,1093,1388,295
1388,1,1,182,1220,1038
1389,1,1,317,1212,895
1390,0,0,170,0,-170
1391,1,0,54,0,-54
1392,1,0,17,0,-17
1393,1,0,49,0,-49
1394,1,0,16,0,-16
1395,0,0,5,0,-5
1396,1,0,28,0,-28
1397,0,0,4,0,-4
1398,1,1,714,1362,648
1399,0,0,100,0,-100
1400,0,0,3,0,-3
1401,0,0,2,0,-2
1402,1,1,451,1273,822
1403,1,0,41,0,-41
1404,0,0,290,0,-290
1405,1,0,241,0,-241
1406,0,0,8,0,-8
1407,0,0,101,0,-101
1408,1,0,11,0,-11
1409,1,0,13,0,-13
1410,1,0,70,0,-70
1411,1,1,411,1312,901
1412,0,0,2,0,-2
1413,1,0,180,0,-180
1414,1,1,1052,1202,150
1415,1,1,49,1208,1159
1416,0,0,26,0,-26
1417,1,1,528,1682,1154
1418,0,0,220,0,-220
1419,1,0,29,0,-29
1420,1,0,18,0,-18
1421,1,0,3,0,-3
1422,1,1,819,1622,803
1423,0,0,87,0,-87
1424,1,1,1160,1483,323
1425,0,0,84,0,-84
1426,1,1,423,1247,824
1427,0,0,72,0,-72
1428,1,1,363,2820,2457
1429,0,0,67,0,-67
1430,1,0,32,0,-32
1431,0,0,81,0,-81
1432,0,0,12,0,-12
1433,1,1,1604,1503,-101
1434,0,0,101,0,-101
1435,1,1,485,5066,4581
1436,0,0,77,0,-77
1437,1,1,229,1377,1148
1438,1,1,1830,1226,-604
1439,1,1,232,1326,1094
1440,1,0,82,0,-82
1441,0,0,33,0,-33
1442,1,0,6,0,-6
1443,1,0,18,0,-18
1444,1,1,698,1326,628
1445,1,1,1357,1303,-54
1446,0,0,83,0,-83
1447,0,0,11,0,-11
1448,0,0,6,0,-6
1449,0,0,3,0,-3
1450,1,1,262,1616,1354
1451,0,0,1,0,-1
1452,0,0,10,0,-10
1453,0,0,42,0,-42
1454,0,0,7,0,-7
1455,1,1,114,1794,1680
1456,1,0,38,0,-38
1457,0,0,27,0,-27
1458,0,0,66,0,-66
1459,0,0,119,0,-119
1460,1,1,207,1977,1770
1461,1,0,44,0,-44
1462,1,0,146,0,-146
1463,0,0,33,0,-33
1464,0,0,2,0,-2
1465,1,0,58,0,-58
1466,1,1,512,1226,714
1467,0,0,19,0,-19
1468,0,0,25,0,-25
1469,1,1,463,1293,830
1470,0,0,122,0,-122
1471,1,0,180,0,-180
1472,1,1,1996,1530,-466
1473,1,1,233,1216,983
1474,0,0,0,0,0
1475,0,0,4,0,-4
1476,1,1,578,1366,788
1477,1,1,162,1437,1275
1478,1,1,739,1291,552
1479,1,1,288,1940,1652
1480,1,0,33,0,-33
1481,0,0,100,0,-100
1482,1,0,98,0,-98
1483,0,0,76,0,-76
1484,1,1,461,2147,1686
1485,1,1,983,1298,315
1486,1,0,12,0,-12
1487,1,0,67,0,-67
1488,0,0,29,0,-29
1489,0,0,49,0,-49
1490,1,1,67,1229,1162
1491,1,0,44,0,-44
1492,1,1,550,1683,1133
1493,1,0,110,0,-110
1494,1,1,736,1277,541
1495,1,0,64,0,-64
1496,0,0,8,0,-8
1497,0,0,62,0,-62
1498,1,1,209,1326,1117
1499,0,0,83,0,-83
1500,1,1,356,1202,846
1501,0,0,22,0,-22
1502,0,0,99,0,-99
1503,1,0,1,0,-1
1504,1,0,15,0,-15
1505,0,0,179,0,-179
1506,0,0,70,0,-70
1507,0,0,41,0,-41
1508,0,0,44,0,-44
1509,1,0,149,0,-149
1510,1,1,19,1337,1318
1511,1,0,83,0,-83
1512,0,0,44,0,-44
1513,1,0,34,0,-34
1514,1,0,1,0,-1
1515,1,0,19,0,-19
1516,1,1,488,1273,785
1517,0,0,64,0,-64
1518,1,0,41,0,-41
1519,1,1,147,1376,1229
1520,0,0,57,0,-57
1521,1,0,43,0,-43
1522,1,0,5,0,-5
1523,1,1,812,2984,2172
1524,0,0,15,0,-15
1525,0,0,31,0,-31
1526,1,0,4,0,-4
1527,1,1,185,1288,1103
1528,0,0,5,0,-5
1529,1,0,28,0,-28
1530,1,0,53,0,-53
1531,1,1,341,1548,1207
1532,1,0,114,0,-114
1533,1,1,689,2010,1321
1534,1,0,2,0,-2
1535,1,1,1183,1284,101
1536,1,0,9,0,-9
1537,0,0,64,0,-64
1538,1,0,85,0,-85
1539,1,0,27,0,-27
1540,0,0,1,0,-1
1541,1,0,43,0,-43
1542,0,0,0,0,0
1543,1,1,1206,1418,212
1544,1,1,400,1444,1044
1545,0,0,5,0,-5
1546,0,0,1,0,-1
1547,1,1,1744,1631,-113
1548,1,1,172,1327,1155
1549,0,0,11,0,-11
1550,1,1,483,1321,838
1551,0,0,1,0,-1
1552,1,0,79,0,-79
1553,1,1,42,1854,1812
1554,1,1,30,1404,1374
1555,0,0,112,0,-112
1556,1,0,7,0,-7
1557,1,1,976,3112,2136
1558,0,0,139,0,-139
1559,1,0,11,0,-11
1560,1,1,23,1550,1527
1561,1,1,119,1316,1197
1562,0,0,67,0,-67
1563,1,1,133,1499,1366
1564,0,0,1,0,-1
1565,1,0,66,0,-66
1566,0,0,5,0,-5
1567,1,1,173,1285,1112
1568,1,1,637,1533,896
1569,1,0,20,0,-20
1570,1,1,144,1251,1107
1571,1,0,52,0,-52
1572,0,0,32,0,-32
1573,0,0,0,0,0
1574,0,0,16,0,-16
1575,0,0,13,0,-13
1576,1,1,956,1949,993
1577,1,1,394,1219,825
1578,0,0,164,0,-164
1579,1,1,41,1203,1162
1580,0,0,21,0,-21
1581,1,1,1100,1589,489
1582,1,0,0,0,0
1583,0,0,122,0,-122
1584,1,0,16,0,-16
1585,1,0,26,0,-26
1586,1,0,4,0,-4
1587,1,1,426,1341,915
1588,0,0,7,0,-7
1589,0,0,14,0,-14
1590,0,0,8,0,-8
1591,1,1,490,1462,972
1592,1,1,180,1589,1409
1593,1,0,95,0,-95
1594,1,0,3,0,-3
1595,0,0,38,0,-38
1596,0,0,38,0,-38
1597,0,0,39,0,-39
1598,0,0,129,0,-129
1599,0,0,37,0,-37
1600,0,0,219,0,-219
1601,1,1,1499,1434,-65
1602,1,0,81,0,-81
1603,1,0,28,0,-28
1604,0,0,70,0,-70
1605,1,1,959,1715,756
1606,1,1,250,1915,1665
1607,0,0,40,0,-40
1608,1,0,17,0,-17
1609,1,0,101,0,-101
1610,1,1,554,1851,1297
1611,1,0,20,0,-20
1612,1,0,15,0,-15
1613,1,0,69,0,-69
1614,1,0,43,0,-43
1615,1,1,53,2234,2181
1616,0,0,6,0,-6
1617,1,1,1646,1632,-14
1618,1,1,253,1734,1481
1619,1,0,50,0,-50
1620,1,0,63,0,-63
1621,1,1,31,1284,1253
1622,1,1,205,1472,1267
1623,0,0,77,0,-77
1624,0,0,19,0,-19
1625,1,1,1839,1445,-394
1626,0,0,16,0,-16
1627,0,0,73,0,-73
1628,0,0,2,0,-2
1629,1,1,463,1351,888
1630,0,0,2,0,-2
1631,1,0,87,0,-87
1632,0,0,332,0,-332
1633,1,0,23,0,-23
1634,1,0,21,0,-21
1635,1,1,1239,1340,101
1636,1,1,286,1616,1330
1637,0,0,66,0,-66
1638,0,0,53,0,-53
1639,1,0,10,0,-10
1640,1,1,568,1492,924
1641,1,0,6,0,-6
1642,0,0,52,0,-52
1643,0,0,5,0,-5
1644,1,0,43,0,-43
1645,1,0,8,0,-8
1646,1,0,21,0,-21
1647,0,0,64,0,-64
1648,1,0,46,0,-46
1649,1,1,837,2339,1502
1650,0,0,18,0,-18
1651,1,0,31,0,-31
1652,0,0,33,0,-33
1653,1,1,1251,1388,137
1654,0,0,25,0,-25
1655,1,1,911,1426,515
1656,1,0,16,0,-16
1657,1,0,61,0,-61
1658,1,0,71,0,-71
1659,1,1,710,1214,504
1660,1,0,61,0,-61
1661,1,0,263,0,-263
1662,1,0,35,0,-35
1663,1,1,865,3905,3040
1664,0,0,79,0,-79
1665,1,1,165,2248,2083
1666,1,1,2666,1325,-1341
1667,1,1,27,1322,1295
1668,1,1,343,1382,1039
1669,1,0,42,0,-42
1670,0,0,13,0,-13
1671,0,0,8,0,-8
1672,0,0,14,0,-14
1673,1,1,641,1909,1268
1674,0,0,32,0,-32
1675,1,0,107,0,-107
1676,1,0,9,0,-9
1677,1,0,131,0,-131
1678,0,0,36,0,-36
1679,1,1,544,1251,707
1680,1,1,447,2009,1562
1681,0,0,13,0,-13
1682,1,0,121,0,-121
1683,0,0,32,0,-32
1684,1,0,41,0,-41
1685,0,0,5,0,-5
1686,1,1,470,1261,791
1687,1,1,1262,1918,656
1688,1,1,700,1666,966
1689,1,1,175,1375,1200
1690,0,0,28,0,-28
1691,0,0,20,0,-20
1692,0,0,25,0,-25
1693,1,1,73,1206,1133
1694,0,0,30,0,-30
1695,1,0,85,0,-85
1696,0,0,16,0,-16
1697,1,1,279,1274,995
1698,1,0,25,0,-25
1699,1,0,15,0,-15
1700,1,1,935,1280,345
1701,0,0,139,0,-139
1702,0,0,35,0,-35
1703,0,0,0,0,0
1704,1,0,10,0,-10
1705,0,0,33,0,-33
1706,1,0,8,0,-8
1707,0,0,16,0,-16
1708,1,0,12,0,-12
1709,1,1,835,1619,784
1710,1,1,289,1602,1313
1711,0,0,73,0,-73
1712,1,1,84,1283,1199
1713,1,1,573,2711,2138
1714,0,0,6,0,-6
1715,1,0,57,0,-57
1716,0,0,25,0,-25
1717,0,0,4,0,-4
1718,0,0,35,0,-35
1719,1,0,30,0,-30
1720,1,1,223,1221,998
1721,0,0,25,0,-25
1722,0,0,40,0,-40
1723,0,0,4,0,-4
1724,0,0,53,0,-53
1725,0,0,6,0,-6
1726,0,0,31,0,-31
1727,1,0,21,0,-21
1728,0,0,25,0,-25
1729,1,1,569,1350,781
1730,0,0,92,0,-92
1731,0,0,28,0,-28
1732,0,0,4,0,-4
1733,1,1,64,1432,1368
1734,1,1,82,1443,1361
1735,1,0,1,0,-1
1736,0,0,5,0,-5
1737,1,0,62,0,-62
1738,0,0,13,0,-13
1739,1,0,9,0,-9
1740,1,1,1777,1759,-18
1741,1,1,301,1491,1190
1742,1,1,1087,1940,853
1743,1,1,205,1251,1046
1744,0,0,252,0,-252
1745,0,0,13,0,-13
1746,1,0,74,0,-74
1747,1,1,189,1587,1398
1748,1,0,21,0,-21
1749,1,0,53,0,-53
1750,1,1,93,1230,1137
1751,1,1,575,2169,1594
1752,1,0,61,0,-61
1753,1,0,34,0,-34
1754,1,0,102,0,-102
1755,1,1,245,1662,1417
1756,0,0,38,0,-38
1757,0,0,67,0,-67
1758,1,0,39,0,-39
1759,1,0,9,0,-9
1760,1,0,16,0,-16
1761,0,0,13,0,-13
1762,1,1,2493,2815,322
1763,0,0,34,0,-34
1764,1,0,23,0,-23
1765,0,0,7,0,-7
1766,0,0,68,0,-68
1767,1,1,1169,1354,185
1768,1,1,61,1447,1386
1769,0,0,243,0,-243
1770,1,1,383,1369,986
1771,1,0,3,0,-3
1772,1,0,14,0,-14
1773,0,0,74,0,-74
1774,1,0,73,0,-73
1775,0,0,7,0,-7
1776,0,0,15,0,-15
1777,0,0,44,0,-44
1778,1,1,30,2064,2034
1779,0,0,9,0,-9
1780,1,0,91,0,-91
1781,0,0,119,0,-119
1782,1,1,746,3158,2412
1783,0,0,7,0,-7
1784,0,0,3,0,-3
1785,1,0,8,0,-8
1786,0,0,9,0,-9
1787,1,1,102,1881,1779
1788,1,0,18,0,-18
1789,1,0,94,0,-94
1790,1,0,90,0,-90
1791,1,0,55,0,-55
1792,0,0,50,0,-50
1793,0,0,10,0,-10
1794,0,0,5,0,-5
1795,1,0,61,0,-61
1796,1,1,35,1401,1366
1797,1,1,1231,1271,40
1798,1,1,499,1300,801
1799,0,0,31,0,-31
1800,1,0,103,0,-103
1801,1,0,56,0,-56
1802,1,1,610,1227,617
1803,1,0,43,0,-43
1804,1,1,918,1788,870
1805,1,1,1854,1215,-639
1806,1,1,106,1514,1408
1807,1,0,114,0,-114
1808,1,0,26,0,-26
1809,0,0,60,0,-60
1810,0,0,161,0,-161
1811,1,1,845,1316,471
1812,0,0,7,0,-7
1813,1,0,111,0,-111
1814,1,0,27,0,-27
1815,1,1,183,1625,1442
1816,1,1,820,1738,918
1817,0,0,53,0,-53
1818,0,0,1,0,-1
1819,0,0,51,0,-51
1820,0,0,68,0,-68
1821,0,0,110,0,-110
1822,0,0,45,0,-45
1823,0,0,33,0,-33
1824,1,1,1314,1254,-60
1825,0,0,99,0,-99
1826,1,1,325,1648,1323
1827,1,0,56,0,-56
1828,1,0,16,0,-16
1829,0,0,130,0,-130
1830,1,0,65,0,-65
1831,0,0,11,0,-11
1832,1,0,110,0,-110
1833,1,1,461,1924,1463
1834,1,0,36,0,-36
1835,1,0,16,0,-16
1836,1,1,434,1409,975
1837,1,0,12,0,-12
1838,0,0,1,0,-1
1839,0,0,19,0,-19
1840,1,0,63,0,-63
1841,1,0,180,0,-180
1842,1,1,1098,1651,553
1843,1,1,277,1453,1176
1844,0,0,23,0,-23
1845,1,0,98,0,-98
1846,0,0,74,0,-74
1847,1,1,221,1470,1249
1848,0,0,29,0,-29
1849,0,0,162,0,-162
1850,1,1,292,1285,993
1851,1,1,123,1611,1488
1852,0,0,7,0,-7
1853,1,1,581,1522,941
1854,1,0,15,0,-15
1855,0,0,40,0,-40
1856,1,0,88,0,-88
1857,1,0,76,0,-76
1858,0,0,23,0,-23
1859,0,0,21,0,-21
1860,1,0,36,0,-36
1861,1,0,50,0,-50
1862,1,0,144,0,-144
1863,1,0,35,0,-35
1864,1,1,188,1834,1646
1865,0,0,24,0,-24
1866,1,0,77,0,-77
1867,1,0,48,0,-48
1868,0,0,50,0,-50
1869,0,0,37,0,-37
1870,1,1,293,1345,1052
1871,1,1,470,1519,1049
1872,1,0,56,0,-56
1873,1,0,10,0,-10
1874,0,0,2,0,-2
1875,0,0,2,0,-2
1876,0,0,50,0,-50
1877,0,0,11,0,-11
1878,0,0,98,0,-98
1879,1,0,79,0,-79
1880,1,1,331,1347,1016
1881,1,1,1280,1252,-28
1882,1,1,1474,2913,1439
1883,1,0,1,0,-1
1884,1,0,59,0,-59
1885,1,1,263,1434,1171
1886,1,1,788,1216,428
1887,1,1,810,1434,624
1888,1,0,98,0,-98
1889,1,0,30,0,-30
1890,1,0,49,0,-49
1891,0,0,7,0,-7
1892,1,0,57,0,-57
1893,1,1,272,1673,1401
1894,1,0,102,0,-102
1895,0,0,42,0,-42
1896,0,0,60,0,-60
1897,0,0,43,0,-43
1898,0,0,3,0,-3
1899,0,0,0,0,0
1900,1,1,949,1212,263
1901,0,0,198,0,-198
1902,0,0,44,0,-44
1903,0,0,4,0,-4
1904,0,0,196,0,-196
1905,1,1,1252,2506,1254
1906,1,0,48,0,-48
1907,1,0,358,0,-358
1908,0,0,12,0,-12
1909,0,0,20,0,-20
1910,1,1,759,1295,536
1911,0,0,57,0,-57
1912,1,1,80,1469,1389
1913,1,0,97,0,-97
1914,0,0,91,0,-91
1915,0,0,2,0,-2
1916,1,0,46,0,-46
1917,0,0,61,0,-61
1918,0,0,22,0,-22
1919,0,0,26,0,-26
1920,1,0,32,0,-32
1921,1,1,70,1830,1760
1922,0,0,5,0,-5
1923,1,1,612,1391,779
1924,1,0,3,0,-3
1925,1,0,59,0,-59
1926,1,1,317,1253,936
1927,0,0,19,0,-19
1928,0,0,33,0,-33
1929,1,0,2,0,-2
1930,1,1,98,2302,2204
1931,1,0,55,0,-55
1932,1,1,1060,1308,248
1933,1,0,58,0,-58
1934,0,0,35,0,-35
1935,0,0,46,0,-46
1936,0,0,49,0,-49
1937,1,0,101,0,-101
1938,0,0,44,0,-44
1939,0,0,161,0,-161
1940,0,0,12,0,-12
1941,0,0,1,0,-1
1942,1,1,997,1710,713
1943,0,0,30,0,-30
1944,1,1,381,1568,1187
1945,1,1,176,1233,1057
1946,1,0,146,0,-146
1947,0,0,40,0,-40
1948,1,0,26,0,-26
1949,0,0,5,0,-5
1950,1,0,93,0,-93
1951,1,1,390,1374,984
1952,1,1,666,1862,1196
1953,1,1,46,1300,1254
1954,1,1,491,2170,1679
1955,1,1,243,1519,1276
1956,1,1,150,1398,1248
1957,1,1,1197,1281,84
1958,0,0,227,0,-227
1959,0,0,37,0,-37
1960,1,1,224,1972,1748
1961,1,1,336,1929,1593
1962,0,0,3,0,-3
1963,1,0,52,0,-52
1964,0,0,129,0,-129
1965,1,0,69,0,-69
1966,1,1,166,1216,1050
1967,0,0,195,0,-195
1968,1,1,2348,1276,-1072
1969,1,0,60,0,-60
1970,0,0,33,0,-33
1971,1,1,562,1226,664
1972,0,0,95,0,-95
1973,1,0,11,0,-11
1974,0,0,120,0,-120
1975,0,0,0,0,0
1976,1,1,209,1307,1098
1977,1,1,813,1225,412
1978,1,0,9,0,-9
1979,0,0,86,0,-86
1980,1,0,27,0,-27
1981,0,0,69,0,-69
1982,0,0,66,0,-66
1983,1,0,65,0,-65
1984,0,0,20,0,-20
1985,0,0,155,0,-155
1986,0,0,9,0,-9
1987,1,1,1366,1263,-103
1988,0,0,69,0,-69
1989,1,1,699,1215,516
1990,0,0,8,0,-8
1991,1,0,61,0,-61
1992,1,0,46,0,-46
1993,0,0,80,0,-80
1994,0,0,67,0,-67
1995,1,0,5,0,-5
1996,0,0,41,0,-41
1997,1,0,47,0,-47
1998,1,1,685,1516,831
1999,1,1,621,1400,779
2000,1,1,152,1291,1139
2001,0,0,8,0,-8
2002,1,0,47,0,-47
2003,1,1,724,1207,483
2004,0,0,27,0,-27
2005,1,0,37,0,-37
2006,0,0,28,0,-28
2007,1,0,27,0,-27
2008,0,0,15,0,-15
2009,1,0,69,0,-69
2010,1,1,345,1758,1413
2011,1,0,18,0,-18
2012,1,1,485,1489,1004
2013,1,0,89,0,-89
2014,1,0,66,0,-66
2015,1,0,2,0,-2
2016,1,1,513,1311,798
2017,1,0,7,0,-7
2018,0,0,7,0,-7
2019,0,0,28,0,-28
2020,1,1,92,1227,1135
2021,1,1,948,1235,287
2022,1,0,44,0,-44
2023,1,1,667,1362,695
2024,0,0,33,0,-33
2025,1,1,449,1709,1260
2026,1,0,40,0,-40
2027,0,0,206,0,-206
2028,1,1,408,1342,934
2029,0,0,60,0,-60
2030,1,0,33,0,-33
2031,1,1,2585,1520,-1065
2032,1,1,736,2558,1822
2033,1,0,25,0,-25
2034,0,0,26,0,-26
2035,0,0,27,0,-27
2036,1,1,151,1635,1484
2037,0,0,35,0,-35
2038,1,0,54,0,-54
2039,0,0,2,0,-2
2040,1,1,359,1242,883
2041,1,1,412,1367,955
2042,1,0,13,0,-13
2043,0,0,31,0,-31
2044,1,1,139,1714,1575
2045,1,0,133,0,-133
2046,1,0,0,0,0
2047,0,0,10,0,-10
2048,1,0,111,0,-111
2049,1,1,274,1348,1074
2050,0,0,11,0,-11
2051,0,0,8,0,-8
2052,1,0,35,0,-35
2053,0,0,3,0,-3
2054,1,0,56,0,-56
2055,1,1,257,2149,1892
2056,0,0,124,0,-124
2057,1,1,1021,1262,241
2058,0,0,28,0,-28
2059,0,0,20,0,-20
2060,1,1,518,1541,1023
2061,1,0,32,0,-32
2062,1,0,70,0,-70
2063,1,0,2,0,-2
2064,0,0,33,0,-33
2065,0,0,52,0,-52
2066,1,0,4,0,-4
2067,0,0,3,0,-3
2068,1,0,31,0,-31
2069,0,0,103,0,-103
2070,1,0,17,0,-17
2071,1,0,36,0,-36
2072,1,0,6,0,-6
2073,0,0,64,0,-64
2074,1,0,21,0,-21
2075,0,0,37,0,-37
2076,1,0,110,0,-110
2077,1,0,25,0,-25
2078,1,0,12,0,-12
2079,1,0,44,0,-44
2080,1,1,225,1768,1543
2081,1,1,1019,1374,355
2082,0,0,80,0,-80
2083,1,1,303,2027,1724
2084,0,0,6,0,-6
2085,0,0,7,0,-7
2086,0,0,0,0,0
2087,1,0,28,0,-28
2088,1,1,558,1696,1138
2089,1,0,118,0,-118
2090,0,0,89,0,-89
2091,0,0,171,0,-171
2092,0,0,129,0,-129
2093,0,0,95,0,-95
2094,0,0,156,0,-156
2095,1,0,14,0,-14
2096,1,1,340,2082,1742
2097,1,0,10,0,-10
2098,1,1,276,1416,1140
2099,1,1,155,1331,1176
2100,1,0,0,0,0
2101,1,1,186,1243,1057
2102,0,0,27,0,-27
2103,1,0,23,0,-23
2104,1,0,99,0,-99
2105,0,0,28,0,-28
2106,1,0,20,0,-20
2107,0,0,85,0,-85
2108,0,0,11,0,-11
2109,1,0,99,0,-99
2110,1,1,205,2186,1981
2111,1,1,2739,1356,-1383
2112,0,0,2,0,-2
2113,1,0,215,0,-215
2114,1,1,269,1436,1167
2115,0,0,20,0,-20
2116,1,1,527,1600,1073
2117,0,0,18,0,-18
2118,1,0,49,0,-49
2119,1,0,45,0,-45
2120,0,0,20,0,-20
2121,1,0,47,0,-47
2122,1,1,376,1505,1129
2123,1,0,53,0,-53
2124,1,0,62,0,-62
2125,0,0,18,0,-18
2126,1,0,55,0,-55
2127,0,0,108,0,-108
2128,1,1,1257,1287,30
2129,1,1,126,4149,4023
2130,1,1,1323,1461,138
2131,0,0,0,0,0
2132,1,0,118,0,-118
2133,1,0,45,0,-45
2134,1,0,54,0,-54
2135,1,0,28,0,-28
2136,0,0,6,0,-6
2137,1,0,3,0,-3
2138,0,0,90,0,-90
2139,1,0,117,0,-117
2140,0,0,1,0,-1
2141,1,1,234,1259,1025
2142,0,0,29,0,-29
2143,1,0,34,0,-34
2144,1,1,528,3451,2923
2145,1,1,187,1269,1082
2146,1,0,6,0,-6
2147,1,1,13,1473,1460
2148,0,0,9,0,-9
2149,0,0,98,0,-98
2150,1,1,294,1801,1507
2151,0,0,294,0,-294
2152,1,0,140,0,-140
2153,0,0,18,0,-18
2154,1,1,1269,1271,2
2155,1,0,14,0,-14
2156,1,1,121,1254,1133
2157,1,1,352,1344,992
2158,1,1,689,1235,546
2159,1,0,4,0,-4
2160,1,1,406,1757,1351
2161,0,0,14,0,-14
2162,0,0,10,0,-10
2163,0,0,64,0,-64
2164,1,0,133,0,-133
2165,1,1,87,1403,1316
2166,1,1,498,1729,1231
2167,1,1,572,1291,719
2168,1,0,14,0,-14
2169,0,0,4,0,-4
2170,1,0,55,0,-55
2171,1,0,100,0,-100
2172,1,1,800,1360,560
2173,1,1,350,1309,959
2174,0,0,70,0,-70
2175,1,0,50,0,-50
2176,0,0,20,0,-20
2177,0,0,160,0,-160
2178,1,1,402,1460,1058
2179,1,1,1098,1692,594
2180,1,1,248,2348,2100
2181,0,0,69,0,-69
2182,1,0,53,0,-53
2183,1,0,74,0,-74
2184,0,0,16,0,-16
2185,1,0,25,0,-25
2186,0,0,90,0,-90
2187,1,1,611,2373,1762
2188,1,1,446,1353,907
2189,0,0,26,0,-26
2190,1,0,148,0,-148
2191,1,0,1,0,-1
2192,1,1,882,1210,328
2193,1,1,723,1238,515
2194,0,0,41,0,-41
2195,1,0,35,0,-35
2196,1,1,189,1637,1448
2197,1,0,96,0,-96
2198,1,1,1838,1403,-435
2199,1,1,187,1664,1477
2200,1,0,46,0,-46
2201,0,0,127,0,-127
2202,1,1,721,1385,664
2203,1,1,1426,1242,-184
2204,1,1,695,1250,555
2205,1,1,190,2015,1825
2206,1,1,96,1429,1333
2207,1,1,483,1588,1105
2208,1,1,964,1762,798
2209,1,0,35,0,-35
2210,0,0,1,0,-1
2211,0,0,1,0,-1
2212,1,1,635,1385,750
2213,1,0,37,0,-37
2214,0,0,16,0,-16
2215,0,0,17,0,-17
2216,0,0,0,0,0
2217,0,0,24,0,-24
2218,0,0,7,0,-7
2219,1,1,775,1353,578
2220,0,0,119,0,-119
2221,1,0,58,0,-58
2222,0,0,23,0,-23
2223,0,0,6,0,-6
2224,1,0,61,0,-61
2225,1,1,139,1317,1178
2226,1,0,28,0,-28
2227,1,0,2,0,-2
2228,1,0,31,0,-31
2229,1,0,81,0,-81
2230,1,0,115,0,-115
2231,1,0,1,0,-1
2232,0,0,102,0,-102
2233,0,0,9,0,-9
2234,1,1,154,1822,1668
2235,0,0,35,0,-35
2236,1,1,63,1236,1173
2237,1,0,31,0,-31
2238,1,0,50,0,-50
2239,1,1,324,1210,886
2240,1,0,15,0,-15
2241,1,1,49,1285,1236
2242,0,0,80,0,-80
2243,1,1,1222,1269,47
2244,1,1,328,1280,952
2245,1,1,169,1509,1340
2246,1,0,22,0,-22
2247,1,0,22,0,-22
2248,1,1,124,1224,1100
2249,1,0,17,0,-17
2250,1,1,66,1471,1405
2251,1,1,268,2511,2243
2252,1,1,277,2422,2145
2253,1,0,58,0,-58
2254,1,1,263,1699,1436
2255,0,0,41,0,-41
2256,1,0,52,0,-52
2257,1,0,40,0,-40
2258,0,0,10,0,-10
2259,1,0,90,0,-90
2260,1,1,323,1295,972
2261,0,0,89,0,-89
2262,1,0,56,0,-56
2263,0,0,95,0,-95
2264,0,0,75,0,-75
2265,1,1,172,1401,1229
2266,1,1,169,1269,1100
2267,0,0,72,0,-72
2268,1,0,70,0,-70
2269,1,0,31,0,-31
2270,0,0,30,0,-30
2271,1,1,28,1774,1746
2272,0,0,20,0,-20
2273,0,0,63,0,-63
2274,0,0,65,0,-65
2275,1,0,70,0,-70
2276,0,0,67,0,-67
2277,1,0,18,0,-18
2278,0,0,61,0,-61
2279,0,0,22,0,-22
2280,1,1,1747,1525,-222
2281,1,0,85,0,-85
2282,0,0,1,0,-1
2283,1,0,135,0,-135
2284,0,0,63,0,-63
2285,1,1,930,1475,545
2286,1,0,25,0,-25
2287,1,0,14,0,-14
2288,0,0,7,0,-7
2289,0,0,80,0,-80
2290,0,0,42,0,-42
2291,1,1,369,1488,1119
2292,1,1,278,1314,1036
2293,1,1,423,1429,1006
2294,0,0,26,0,-26
2295,0,0,25,0,-25
2296,1,1,581,1566,985
2297,0,0,114,0,-114
2298,1,1,918,1320,402
2299,1,1,985,1226,241
2300,0,0,34,0,-34
2301,0,0,41,0,-41
2302,0,0,10,0,-10
2303,0,0,4,0,-4
2304,1,1,858,1323,465
2305,0,0,28,0,-28
2306,0,0,115,0,-115
2307,0,0,36,0,-36
2308,1,0,16,0,-16
2309,0,0,5,0,-5
2310,0,0,69,0,-69
2311,0,0,32,0,-32
2312,0,0,151,0,-151
2313,1,1,1366,1472,106
2314,0,0,32,0,-32
2315,1,0,31,0,-31
2316,1,1,594,1539,945
2317,0,0,27,0,-27
2318,1,0,10,0,-10
2319,1,0,25,0,-25
2320,1,0,80,0,-80
2321,1,1,106,1221,1115
2322,0,0,11,0,-11
2323,1,0,113,0,-113
2324,0,0,160,0,-160
2325,1,1,570,1578,1008
2326,0,0,22,0,-22
2327,0,0,13,0,-13
2328,0,0,70,0,-70
2329,0,0,18,0,-18
2330,1,0,55,0,-55
2331,0,0,93,0,-93
2332,1,0,3,0,-3
2333,0,0,140,0,-140
2334,0,0,14,0,-14
2335,1,0,19,0,-19
2336,0,0,109,0,-109
2337,1,1,11,1638,1627
2338,0,0,41,0,-41
2339,1,0,20,0,-20
2340,0,0,0,0,0
2341,0,0,130,0,-130
2342,1,1,215,1261,1046
2343,1,0,2,0,-2
2344,0,0,42,0,-42
2345,0,0,59,0,-59
2346,0,0,16,0,-16
2347,1,1,761,1330,569
2348,0,0,13,0,-13
2349,1,0,5,0,-5
2350,1,1,343,1481,1138
2351,0,0,40,0,-40
2352,1,0,64,0,-64
2353,0,0,19,0,-19
2354,1,1,159,1442,1283
2355,0,0,54,0,-54
2356,1,0,21,0,-21
2357,0,0,6,0,-6
2358,1,0,28,0,-28
2359,1,0,50,0,-50
2360,1,1,126,2689,2563
2361,1,0,25,0,-25
2362,1,1,1097,1212,115
2363,1,0,2,0,-2
2364,1,1,207,1794,1587
2365,0,0,45,0,-45
2366,0,0,57,0,-57
2367,0,0,52,0,-52
2368,1,1,98,1215,1117
2369,0,0,59,0,-59
2370,0,0,44,0,-44
2371,0,0,54,0,-54
2372,1,0,97,0,-97
2373,0,0,23,0,-23
2374,1,0,162,0,-162
2375,1,0,106,0,-106
2376,0,0,0,0,0
2377,1,1,99,1717,1618
2378,0,0,98,0,-98
2379,1,0,4,0,-4
2380,1,0,18,0,-18
2381,1,1,509,1236,727
2382,1,0,24,0,-24
2383,0,0,68,0,-68
2384,0,0,27,0,-27
2385,0,0,47,0,-47
2386,1,0,160,0,-160
2387,0,0,25,0,-25
2388,1,0,60,0,-60
2389,0,0,78,0,-78
2390,1,0,15,0,-15
2391,0,0,30,0,-30
2392,0,0,113,0,-113
2393,0,0,20,0,-20
2394,0,0,10,0,-10
2395,1,0,18,0,-18
2396,1,1,765,1348,583
2397,0,0,10,0,-10
2398,1,0,8,0,-8
2399,1,0,85,0,-85
2400,1,0,33,0,-33
2401,1,1,584,1456,872
2402,1,0,22,0,-22
2403,1,1,870,1272,402
2404,1,1,838,1366,528
2405,1,0,357,0,-357
2406,0,0,27,0,-27
2407,1,0,3,0,-3
2408,1,0,4,0,-4
2409,1,0,178,0,-178
2410,1,1,300,1602,1302
2411,1,1,148,1280,1132
2412,0,0,7,0,-7
2413,1,0,94,0,-94
2414,1,0,22,0,-22
2415,0,0,65,0,-65
2416,0,0,43,0,-43
2417,0,0,238,0,-238
2418,1,1,184,1862,1678
2419,1,1,925,1419,494
2420,0,0,1,0,-1
2421,0,0,35,0,-35
2422,1,1,159,1618,1459
2423,0,0,46,0,-46
2424,0,0,45,0,-45
2425,1,0,27,0,-27
2426,0,0,6,0,-6
2427,0,0,52,0,-52
2428,1,0,46,0,-46
2429,0,0,6,0,-6
2430,0,0,14,0,-14
2431,0,0,7,0,-7
2432,1,0,92,0,-92
2433,0,0,42,0,-42
2434,1,0,59,0,-59
2435,0,0,31,0,-31
2436,0,0,23,0,-23
2437,1,1,924,1640,716
2438,0,0,45,0,-45
2439,0,0,16,0,-16
2440,1,0,10,0,-10
2441,0,0,13,0,-13
2442,0,0,23,0,-23
2443,0,0,82,0,-82
2444,1,1,1504,1236,-268
2445,1,1,517,1249,732
2446,1,1,124,1292,1168
2447,1,1,199,1370,1171
2448,1,1,205,1406,1201
2449,1,0,33,0,-33
2450,1,0,7,0,-7
2451,1,1,82,1708,1626
2452,0,0,56,0,-56
2453,1,1,460,1799,1339
2454,0,0,22,0,-22
2455,1,0,16,0,-16
2456,1,1,87,1281,1194
2457,1,1,330,1657,1327
2458,1,0,35,0,-35
2459,1,0,8,0,-8
2460,1,0,4,0,-4
2461,1,0,84,0,-84
2462,1,1,234,1966,1732
2463,0,0,31,0,-31
2464,0,0,32,0,-32
2465,1,0,31,0,-31
2466,1,1,888,1912,1024
2467,0,0,30,0,-30
2468,0,0,3,0,-3
2469,0,0,16,0,-16
2470,1,0,43,0,-43
2471,1,0,32,0,-32
2472,1,0,47,0,-47
2473,1,0,14,0,-14
2474,0,0,2,0,-2
2475,1,0,110,0,-110
2476,1,0,3,0,-3
2477,1,1,407,1542,1135
2478,1,0,26,0,-26
2479,1,0,22,0,-22
2480,1,0,128,0,-128
2481,0,0,11,0,-11
2482,0,0,44,0,-44
2483,0,0,9,0,-9
2484,0,0,49,0,-49
2485,0,0,227,0,-227
2486,0,0,26,0,-26
2487,1,0,11,0,-11
2488,1,0,79,0,-79
2489,1,0,22,0,-22
2490,0,0,34,0,-34
2491,1,0,48,0,-48
2492,1,1,90,2566,2476
2493,1,0,17,0,-17
2494,1,0,146,0,-146
2495,1,1,208,1437,1229
2496,1,1,198,1798,1600
2497,0,0,82,0,-82
2498,0,0,36,0,-36
2499,0,0,9,0,-9
2500,1,1,320,2627,2307
2501,1,0,33,0,-33
2502,0,0,13,0,-13
2503,0,0,26,0,-26
2504,0,0,56,0,-56
2505,0,0,59,0,-59
2506,0,0,2,0,-2
2507,1,0,47,0,-47
2508,0,0,89,0,-89
2509,1,1,294,1915,1621
2510,0,0,54,0,-54
2511,1,1,426,1550,1124
2512,1,1,732,1238,506
2513,0,0,50,0,-50
2514,1,1,281,1228,947
2515,1,1,34,1723,1689
2516,1,0,1,0,-1
2517,1,0,58,0,-58
2518,1,0,103,0,-103
2519,1,0,2,0,-2
2520,0,0,6,0,-6
2521,1,1,692,1622,930
2522,0,0,111,0,-111
2523,1,1,66,4548,4482
2524,1,0,39,0,-39
2525,0,0,52,0,-52
2526,0,0,39,0,-39
2527,1,0,6,0,-6
2528,0,0,91,0,-91
2529,1,0,20,0,-20
2530,0,0,210,0,-210
2531,1,0,0,0,0
2532,1,1,2439,1478,-961
2533,1,0,27,0,-27
2534,0,0,5,0,-5
2535,0,0,38,0,-38
2536,0,0,111,0,-111
2537,0,0,40,0,-40
2538,0,0,140,0,-140
2539,0,0,41,0,-41
2540,1,0,5,0,-5
2541,1,1,571,1356,785
2542,1,1,738,1457,719
2543,0,0,66,0,-66
2544,0,0,16,0,-16
2545,1,0,20,0,-20
2546,1,1,94,1226,1132
2547,0,0,37,0,-37
2548,1,0,65,0,-65
2549,1,0,27,0,-27
2550,0,0,125,0,-125
2551,1,1,597,1221,624
2552,0,0,6,0,-6
2553,1,1,753,1417,664
2554,1,0,76,0,-76
2555,1,1,461,1376,915
2556,0,0,27,0,-27
2557,1,0,26,0,-26
2558,0,0,87,0,-87
2559,0,0,101,0,-101
2560,1,1,267,1579,1312
2561,1,0,42,0,-42
2562,1,1,278,1943,1665
2563,1,1,212,1341,1129
2564,1,0,75,0,-75
2565,1,0,57,0,-57
2566,0,0,132,0,-132
2567,0,0,5,0,-5
2568,1,1,137,2177,2040
2569,1,1,39,1426,1387
2570,0,0,54,0,-54
2571,1,1,799,1376,577
2572,0,0,63,0,-63
2573,1,0,49,0,-49
2574,1,1,318,1423,1105
2575,0,0,62,0,-62
2576,0,0,36,0,-36
2577,1,0,65,0,-65
2578,1,1,846,1503,657
2579,1,0,17,0,-17
2580,1,1,1145,1608,463
2581,1,0,55,0,-55
2582,0,0,51,0,-51
2583,1,0,42,0,-42
2584,0,0,2,0,-2
2585,1,0,45,0,-45
2586,0,0,61,0,-61
2587,0,0,22,0,-22
2588,1,0,33,0,-33
2589,0,0,34,0,-34
2590,1,0,29,0,-29
2591,1,1,779,1262,483
2592,1,0,100,0,-100
2593,0,0,69,0,-69
2594,0,0,19,0,-19
2595,0,0,23,0,-23
2596,0,0,61,0,-61
2597,1,1,732,1734,1002
2598,0,0,17,0,-17
2599,1,0,58,0,-58
2600,1,1,778,1314,536
2601,1,1,237,1503,1266
2602,1,0,5,0,-5
2603,1,0,34,0,-34
2604,1,0,33,0,-33
2605,0,0,45,0,-45
2606,0,0,46,0,-46
2607,0,0,6,0,-6
2608,0,0,66,0,-66
2609,0,0,25,0,-25
2610,0,0,76,0,-76
2611,0,0,83,0,-83
2612,1,0,24,0,-24
2613,0,0,3,0,-3
2614,0,0,88,0,-88
2615,0,0,105,0,-105
2616,0,0,74,0,-74
2617,0,0,76,0,-76
2618,0,0,67,0,-67
2619,1,1,703,1595,892
2620,0,0,33,0,-33
2621,1,0,4,0,-4
2622,0,0,11,0,-11
2623,0,0,17,0,-17
2624,1,0,29,0,-29
2625,1,1,135,1572,1437
2626,0,0,3,0,-3
2627,0,0,18,0,-18
2628,1,1,889,1250,361
2629,1,0,23,0,-23
2630,0,0,35,0,-35
2631,1,0,30,0,-30
2632,1,1,321,1282,961
2633,0,0,7,0,-7
2634,1,0,1,0,-1
2635,1,1,293,1610,1317
2636,1,1,360,3189,2829
2637,1,1,345,1226,881
2638,0,0,25,0,-25
2639,1,1,876,2675,1799
2640,1,1,389,1934,1545
2641,1,1,131,1380,1249
2642,0,0,29,0,-29
2643,0,0,47,0,-47
2644,0,0,31,0,-31
2645,1,1,414,2601,2187
2646,0,0,0,0,0
2647,0,0,138,0,-138
2648,1,1,113,1648,1535
2649,0,0,11,0,-11
2650,1,1,507,1863,1356
2651,1,1,363,1312,949
2652,1,0,61,0,-61
2653,0,0,40,0,-40
2654,0,0,23,0,-23
2655,1,0,14,0,-14
2656,1,0,23,0,-23
2657,1,1,1064,1331,267
2658,1,0,122,0,-122
2659,1,1,1539,1324,-215
2660,0,0,40,0,-40
2661,0,0,63,0,-63
2662,1,1,825,5390,4565
2663,0,0,75,0,-75
2664,1,1,357,2002,1645
2665,1,1,737,1233,496
2666,0,0,7,0,-7
2667,0,0,19,0,-19
2668,1,1,295,1208,913
2669,0,0,131,0,-131
2670,0,0,25,0,-25
2671,0,0,26,0,-26
2672,1,1,446,1958,1512
2673,0,0,31,0,-31
2674,0,0,19,0,-19
2675,0,0,62,0,-62
2676,0,0,2,0,-2
2677,1,1,1429,1820,391
2678,1,1,277,2833,2556
2679,0,0,36,0,-36
2680,1,1,262,1351,1089
2681,1,1,74,1408,1334
2682,1,0,0,0,0
2683,0,0,17,0,-17
2684,1,1,60,1216,1156
2685,0,0,12,0,-12
2686,1,0,29,0,-29
2687,0,0,86,0,-86
2688,1,1,458,1827,1369
2689,0,0,5,0,-5
2690,1,1,245,1392,1147
2691,0,0,55,0,-55
2692,1,1,693,1278,585
2693,0,0,94,0,-94
2694,1,1,280,1213,933
2695,0,0,3,0,-3
2696,1,1,617,1266,649
2697,1,0,83,0,-83
2698,1,0,20,0,-20
2699,0,0,116,0,-116
2700,0,0,2,0,-2
2701,1,0,4,0,-4
2702,1,0,60,0,-60
2703,1,1,2364,4338,1974
2704,0,0,65,0,-65
2705,1,0,22,0,-22
2706,1,0,2,0,-2
2707,1,0,24,0,-24
2708,0,0,169,0,-169
2709,1,1,1316,1429,113
2710,0,0,27,0,-27
2711,1,0,48,0,-48
2712,0,0,112,0,-112
2713,1,1,476,1259,783
2714,0,0,4,0,-4
2715,1,0,65,0,-65
2716,1,0,26,0,-26
2717,1,0,42,0,-42
2718,0,0,18,0,-18
2719,1,1,293,1961,1668
2720,1,0,7,0,-7
2721,1,1,667,1474,807
2722,0,0,140,0,-140
2723,0,0,12,0,-12
2724,1,0,52,0,-52
2725,1,0,70,0,-70
2726,1,0,20,0,-20
2727,1,1,353,1558,1205
2728,0,0,61,0,-61
2729,0,0,77,0,-77
2730,1,1,1133,1275,142
2731,1,0,22,0,-22
2732,0,0,99,0,-99
2733,1,1,114,1266,1152
2734,1,1,1094,2396,1302
2735,1,0,29,0,-29
2736,1,1,215,1593,1378
2737,1,0,12,0,-12
2738,0,0,95,0,-95
2739,0,0,60,0,-60
2740,0,0,175,0,-175
2741,1,1,37,1728,1691
2742,1,1,452,1382,930
2743,0,0,4,0,-4
2744,1,1,869,1461,592
2745,0,0,55,0,-55
2746,0,0,54,0,-54
2747,0,0,64,0,-64
2748,1,1,277,1372,1095
2749,1,1,310,1811,1501
2750,1,0,24,0,-24
2751,1,1,46,1699,1653
2752,0,0,76,0,-76
2753,1,0,6,0,-6
2754,0,0,70,0,-70
2755,1,1,1811,1426,-385
2756,0,0,37,0,-37
2757,0,0,9,0,-9
2758,1,0,0,0,0
2759,1,0,29,0,-29
2760,0,0,25,0,-25
2761,0,0,32,0,-32
2762,1,0,37,0,-37
2763,1,1,640,1790,1150
2764,0,0,26,0,-26
2765,0,0,290,0,-290
2766,0,0,28,0,-28
2767,0,0,11,0,-11
2768,1,1,185,1370,1185
2769,0,0,9,0,-9
2770,1,0,168,0,-168
2771,1,1,94,1613,1519
2772,1,1,363,1757,1394
2773,1,0,45,0,-45
2774,1,0,11,0,-11
2775,0,0,62,0,-62
2776,1,0,1,0,-1
2777,0,0,11,0,-11
2778,1,0,38,0,-38
2779,0,0,32,0,-32
2780,1,0,57,0,-57
2781,0,0,15,0,-15
2782,1,1,99,2355,2256
2783,0,0,29,0,-29
2784,1,0,240,0,-240
2785,0,0,69,0,-69
2786,1,0,14,0,-14
2787,0,0,85,0,-85
2788,1,0,1,0,-1
2789,0,0,6,0,-6
2790,1,0,46,0,-46
2791,0,0,14,0,-14
2792,0,0,65,0,-65
2793,1,0,172,0,-172
2794,1,1,691,1525,834
2795,0,0,207,0,-207
2796,0,0,80,0,-80
2797,0,0,7,0,-7
2798,1,1,364,1702,1338
2799,1,1,982,1454,472
2800,1,1,128,1496,1368
2801,1,1,131,1788,1657
2802,1,0,43,0,-43
2803,1,0,23,0,-23
2804,1,1,113,1250,1137
2805,1,0,25,0,-25
2806,1,1,191,1573,1382
2807,1,0,2,0,-2
2808,0,0,245,0,-245
2809,0,0,3,0,-3
2810,0,0,16,0,-16
2811,0,0,8,0,-8
2812,0,0,8,0,-8
2813,1,0,39,0,-39
2814,1,1,618,1992,1374
2815,0,0,244,0,-244
2816,0,0,48,0,-48
2817,1,0,10,0,-10
2818,0,0,9,0,-9
2819,1,1,532,2774,2242
2820,1,0,45,0,-45
2821,1,1,518,1305,787
2822,1,0,170,0,-170
2823,1,1,586,1345,759
2824,1,1,195,1442,1247
2825,0,0,17,0,-17
2826,1,1,393,2022,1629
2827,0,0,13,0,-13
2828,1,1,1617,1308,-309
2829,0,0,142,0,-142
2830,1,1,41,1349,1308
2831,1,0,23,0,-23
2832,1,0,42,0,-42
2833,1,1,411,1413,1002
2834,1,1,130,1252,1122
2835,0,0,29,0,-29
2836,0,0,63,0,-63
2837,1,0,25,0,-25
2838,1,1,116,1776,1660
2839,1,1,80,1261,1181
2840,0,0,35,0,-35
2841,1,0,35,0,-35
2842,1,0,1,0,-1
2843,0,0,43,0,-43
2844,0,0,47,0,-47
2845,1,1,572,1793,1221
2846,0,0,122,0,-122
2847,1,0,115,0,-115
2848,1,0,11,0,-11
2849,0,0,115,0,-115
2850,1,1,947,3135,2188
2851,0,0,31,0,-31
2852,0,0,12,0,-12
2853,1,0,116,0,-116
2854,1,0,22,0,-22
2855,1,1,496,2142,1646
2856,0,0,17,0,-17
2857,1,0,34,0,-34
2858,1,1,136,1376,1240
2859,1,1,115,1254,1139
2860,1,1,623,1366,743
2861,1,1,624,1243,619
2862,1,0,106,0,-106
2863,1,1,244,1505,1261
2864,1,1,162,1256,1094
2865,1,0,154,0,-154
2866,1,0,8,0,-8
2867,1,1,453,2035,1582
2868,0,0,61,0,-61
2869,1,1,958,1418,460
2870,0,0,52,0,-52
2871,1,0,18,0,-18
2872,0,0,5,0,-5
2873,0,0,8,0,-8
2874,1,1,534,1345,811
2875,0,0,19,0,-19
2876,1,0,43,0,-43
2877,0,0,48,0,-48
2878,1,0,46,0,-46
2879,1,1,1893,1997,104
2880,1,0,94,0,-94
2881,0,0,15,0,-15
2882,1,0,65,0,-65
2883,1,0,18,0,-18
2884,0,0,92,0,-92
2885,0,0,20,0,-20
2886,0,0,59,0,-59
2887,0,0,1,0,-1
2888,1,1,595,1338,743
2889,0,0,17,0,-17
2890,1,1,1996,4210,2214
2891,1,0,75,0,-75
2892,0,0,43,0,-43
2893,0,0,60,0,-60
2894,0,0,135,0,-135
2895,1,0,19,0,-19
2896,1,1,916,1208,292
2897,1,1,139,1602,1463
2898,1,0,21,0,-21
2899,1,0,90,0,-90
2900,1,1,171,1273,1102
2901,1,1,158,3760,3602
2902,1,1,510,1317,807
2903,0,0,205,0,-205
2904,1,0,233,0,-233
2905,0,0,92,0,-92
2906,1,0,0,0,0
2907,0,0,69,0,-69
2908,0,0,5,0,-5
2909,1,0,1,0,-1
2910,0,0,16,0,-16
2911,1,1,1360,4866,3506
2912,1,0,67,0,-67
2913,1,1,669,1691,1022
2914,0,0,15,0,-15
2915,0,0,1,0,-1
2916,1,1,513,1352,839
2917,1,0,23,0,-23
2918,1,0,16,0,-16
2919,1,1,442,1310,868
2920,1,1,416,1381,965
2921,1,1,342,1235,893
2922,0,0,0,0,0
2923,0,0,42,0,-42
2924,1,1,570,1291,721
2925,0,0,92,0,-92
2926,1,0,8,0,-8
2927,1,0,7,0,-7
2928,1,1,67,1408,1341
2929,0,0,144,0,-144
2930,1,1,336,1692,1356
2931,1,1,220,1513,1293
2932,0,0,53,0,-53
2933,0,0,12,0,-12
2934,1,1,89,1647,1558
2935,1,0,175,0,-175
2936,1,0,29,0,-29
2937,1,0,12,0,-12
2938,1,0,17,0,-17
2939,1,1,1101,1200,99
2940,1,1,403,2085,1682
2941,0,0,4,0,-4
2942,0,0,14,0,-14
2943,1,1,695,2429,1734
2944,0,0,30,0,-30
2945,0,0,59,0,-59
2946,0,0,14,0,-14
2947,1,1,269,1357,1088
2948,1,0,5,0,-5
2949,1,1,764,1279,515
2950,1,1,12,1432,1420
2951,1,1,19,1228,1209
2952,1,1,897,1316,419
2953,0,0,45,0,-45
2954,0,0,13,0,-13
2955,1,0,38,0,-38
2956,1,1,189,1787,1598
2957,0,0,29,0,-29
2958,0,0,122,0,-122
2959,1,1,151,1953,1802
2960,0,0,44,0,-44
2961,1,0,173,0,-173
2962,1,0,21,0,-21
2963,0,0,33,0,-33
2964,0,0,24,0,-24
2965,0,0,74,0,-74
2966,1,1,176,1254,1078
2967,0,0,99,0,-99
2968,1,1,247,1265,1018
2969,1,0,33,0,-33
2970,1,0,12,0,-12
2971,1,0,44,0,-44
2972,0,0,79,0,-79
2973,0,0,56,0,-56
2974,1,0,45,0,-45
2975,0,0,45,0,-45
2976,0,0,83,0,-83
2977,0,0,48,0,-48
2978,1,1,39,1516,1477
2979,0,0,2,0,-2
2980,0,0,19,0,-19
2981,0,0,6,0,-6
2982,1,1,321,1205,884
2983,0,0,64,0,-64
2984,1,1,513,1992,1479
2985,1,0,35,0,-35
2986,0,0,30,0,-30
2987,0,0,46,0,-46
2988,1,0,109,0,-109
2989,1,0,25,0,-25
2990,1,1,206,2814,2608
2991,1,1,1034,2013,979
2992,0,0,107,0,-107
2993,0,0,28,0,-28
2994,1,0,1,0,-1
2995,0,0,39,0,-39
2996,0,0,2,0,-2
2997,1,1,644,1484,840
2998,1,1,73,1502,1429
2999,0,0,15,0,-15
3000,0,0,48,0,-48
3001,0,0,95,0,-95
3002,0,0,15,0,-15
3003,1,0,43,0,-43
3004,0,0,10,0,-10
3005,1,1,313,1458,1145
3006,0,0,87,0,-87
3007,1,0,69,0,-69
3008,0,0,87,0,-87
3009,0,0,35,0,-35
3010,1,1,149,1371,1222
3011,0,0,47,0,-47
3012,0,0,46,0,-46
3013,0,0,19,0,-19
3014,0,0,45,0,-45
3015,1,0,60,0,-60
3016,1,0,79,0,-79
3017,1,0,10,0,-10
3018,1,0,56,0,-56
3019,0,0,108,0,-108
3020,1,0,21,0,-21
3021,0,0,31,0,-31
3022,0,0,94,0,-94
3023,1,0,41,0,-41
3024,0,0,40,0,-40
3025,1,0,1,0,-1
3026,1,0,223,0,-223
3027,0,0,141,0,-141
3028,1,1,281,1292,1011
3029,0,0,116,0,-116
3030,0,0,24,0,-24
3031,0,0,46,0,-46
3032,0,0,79,0,-79
3033,1,0,119,0,-119
3034,1,0,190,0,-190
3035,1,1,1939,1341,-598
3036,1,1,733,1380,647
3037,0,0,63,0,-63
3038,1,0,29,0,-29
3039,0,0,65,0,-65
3040,1,0,66,0,-66
3041,0,0,60,0,-60
3042,1,1,176,1242,1066
3043,0,0,66,0,-66
3044,1,0,109,0,-109
3045,1,0,38,0,-38
3046,0,0,103,0,-103
3047,0,0,43,0,-43
3048,1,0,32,0,-32
3049,0,0,6,0,-6
3050,0,0,31,0,-31
3051,0,0,102,0,-102
3052,1,0,21,0,-21
3053,1,0,81,0,-81
3054,0,0,43,0,-43
3055,1,1,1153,1828,675
3056,1,1,871,1320,449
3057,0,0,257,0,-257
3058,0,0,14,0,-14
3059,0,0,140,0,-140
3060,1,1,426,1477,1051
3061,1,0,78,0,-78
3062,0,0,24,0,-24
3063,0,0,0,0,0
3064,0,0,13,0,-13
3065,0,0,16,0,-16
3066,1,0,30,0,-30
3067,0,0,43,0,-43
3068,1,0,33,0,-33
3069,0,0,248,0,-248
3070,1,1,509,1291,782
3071,0,0,2,0,-2
3072,1,0,89,0,-89
3073,0,0,35,0,-35
3074,0,0,2,0,-2
3075,0,0,67,0,-67
3076,1,0,54,0,-54
3077,1,1,498,1425,927
3078,1,0,89,0,-89
3079,1,1,933,1817,884
3080,0,0,16,0,-16
3081,1,1,257,1225,968
3082,0,0,11,0,-11
3083,1,1,660,1766,1106
3084,1,0,6,0,-6
3085,1,1,246,1500,1254
3086,1,0,7,0,-7
3087,0,0,35,0,-35
3088,1,1,591,1209,618
3089,1,1,372,1200,828
3090,1,0,7,0,-7
3091,1,1,607,1235,628
3092,1,1,452,1252,800
3093,1,0,70,0,-70
3094,1,1,534,1268,734
3095,0,0,0,0,0
3096,0,0,65,0,-65
3097,0,0,33,0,-33
3098,0,0,36,0,-36
3099,1,1,116,1242,1126
3100,1,1,234,1484,1250
3101,0,0,6,0,-6
3102,0,0,1,0,-1
3103,1,1,391,1975,1584
3104,1,1,327,1289,962
3105,0,0,9,0,-9
3106,1,1,1119,1432,313
3107,0,0,15,0,-15
3108,1,1,731,1267,536
3109,0,0,41,0,-41
3110,0,0,37,0,-37
3111,1,1,263,1259,996
3112,0,0,23,0,-23
3113,1,1,914,1228,314
3114,1,0,127,0,-127
3115,1,0,61,0,-61
3116,1,0,10,0,-10
3117,0,0,21,0,-21
3118,0,0,17,0,-17
3119,1,1,126,1220,1094
3120,1,1,197,1608,1411
3121,0,0,6,0,-6
3122,1,1,1565,1283,-282
3123,1,1,95,1350,1255
3124,1,0,62,0,-62
3125,1,1,114,1596,1482
3126,1,1,763,1838,1075
3127,1,1,162,2068,1906
3128,1,1,94,1573,1479
3129,1,1,26,1349,1323
3130,0,0,0,0,0
3131,1,0,2,0,-2
3132,0,0,13,0,-13
3133,0,0,84,0,-84
3134,1,1,649,1445,796
3135,1,1,568,1289,721
3136,0,0,72,0,-72
3137,0,0,105,0,-105
3138,0,0,40,0,-40
3139,1,1,785,1387,602
3140,0,0,34,0,-34
3141,1,1,989,1450,461
3142,0,0,7,0,-7
3143,0,0,66,0,-66
3144,1,0,95,0,-95
3145,0,0,30,0,-30
3146,0,0,9,0,-9
3147,0,0,0,0,0
3148,1,1,628,1357,729
3149,1,0,84,0,-84
3150,1,0,32,0,-32
3151,0,0,15,0,-15
3152,1,1,433,1332,899
3153,0,0,54,0,-54
3154,1,0,84,0,-84
3155,1,0,73,0,-73
3156,1,1,290,1464,1174
3157,1,1,282,1984,1702
3158,1,0,40,0,-40
3159,1,0,65,0,-65
3160,1,0,12,0,-12
3161,1,1,585,1281,696
3162,0,0,37,0,-37
3163,1,1,100,1224,1124
3164,1,0,179,0,-179
3165,0,0,18,0,-18
3166,1,1,222,1698,1476
3167,1,0,9,0,-9
3168,1,1,1648,1755,107
3169,1,0,41,0,-41
3170,0,0,161,0,-161
3171,1,0,15,0,-15
3172,1,0,10,0,-10
3173,1,0,51,0,-51
3174,1,1,299,1465,1166
3175,1,1,308,1602,1294
3176,0,0,24,0,-24
3177,1,0,117,0,-117
3178,0,0,20,0,-20
3179,1,0,237,0,-237
3180,1,0,87,0,-87
3181,1,1,151,1495,1344
3182,0,0,2,0,-2
3183,1,0,48,0,-48
3184,1,0,11,0,-11
3185,0,0,47,0,-47
3186,0,0,9,0,-9
3187,1,0,35,0,-35
3188,1,1,239,2306,2067
3189,1,0,120,0,-120
3190,1,1,407,1736,1329
3191,1,0,116,0,-116
3192,1,1,576,1975,1399
3193,1,1,747,1522,775
3194,1,0,24,0,-24
3195,0,0,75,0,-75
3196,0,0,12,0,-12
3197,1,0,62,0,-62
3198,1,1,320,1831,1511
3199,0,0,36,0,-36
3200,0,0,140,0,-140
3201,0,0,141,0,-141
3202,0,0,48,0,-48
3203,0,0,160,0,-160
3204,1,1,141,1236,1095
3205,1,0,15,0,-15
3206,0,0,12,0,-12
3207,1,0,47,0,-47
3208,0,0,65,0,-65
3209,0,0,3,0,-3
3210,0,0,21,0,-21
3211,1,0,12,0,-12
3212,0,0,12,0,-12
3213,1,1,264,1648,1384
3214,1,1,151,2067,1916
3215,1,1,787,1436,649
3216,1,0,93,0,-93
3217,1,0,129,0,-129
3218,0,0,82,0,-82
3219,0,0,0,0,0
3220,0,0,46,0,-46
3221,0,0,66,0,-66
3222,0,0,86,0,-86
3223,1,1,823,1412,589
3224,0,0,52,0,-52
3225,1,0,160,0,-160
3226,0,0,4,0,-4
3227,0,0,45,0,-45
3228,1,0,26,0,-26
3229,0,0,25,0,-25
3230,1,0,49,0,-49
3231,0,0,31,0,-31
3232,0,0,33,0,-33
3233,0,0,5,0,-5
3234,1,0,35,0,-35
3235,1,1,528,1854,1326
3236,0,0,40,0,-40
3237,1,1,64,1215,1151
3238,1,1,572,1329,757
3239,1,1,2416,1813,-603
3240,1,0,160,0,-160
3241,0,0,109,0,-109
3242,1,1,114,1256,1142
3243,0,0,8,0,-8
3244,1,0,61,0,-61
3245,1,1,961,1311,350
3246,0,0,21,0,-21
3247,1,1,410,1325,915
3248,1,0,96,0,-96
3249,1,1,457,1453,996
3250,1,1,2,1614,1612
3251,0,0,7,0,-7
3252,0,0,11,0,-11
3253,1,1,493,1624,1131
3254,1,0,7,0,-7
3255,1,1,46,1221,1175
3256,1,1,130,1247,1117
3257,1,1,1229,1636,407
3258,0,0,27,0,-27
3259,0,0,45,0,-45
3260,1,1,401,1228,827
3261,1,1,180,1308,1128
3262,1,0,18,0,-18
3263,1,1,107,1944,1837
3264,0,0,9,0,-9
3265,0,0,178,0,-178
3266,0,0,107,0,-107
3267,1,1,93,1902,1809
3268,1,1,932,1660,728
3269,1,1,385,1447,1062
3270,1,0,14,0,-14
3271,0,0,5,0,-5
3272,0,0,69,0,-69
3273,0,0,50,0,-50
3274,1,1,891,1764,873
3275,1,1,304,1490,1186
3276,1,0,36,0,-36
3277,1,1,740,1725,985
3278,1,0,19,0,-19
3279,0,0,55,0,-55
3280,1,0,14,0,-14
3281,1,1,2227,1247,-980
3282,0,0,24,0,-24
3283,0,0,131,0,-131
3284,0,0,27,0,-27
3285,1,0,4,0,-4
3286,1,0,5,0,-5
3287,1,1,301,1803,1502
3288,1,0,3,0,-3
3289,0,0,0,0,0
3290,1,1,179,1541,1362
3291,1,1,960,1319,359
3292,1,1,1990,3983,1993
3293,1,1,418,2183,1765
3294,0,0,112,0,-112
3295,1,0,95,0,-95
3296,1,0,3,0,-3
3297,0,0,70,0,-70
3298,1,0,26,0,-26
3299,0,0,25,0,-25
3300,1,0,5,0,-5
3301,0,0,34,0,-34
3302,1,1,268,1318,1050
3303,0,0,65,0,-65
3304,0,0,4,0,-4
3305,0,0,68,0,-68
3306,1,0,38,0,-38
3307,1,1,189,1660,1471
3308,1,0,3,0,-3
3309,0,0,43,0,-43
3310,1,1,98,1854,1756
3311,0,0,28,0,-28
3312,1,1,933,1298,365
3313,1,1,417,1218,801
3314,0,0,70,0,-70
3315,1,1,339,2736,2397
3316,1,0,13,0,-13
3317,0,0,72,0,-72
3318,0,0,40,0,-40
3319,1,1,1639,1262,-377
3320,1,1,58,2171,2113
3321,1,0,14,0,-14
3322,0,0,23,0,-23
3323,1,1,198,1479,1281
3324,1,0,14,0,-14
3325,1,1,575,1663,1088
3326,1,0,55,0,-55
3327,0,0,1,0,-1
3328,1,1,120,1686,1566
3329,1,0,105,0,-105
3330,0,0,214,0,-214
3331,1,0,24,0,-24
3332,1,1,82,1390,1308
3333,1,0,40,0,-40
3334,1,1,745,1222,477
3335,1,1,552,1275,723
3336,1,1,35,1340,1305
3337,0,0,25,0,-25
3338,1,1,21,1218,1197
3339,0,0,10,0,-10
3340,1,0,0,0,0
3341,1,0,30,0,-30
3342,1,0,36,0,-36
3343,1,0,159,0,-159
3344,0,0,4,0,-4
3345,1,0,202,0,-202
3346,1,0,33,0,-33
3347,1,1,1199,2039,840
3348,1,0,28,0,-28
3349,0,0,3,0,-3
3350,0,0,5,0,-5
3351,0,0,18,0,-18
3352,1,1,414,2043,1629
3353,1,0,57,0,-57
3354,0,0,27,0,-27
3355,0,0,15,0,-15
3356,0,0,15,0,-15
3357,1,0,80,0,-80
3358,0,0,43,0,-43
3359,1,0,3,0,-3
3360,1,0,13,0,-13
3361,0,0,43,0,-43
3362,0,0,83,0,-83
3363,0,0,18,0,-18
3364,1,0,76,0,-76
3365,1,0,48,0,-48
3366,0,0,22,0,-22
3367,1,0,20,0,-20
3368,1,0,59,0,-59
3369,0,0,82,0,-82
3370,1,1,122,1224,1102
3371,1,1,298,1744,1446
3372,1,0,41,0,-41
3373,1,0,96,0,-96
3374,1,1,107,1651,1544
3375,1,1,44,1618,1574
3376,1,1,564,1881,1317
3377,1,0,1,0,-1
3378,1,0,50,0,-50
3379,1,1,668,1238,570
3380,0,0,66,0,-66
3381,1,0,75,0,-75
3382,1,1,116,1434,1318
3383,1,1,496,1219,723
3384,1,0,90,0,-90
3385,1,0,14,0,-14
3386,1,0,0,0,0
3387,1,1,913,1287,374
3388,0,0,80,0,-80
3389,1,0,150,0,-150
3390,0,0,8,0,-8
3391,1,1,515,1512,997
3392,0,0,50,0,-50
3393,1,1,294,1219,925
3394,1,1,921,1603,682
3395,0,0,22,0,-22
3396,1,1,233,2502,2269
3397,1,1,85,1607,1522
3398,0,0,11,0,-11
3399,1,0,54,0,-54
3400,0,0,106,0,-106
3401,1,0,4,0,-4
3402,1,1,487,1300,813
3403,1,0,29,0,-29
3404,1,1,110,1377,1267
3405,0,0,82,0,-82
3406,0,0,54,0,-54
3407,0,0,124,0,-124
3408,1,1,174,2332,2158
3409,1,0,49,0,-49
3410,0,0,14,0,-14
3411,1,1,1780,2127,347
3412,1,0,10,0,-10
3413,1,0,1,0,-1
3414,1,1,230,1906,1676
3415,1,1,2368,1734,-634
3416,1,0,18,0,-18
3417,1,0,1,0,-1
3418,0,0,56,0,-56
3419,1,0,38,0,-38
3420,1,0,11,0,-11
3421,1,1,472,1970,1498
3422,1,0,9,0,-9
3423,0,0,110,0,-110
3424,1,0,146,0,-146
3425,1,1,56,1843,1787
3426,0,0,24,0,-24
3427,1,1,706,1635,929
3428,0,0,92,0,-92
3429,0,0,56,0,-56
3430,1,0,60,0,-60
3431,1,1,77,1600,1523
3432,1,0,23,0,-23
3433,0,0,7,0,-7
3434,0,0,42,0,-42
3435,0,0,68,0,-68
3436,1,1,695,1672,977
3437,1,0,81,0,-81
3438,0,0,25,0,-25
3439,1,1,317,1713,1396
3440,0,0,27,0,-27
3441,0,0,20,0,-20
3442,1,1,110,1214,1104
3443,1,0,30,0,-30
3444,0,0,59,0,-59
3445,0,0,29,0,-29
3446,1,1,559,1532,973
3447,0,0,29,0,-29
3448,0,0,175,0,-175
3449,1,1,496,1291,795
3450,0,0,3,0,-3
3451,1,1,649,2418,1769
3452,1,1,908,1419,511
3453,0,0,142,0,-142
3454,0,0,20,0,-20
3455,0,0,23,0,-23
3456,0,0,94,0,-94
3457,0,0,46,0,-46
3458,1,0,54,0,-54
3459,1,0,67,0,-67
3460,0,0,28,0,-28
3461,0,0,50,0,-50
3462,0,0,142,0,-142
3463,0,0,110,0,-110
3464,0,0,63,0,-63
3465,1,1,224,1496,1272
3466,0,0,170,0,-170
3467,1,0,34,0,-34
3468,1,1,1005,1213,208
3469,1,0,70,0,-70
3470,1,1,646,1727,1081
3471,0,0,94,0,-94
3472,0,0,108,0,-108
3473,0,0,39,0,-39
3474,1,1,154,1615,1461
3475,0,0,2,0,-2
3476,0,0,0,0,0
3477,0,0,38,0,-38
3478,1,0,56,0,-56
3479,1,0,73,0,-73
3480,0,0,48,0,-48
3481,1,1,636,1903,1267
3482,1,0,23,0,-23
3483,0,0,102,0,-102
3484,1,0,37,0,-37
3485,0,0,75,0,-75
3486,1,1,951,1205,254
3487,1,0,115,0,-115
3488,0,0,197,0,-197
3489,1,0,6,0,-6
3490,1,1,50,1628,1578
3491,1,0,6,0,-6
3492,1,1,107,1260,1153
3493,1,1,170,1556,1386
3494,1,0,13,0,-13
3495,1,1,276,1295,1019
3496,0,0,7,0,-7
3497,1,1,255,1578,1323
3498,1,0,65,0,-65
3499,1,1,604,1831,1227
3500,1,0,40,0,-40
3501,1,1,207,1531,1324
3502,1,0,100,0,-100
3503,0,0,125,0,-125
3504,1,0,21,0,-21
3505,0,0,38,0,-38
3506,0,0,15,0,-15
3507,1,0,6,0,-6
3508,0,0,46,0,-46
3509,1,0,37,0,-37
3510,1,1,1022,1722,700
3511,1,1,1275,1618,343
3512,0,0,28,0,-28
3513,0,0,2,0,-2
3514,1,0,3,0,-3
3515,1,1,123,1201,1078
3516,0,0,35,0,-35
3517,1,0,2,0,-2
3518,1,1,468,2951,2483
3519,1,1,757,1451,694
3520,1,1,353,1320,967
3521,1,1,315,1555,1240
3522,0,0,53,0,-53
3523,1,1,533,1252,719
3524,0,0,0,0,0
3525,0,0,5,0,-5
3526,1,0,153,0,-153
3527,0,0,43,0,-43
3528,1,1,667,1629,962
3529,1,1,239,1234,995
3530,0,0,56,0,-56
3531,0,0,61,0,-61
3532,1,0,33,0,-33
3533,1,1,196,1272,1076
3534,1,0,48,0,-48
3535,1,0,134,0,-134
3536,0,0,61,0,-61
3537,0,0,59,0,-59
3538,1,1,1733,1265,-468
3539,0,0,7,0,-7
3540,1,0,60,0,-60
3541,0,0,11,0,-11
3542,1,1,2181,1492,-689
3543,1,1,391,1930,1539
3544,1,1,513,1723,1210
3545,1,1,501,1421,920
3546,0,0,1,0,-1
3547,0,0,93,0,-93
3548,1,1,409,1833,1424
3549,1,1,1132,1713,581
3550,1,0,80,0,-80
3551,1,1,293,1238,945
3552,0,0,37,0,-37
3553,0,0,116,0,-116
3554,1,0,35,0,-35
3555,1,1,137,1475,1338
3556,1,1,536,1387,851
3557,1,0,32,0,-32
3558,0,0,55,0,-55
3559,1,1,271,1842,1571
3560,0,0,35,0,-35
3561,0,0,56,0,-56
3562,0,0,12,0,-12
3563,0,0,10,0,-10
3564,1,1,256,2010,1754
3565,0,0,10,0,-10
3566,0,0,241,0,-241
3567,0,0,56,0,-56
3568,1,1,607,2142,1535
3569,0,0,29,0,-29
3570,1,1,51,1424,1373
3571,1,0,50,0,-50
3572,1,1,365,1386,1021
3573,0,0,63,0,-63
3574,1,1,13,2041,2028
3575,1,1,183,1450,1267
3576,0,0,102,0,-102
3577,1,0,86,0,-86
3578,1,0,17,0,-17
3579,0,0,69,0,-69
3580,1,0,12,0,-12
3581,1,1,546,1352,806
3582,1,0,56,0,-56
3583,1,0,102,0,-102
3584,1,0,24,0,-24
3585,1,1,333,1212,879
3586,1,1,2467,2342,-125
3587,0,0,42,0,-42
3588,1,0,57,0,-57
3589,0,0,3,0,-3
3590,1,1,162,2852,2690
3591,0,0,13,0,-13
3592,1,1,257,1349,1092
3593,1,0,44,0,-44
3594,1,0,20,0,-20
3595,0,0,32,0,-32
3596,0,0,17,0,-17
3597,1,1,666,1326,660
3598,1,0,49,0,-49
3599,1,1,356,1210,854
3600,0,0,226,0,-226
3601,0,0,256,0,-256
3602,1,1,559,1252,693
3603,0,0,39,0,-39
3604,0,0,190,0,-190
3605,1,1,2004,1225,-779
3606,0,0,14,0,-14
3607,0,0,24,0,-24
3608,1,1,802,1544,742
3609,0,0,20,0,-20
3610,0,0,31,0,-31
3611,0,0,42,0,-42
3612,0,0,38,0,-38
3613,1,1,41,2026,1985
3614,1,1,614,1353,739
3615,0,0,144,0,-144
3616,1,0,14,0,-14
3617,1,1,352,1318,966
3618,1,0,29,0,-29
3619,1,0,98,0,-98
3620,1,1,464,1880,1416
3621,1,0,61,0,-61
3622,0,0,86,0,-86
3623,1,1,142,1529,1387
3624,1,1,1161,2782,1621
3625,0,0,40,0,-40
3626,1,0,39,0,-39
3627,1,0,58,0,-58
3628,0,0,10,0,-10
3629,1,1,3676,1523,-2153
3630,1,0,58,0,-58
3631,1,0,14,0,-14
3632,0,0,119,0,-119
3633,0,0,60,0,-60
3634,1,0,27,0,-27
3635,1,1,344,1349,1005
3636,0,0,32,0,-32
3637,1,0,81,0,-81
3638,0,0,8,0,-8
3639,1,1,536,1649,1113
3640,1,1,314,2174,1860
3641,1,1,434,1377,943
3642,1,0,23,0,-23
3643,0,0,35,0,-35
3644,0,0,22,0,-22
3645,1,1,285,1500,1215
3646,0,0,125,0,-125
3647,1,1,20,1459,1439
3648,0,0,41,0,-41
3649,1,0,103,0,-103
3650,1,1,113,1594,1481
3651,1,1,876,1501,625
3652,1,0,28,0,-28
3653,1,1,409,1863,1454
3654,1,1,580,1217,637
3655,0,0,24,0,-24
3656,1,1,234,1331,1097
3657,1,0,81,0,-81
3658,0,0,6,0,-6
3659,1,0,20,0,-20
3660,0,0,62,0,-62
3661,1,1,183,1478,1295
3662,0,0,21,0,-21
3663,1,1,655,1800,1145
3664,1,1,1180,1315,135
3665,0,0,59,0,-59
3666,1,1,749,1872,1123
3667,0,0,38,0,-38
3668,0,0,38,0,-38
3669,0,0,20,0,-20
3670,1,0,39,0,-39
3671,1,1,64,1597,1533
3672,1,1,163,1548,1385
3673,1,1,340,1407,1067
3674,1,1,771,1810,1039
3675,0,0,17,0,-17
3676,1,1,103,2707,2604
3677,1,1,543,1500,957
3678,1,1,1429,1386,-43
3679,1,0,55,0,-55
3680,0,0,2,0,-2
3681,0,0,11,0,-11
3682,0,0,19,0,-19
3683,1,1,304,1424,1120
3684,0,0,64,0,-64
3685,0,0,82,0,-82
3686,0,0,60,0,-60
3687,1,0,6,0,-6
3688,1,0,49,0,-49
3689,1,1,603,2294,1691
3690,0,0,7,0,-7
3691,1,1,200,1207,1007
3692,1,1,43,2183,2140
3693,1,1,1249,1428,179
3694,0,0,9,0,-9
3695,0,0,55,0,-55
3696,1,0,29,0,-29
3697,1,1,207,1206,999
3698,1,1,975,1287,312
3699,0,0,51,0,-51
3700,0,0,39,0,-39
3701,1,0,10,0,-10
3702,0,0,15,0,-15
3703,1,0,62,0,-62
3704,0,0,49,0,-49
3705,0,0,40,0,-40
3706,0,0,45,0,-45
3707,0,0,61,0,-61
3708,1,1,117,1315,1198
3709,0,0,44,0,-44
3710,1,0,169,0,-169
3711,0,0,57,0,-57
3712,0,0,166,0,-166
3713,1,1,188,1415,1227
3714,1,0,43,0,-43
3715,0,0,21,0,-21
3716,1,1,479,1201,722
3717,0,0,201,0,-201
3718,0,0,5,0,-5
3719,0,0,70,0,-70
3720,1,1,100,1302,1202
3721,0,0,10,0,-10
3722,1,1,571,1525,954
3723,0,0,34,0,-34
3724,1,0,67,0,-67
3725,1,0,64,0,-64
3726,0,0,136,0,-136
3727,1,1,829,1929,1100
3728,1,1,133,1282,1149
3729,1,1,430,1762,1332
3730,0,0,68,0,-68
3731,1,1,388,1349,961
3732,1,0,88,0,-88
3733,1,1,573,1416,843
3734,0,0,10,0,-10
3735,0,0,104,0,-104
3736,1,1,826,1952,1126
3737,1,0,95,0,-95
3738,1,1,543,1223,680
3739,1,1,507,1497,990
3740,0,0,29,0,-29
3741,0,0,0,0,0
3742,0,0,10,0,-10
3743,1,0,145,0,-145
3744,1,1,123,1322,1199
3745,0,0,5,0,-5
3746,1,1,822,1356,534
3747,1,0,26,0,-26
3748,0,0,6,0,-6
3749,1,1,900,1444,544
3750,0,0,44,0,-44
3751,0,0,33,0,-33
3752,0,0,4,0,-4
3753,1,0,26,0,-26
3754,0,0,105,0,-105
3755,1,0,113,0,-113
3756,0,0,332,0,-332
3757,0,0,55,0,-55
3758,0,0,2,0,-2
3759,0,0,13,0,-13
3760,1,0,15,0,-15
3761,1,1,1660,1321,-339
3762,1,0,48,0,-48
3763,1,1,580,1467,887
3764,1,1,2606,1278,-1328
3765,1,0,23,0,-23
3766,1,1,215,2166,1951
3767,1,1,400,1599,1199
3768,0,0,21,0,-21
3769,0,0,7,0,-7
3770,1,1,615,1580,965
3771,1,0,150,0,-150
3772,0,0,70,0,-70
3773,0,0,160,0,-160
3774,1,1,292,1799,1507
3775,1,0,54,0,-54
3776,1,1,520,1504,984
3777,1,0,6,0,-6
3778,0,0,6,0,-6
3779,1,0,181,0,-181
3780,0,0,4,0,-4
3781,0,0,166,0,-166
3782,1,0,9,0,-9
3783,1,1,115,1886,1771
3784,0,0,17,0,-17
3785,1,0,31,0,-31
3786,1,0,15,0,-15
3787,0,0,8,0,-8
3788,1,1,133,1561,1428
3789,1,0,169,0,-169
3790,0,0,7,0,-7
3791,1,0,43,0,-43
3792,1,1,444,1201,757
3793,1,0,1,0,-1
3794,1,1,805,2255,1450
3795,1,0,2,0,-2
3796,1,1,65,1578,1513
3797,1,1,1043,2126,1083
3798,1,0,111,0,-111
3799,1,1,520,2853,2333
3800,0,0,0,0,0
3801,0,0,18,0,-18
3802,0,0,28,0,-28
3803,1,0,97,0,-97
3804,0,0,4,0,-4
3805,1,0,19,0,-19
3806,0,0,7,0,-7
3807,1,0,94,0,-94
3808,1,0,55,0,-55
3809,0,0,254,0,-254
3810,1,1,335,2051,1716
3811,1,0,0,0,0
3812,1,1,415,1343,928
3813,0,0,119,0,-119
3814,1,1,666,1308,642
3815,0,0,187,0,-187
3816,0,0,2,0,-2
3817,1,1,1201,1393,192
3818,1,1,184,1258,1074
3819,1,1,74,1501,1427
3820,1,0,5,0,-5
3821,0,0,144,0,-144
3822,1,1,978,1327,349
3823,1,1,150,1323,1173
3824,1,1,27,1945,1918
3825,1,0,82,0,-82
3826,0,0,63,0,-63
3827,0,0,101,0,-101
3828,0,0,166,0,-166
3829,1,0,68,0,-68
3830,1,1,267,1725,1458
3831,0,0,0,0,0
3832,1,0,34,0,-34
3833,0,0,0,0,0
3834,1,0,34,0,-34
3835,1,0,59,0,-59
3836,0,0,36,0,-36
3837,1,0,215,0,-215
3838,1,0,17,0,-17
3839,1,0,67,0,-67
3840,1,1,163,1373,1210
3841,0,0,27,0,-27
3842,1,1,380,1597,1217
3843,0,0,10,0,-10
3844,0,0,12,0,-12
3845,1,0,95,0,-95
3846,1,1,326,1388,1062
3847,1,0,42,0,-42
3848,0,0,29,0,-29
3849,1,1,38,1648,1610
3850,0,0,1,0,-1
3851,0,0,19,0,-19
3852,0,0,141,0,-141
3853,0,0,47,0,-47
3854,1,1,35,1386,1351
3855,0,0,9,0,-9
3856,0,0,0,0,0
3857,0,0,89,0,-89
3858,1,0,22,0,-22
3859,0,0,331,0,-331
3860,0,0,60,0,-60
3861,1,0,12,0,-12
3862,0,0,108,0,-108
3863,1,0,7,0,-7
3864,0,0,4,0,-4
3865,0,0,271,0,-271
3866,0,0,15,0,-15
3867,1,0,10,0,-10
3868,0,0,26,0,-26
3869,1,0,4,0,-4
3870,1,0,77,0,-77
3871,1,0,76,0,-76
3872,1,0,8,0,-8
3873,1,1,540,2019,1479
3874,1,0,35,0,-35
3875,0,0,12,0,-12
3876,0,0,44,0,-44
3877,1,1,613,1662,1049
3878,0,0,6,0,-6
3879,1,0,13,0,-13
3880,0,0,70,0,-70
3881,0,0,10,0,-10
3882,0,0,90,0,-90
3883,1,1,551,1357,806
3884,1,1,392,1201,809
3885,1,1,72,1201,1129
3886,0,0,26,0,-26
3887,1,0,59,0,-59
3888,1,0,11,0,-11
3889,1,0,18,0,-18
3890,1,1,664,1316,652
3891,1,0,57,0,-57
3892,0,0,43,0,-43
3893,1,0,95,0,-95
3894,0,0,97,0,-97
3895,1,0,94,0,-94
3896,1,1,312,1644,1332
3897,1,0,98,0,-98
3898,1,0,101,0,-101
3899,1,0,2,0,-2
3900,0,0,112,0,-112
3901,1,0,102,0,-102
3902,0,0,3,0,-3
3903,1,0,81,0,-81
3904,0,0,2,0,-2
3905,0,0,1,0,-1
3906,0,0,26,0,-26
3907,1,1,434,1268,834
3908,0,0,195,0,-195
3909,1,0,24,0,-24
3910,0,0,94,0,-94
3911,1,1,988,1408,420
3912,1,0,61,0,-61
3913,1,0,5,0,-5
3914,1,0,14,0,-14
3915,1,1,498,1329,831
3916,0,0,4,0,-4
3917,0,0,40,0,-40
3918,0,0,80,0,-80
3919,0,0,14,0,-14
3920,0,0,108,0,-108
3921,0,0,115,0,-115
3922,0,0,7,0,-7
3923,1,0,6,0,-6
3924,0,0,35,0,-35
3925,1,0,46,0,-46
3926,1,1,431,1274,843
3927,1,1,144,1228,1084
3928,1,1,169,2276,2107
3929,0,0,47,0,-47
3930,1,0,3,0,-3
3931,1,0,3,0,-3
3932,0,0,26,0,-26
3933,0,0,132,0,-132
3934,1,0,21,0,-21
3935,0,0,45,0,-45
3936,1,0,109,0,-109
3937,1,0,165,0,-165
3938,1,1,128,1466,1338
3939,0,0,148,0,-148
3940,1,1,269,1297,1028
3941,0,0,35,0,-35
3942,0,0,29,0,-29
3943,1,1,659,2827,2168
3944,1,1,758,1620,862
3945,0,0,28,0,-28
3946,0,0,18,0,-18
3947,1,1,379,1483,1104
3948,1,0,79,0,-79
3949,1,0,42,0,-42
3950,1,1,31,1788,1757
3951,0,0,16,0,-16
3952,0,0,15,0,-15
3953,0,0,15,0,-15
3954,1,0,39,0,-39
3955,1,0,30,0,-30
3956,1,0,97,0,-97
3957,1,0,48,0,-48
3958,1,0,9,0,-9
3959,1,0,15,0,-15
3960,1,1,979,1210,231
3961,0,0,32,0,-32
3962,0,0,16,0,-16
3963,0,0,101,0,-101
3964,1,0,21,0,-21
3965,1,0,7,0,-7
3966,0,0,12,0,-12
3967,1,0,2,0,-2
3968,0,0,95,0,-95
3969,1,1,1235,1268,33
3970,0,0,57,0,-57
3971,0,0,39,0,-39
3972,0,0,38,0,-38
3973,0,0,46,0,-46
3974,0,0,2,0,-2
3975,0,0,20,0,-20
3976,0,0,101,0,-101
3977,0,0,38,0,-38
3978,0,0,51,0,-51
3979,0,0,1,0,-1
3980,1,0,21,0,-21
3981,1,0,13,0,-13
3982,0,0,5,0,-5
3983,0,0,36,0,-36
3984,1,0,33,0,-33
3985,0,0,287,0,-287
3986,1,1,304,1364,1060
3987,1,1,117,1544,1427
3988,1,1,67,1568,1501
3989,1,0,72,0,-72
3990,1,0,137,0,-137
3991,1,0,52,0,-52
3992,1,0,17,0,-17
3993,0,0,47,0,-47
3994,1,0,10,0,-10
3995,1,1,1336,1493,157
3996,1,1,160,2303,2143
3997,1,0,34,0,-34
3998,1,1,1448,1898,450
3999,1,0,1,0,-1
4000,1,0,21,0,-21
4001,1,0,1,0,-1
4002,1,1,526,2008,1482
4003,0,0,2,0,-2
4004,0,0,1,0,-1
4005,1,1,191,1212,1021
4006,1,1,91,2587,2496
4007,0,0,28,0,-28
4008,1,0,106,0,-106
4009,0,0,74,0,-74
4010,0,0,14,0,-14
4011,1,0,43,0,-43
4012,0,0,72,0,-72
4013,0,0,102,0,-102
4014,1,1,285,2033,1748
4015,0,0,81,0,-81
4016,1,0,7,0,-7
4017,0,0,24,0,-24
4018,1,1,697,1530,833
4019,1,1,817,1382,565
4020,1,0,58,0,-58
4021,1,0,47,0,-47
4022,0,0,5,0,-5
4023,1,0,34,0,-34
4024,1,1,889,1781,892
4025,1,1,1615,1637,22
4026,0,0,45,0,-45
4027,0,0,3,0,-3
4028,1,0,12,0,-12
4029,1,0,100,0,-100
4030,1,1,832,2021,1189
4031,1,1,1420,1266,-154
4032,0,0,10,0,-10
4033,1,0,41,0,-41
4034,1,0,8,0,-8
4035,1,0,90,0,-90
4036,1,0,0,0,0
4037,1,0,50,0,-50
4038,1,0,61,0,-61
4039,1,1,369,2266,1897
4040,1,1,322,1870,1548
4041,0,0,8,0,-8
4042,1,1,217,1273,1056
4043,0,0,2,0,-2
4044,1,1,185,1702,1517
4045,1,1,228,1209,981
4046,1,1,463,1249,786
4047,1,0,12,0,-12
4048,0,0,8,0,-8
4049,1,1,726,1267,541
4050,0,0,20,0,-20
4051,1,1,547,1677,1130
4052,1,0,58,0,-58
4053,1,0,5,0,-5
4054,0,0,16,0,-16
4055,1,0,433,0,-433
4056,0,0,21,0,-21
4057,1,0,71,0,-71
4058,1,1,122,1613,1491
4059,0,0,74,0,-74
4060,1,1,353,1465,1112
4061,0,0,25,0,-25
4062,1,1,1248,1633,385
4063,0,0,17,0,-17
4064,1,0,2,0,-2
4065,1,1,143,1367,1224
4066,1,0,10,0,-10
4067,1,1,225,1267,1042
4068,1,0,0,0,0
4069,1,1,247,1593,1346
4070,0,0,84,0,-84
4071,0,0,109,0,-109
4072,1,1,1378,1412,34
4073,0,0,35,0,-35
4074,0,0,97,0,-97
4075,0,0,7,0,-7
4076,0,0,44,0,-44
4077,1,0,51,0,-51
4078,0,0,4,0,-4
4079,1,0,24,0,-24
4080,1,1,146,1378,1232
4081,1,1,238,2787,2549
4082,0,0,6,0,-6
4083,0,0,53,0,-53
4084,0,0,4,0,-4
4085,0,0,37,0,-37
4086,1,0,28,0,-28
4087,1,0,17,0,-17
4088,0,0,37,0,-37
4089,1,1,45,1268,1223
4090,1,1,1452,1975,523
4091,1,0,30,0,-30
4092,1,1,799,1490,691
4093,0,0,3,0,-3
4094,0,0,15,0,-15
4095,1,0,57,0,-57
4096,1,1,1927,1207,-720
4097,1,1,2006,1243,-763
4098,1,0,52,0,-52
4099,1,0,12,0,-12
4100,1,0,59,0,-59
4101,0,0,1,0,-1
4102,1,1,399,1453,1054
4103,1,0,42,0,-42
4104,0,0,29,0,-29
4105,0,0,92,0,-92
4106,0,0,139,0,-139
4107,1,1,508,1266,758
4108,0,0,11,0,-11
4109,1,1,94,1756,1662
4110,1,1,422,1467,1045
4111,1,0,3,0,-3
4112,0,0,86,0,-86
4113,0,0,8,0,-8
4114,0,0,62,0,-62
4115,1,0,20,0,-20
4116,0,0,12,0,-12
4117,1,0,37,0,-37
4118,0,0,76,0,-76
4119,0,0,176,0,-176
4120,1,1,218,1423,1205
4121,1,1,249,1309,1060
4122,0,0,120,0,-120
4123,1,0,41,0,-41
4124,0,0,68,0,-68
4125,0,0,50,0,-50
4126,1,0,10,0,-10
4127,1,1,365,4095,3730
4128,1,1,227,2070,1843
4129,0,0,107,0,-107
4130,0,0,125,0,-125
4131,0,0,116,0,-116
4132,1,1,436,1698,1262
4133,1,0,13,0,-13
4134,0,0,17,0,-17
4135,0,0,32,0,-32
4136,0,0,38,0,-38
4137,1,0,31,0,-31
4138,1,1,1339,1217,-122
4139,0,0,10,0,-10
4140,1,0,82,0,-82
4141,0,0,85,0,-85
4142,1,1,278,1498,1220
4143,0,0,25,0,-25
4144,1,1,125,1271,1146
4145,1,0,12,0,-12
4146,1,0,17,0,-17
4147,0,0,26,0,-26
4148,1,1,147,1538,1391
4149,1,1,324,1357,1033
4150,1,1,564,1230,666
4151,0,0,22,0,-22
4152,0,0,59,0,-59
4153,1,0,10,0,-10
4154,0,0,7,0,-7
4155,0,0,26,0,-26
4156,1,0,11,0,-11
4157,0,0,12,0,-12
4158,1,1,315,1396,1081
4159,0,0,71,0,-71
4160,1,1,590,1220,630
4161,1,1,766,1547,781
4162,0,0,1,0,-1
4163,1,0,68,0,-68
4164,0,0,34,0,-34
4165,1,1,339,1733,1394
4166,1,1,605,1626,1021
4167,1,0,35,0,-35
4168,0,0,85,0,-85
4169,1,0,25,0,-25
4170,1,1,480,1401,921
4171,0,0,257,0,-257
4172,0,0,22,0,-22
4173,0,0,92,0,-92
4174,0,0,89,0,-89
4175,1,0,22,0,-22
4176,0,0,96,0,-96
4177,1,0,3,0,-3
4178,0,0,37,0,-37
4179,1,0,87,0,-87
4180,1,0,12,0,-12
4181,0,0,15,0,-15
4182,0,0,10,0,-10
4183,0,0,109,0,-109
4184,1,1,389,1475,1086
4185,0,0,23,0,-23
4186,1,0,22,0,-22
4187,0,0,7,0,-7
4188,1,1,333,1566,1233
4189,1,0,0,0,0
4190,1,1,180,1291,1111
4191,1,0,22,0,-22
4192,1,0,53,0,-53
4193,1,0,12,0,-12
4194,0,0,65,0,-65
4195,0,0,38,0,-38
4196,1,1,1081,4197,3116
4197,1,1,99,1673,1574
4198,0,0,1,0,-1
4199,0,0,6,0,-6
4200,1,1,1558,1557,-1
4201,1,1,1062,1272,210
4202,0,0,59,0,-59
4203,1,1,95,1206,1111
4204,0,0,2,0,-2
4205,1,1,955,1998,1043
4206,1,1,377,1503,1126
4207,0,0,51,0,-51
4208,1,1,137,1769,1632
4209,0,0,85,0,-85
4210,0,0,39,0,-39
4211,0,0,109,0,-109
4212,0,0,13,0,-13
4213,0,0,49,0,-49
4214,0,0,42,0,-42
4215,0,0,38,0,-38
4216,1,0,64,0,-64
4217,1,0,31,0,-31
4218,1,0,13,0,-13
4219,0,0,267,0,-267
4220,0,0,97,0,-97
4221,1,0,46,0,-46
4222,0,0,119,0,-119
4223,1,1,615,1307,692
4224,1,1,147,1380,1233
4225,0,0,13,0,-13
4226,1,1,554,1362,808
4227,0,0,2,0,-2
4228,1,0,121,0,-121
4229,0,0,13,0,-13
4230,1,1,365,1797,1432
4231,1,1,427,1233,806
4232,1,0,21,0,-21
4233,1,0,143,0,-143
4234,0,0,21,0,-21
4235,1,0,38,0,-38
4236,0,0,83,0,-83
4237,1,0,10,0,-10
4238,1,0,3,0,-3
4239,0,0,0,0,0
4240,1,0,205,0,-205
4241,1,1,1039,1257,218
4242,0,0,2,0,-2
4243,1,0,63,0,-63
4244,1,0,45,0,-45
4245,0,0,26,0,-26
4246,1,0,20,0,-20
4247,0,0,6,0,-6
4248,0,0,81,0,-81
4249,1,0,4,0,-4
4250,1,1,164,1216,1052
4251,1,0,78,0,-78
4252,1,1,935,2442,1507
4253,0,0,39,0,-39
4254,0,0,16,0,-16
4255,1,1,506,1308,802
4256,0,0,72,0,-72
4257,0,0,42,0,-42
4258,0,0,146,0,-146
4259,1,1,70,2485,2415
4260,0,0,23,0,-23
4261,0,0,13,0,-13
4262,1,1,232,1356,1124
4263,1,1,257,1533,1276
4264,1,0,160,0,-160
4265,1,0,3,0,-3
4266,1,0,5,0,-5
4267,0,0,26,0,-26
4268,0,0,15,0,-15
4269,1,1,1144,2091,947
4270,0,0,55,0,-55
4271,1,0,124,0,-124
4272,0,0,122,0,-122
4273,1,1,46,1939,1893
4274,1,0,13,0,-13
4275,0,0,15,0,-15
4276,1,1,758,1740,982
4277,1,0,148,0,-148
4278,0,0,32,0,-32
4279,0,0,72,0,-72
4280,1,1,451,2656,2205
4281,1,0,38,0,-38
4282,1,0,52,0,-52
4283,0,0,99,0,-99
4284,1,1,454,1431,977
4285,1,1,401,2399,1998
4286,0,0,67,0,-67
4287,0,0,49,0,-49
4288,0,0,173,0,-173
4289,0,0,44,0,-44
4290,0,0,15,0,-15
4291,1,0,0,0,0
4292,0,0,73,0,-73
4293,0,0,45,0,-45
4294,0,0,97,0,-97
4295,0,0,45,0,-45
4296,1,0,44,0,-44
4297,1,0,11,0,-11
4298,1,1,133,1407,1274
4299,1,1,207,1250,1043
4300,0,0,81,0,-81
4301,1,0,59,0,-59
4302,1,1,112,1546,1434
4303,1,1,710,1775,1065
4304,1,1,714,1517,803
4305,1,0,47,0,-47
4306,0,0,14,0,-14
4307,1,0,26,0,-26
4308,0,0,83,0,-83
4309,1,1,218,1384,1166
4310,0,0,22,0,-22
4311,0,0,37,0,-37
4312,0,0,2,0,-2
4313,1,1,1028,1379,351
4314,1,0,19,0,-19
4315,1,1,306,1214,908
4316,0,0,3,0,-3
4317,1,0,12,0,-12
4318,1,1,505,1642,1137
4319,0,0,2,0,-2
4320,1,1,206,1257,1051
4321,0,0,15,0,-15
4322,1,0,70,0,-70
4323,0,0,6,0,-6
4324,1,1,62,1604,1542
4325,0,0,1,0,-1
4326,1,0,18,0,-18
4327,0,0,44,0,-44
4328,1,0,0,0,0
4329,1,0,18,0,-18
4330,1,0,31,0,-31
4331,0,0,45,0,-45
4332,0,0,23,0,-23
4333,1,1,1802,1467,-335
4334,0,0,15,0,-15
4335,1,1,2390,1758,-632
4336,1,1,78,1561,1483
4337,0,0,16,0,-16
4338,1,1,796,2382,1586
4339,0,0,65,0,-65
4340,1,0,1,0,-1
4341,1,0,18,0,-18
4342,1,1,732,1923,1191
4343,0,0,2,0,-2
4344,0,0,3,0,-3
4345,1,1,145,1475,1330
4346,0,0,41,0,-41
4347,0,0,25,0,-25
4348,1,1,489,1589,1100
4349,1,1,592,1238,646
4350,1,0,53,0,-53
4351,0,0,0,0,0
4352,1,0,134,0,-134
4353,0,0,105,0,-105
4354,0,0,53,0,-53
4355,1,1,315,1409,1094
4356,0,0,50,0,-50
4357,1,1,156,1401,1245
4358,0,0,141,0,-141
4359,0,0,12,0,-12
4360,0,0,9,0,-9
4361,0,0,18,0,-18
4362,0,0,64,0,-64
4363,1,1,641,1562,921
4364,0,0,38,0,-38
4365,0,0,34,0,-34
4366,1,0,51,0,-51
4367,0,0,150,0,-150
4368,0,0,8,0,-8
4369,0,0,94,0,-94
4370,0,0,12,0,-12
4371,0,0,193,0,-193
4372,1,1,1748,1372,-376
4373,1,1,109,1804,1695
4374,0,0,4,0,-4
4375,1,1,307,1376,1069
4376,1,1,391,1621,1230
4377,1,0,23,0,-23
4378,0,0,6,0,-6
4379,1,0,148,0,-148
4380,1,0,16,0,-16
4381,0,0,20,0,-20
4382,1,1,355,1324,969
4383,0,0,32,0,-32
4384,1,0,37,0,-37
4385,1,0,19,0,-19
4386,0,0,22,0,-22
4387,1,1,593,1357,764
4388,1,0,3,0,-3
4389,1,1,825,1277,452
4390,1,0,168,0,-168
4391,0,0,143,0,-143
4392,1,1,383,1747,1364
4393,1,0,29,0,-29
4394,1,0,31,0,-31
4395,1,0,6,0,-6
4396,1,0,42,0,-42
4397,1,1,343,1845,1502
4398,0,0,109,0,-109
4399,0,0,66,0,-66
4400,0,0,125,0,-125
4401,1,0,102,0,-102
4402,1,1,1067,2043,976
4403,1,0,92,0,-92
4404,0,0,119,0,-119
4405,0,0,115,0,-115
4406,1,0,42,0,-42
4407,1,0,75,0,-75
4408,1,1,210,1342,1132
4409,1,0,143,0,-143
4410,1,1,504,1351,847
4411,1,0,131,0,-131
4412,1,0,5,0,-5
4413,0,0,35,0,-35
4414,0,0,27,0,-27
4415,0,0,30,0,-30
4416,1,1,289,1330,1041
4417,0,0,102,0,-102
4418,1,0,9,0,-9
4419,0,0,32,0,-32
4420,1,0,59,0,-59
4421,1,0,11,0,-11
4422,0,0,10,0,-10
4423,0,0,75,0,-75
4424,0,0,28,0,-28
4425,0,0,0,0,0
4426,1,0,31,0,-31
4427,1,1,181,1265,1084
4428,1,1,995,1839,844
4429,1,1,384,1387,1003
4430,1,0,9,0,-9
4431,0,0,2,0,-2
4432,1,1,1079,1266,187
4433,0,0,82,0,-82
4434,0,0,11,0,-11
4435,1,1,992,1337,345
4436,0,0,165,0,-165
4437,0,0,50,0,-50
4438,1,0,3,0,-3
4439,0,0,126,0,-126
4440,1,1,260,1279,1019
4441,0,0,130,0,-130
4442,1,1,131,1644,1513
4443,1,1,1768,1293,-475
4444,0,0,7,0,-7
4445,0,0,28,0,-28
4446,0,0,43,0,-43
4447,0,0,139,0,-139
4448,0,0,24,0,-24
4449,1,1,122,1888,1766
4450,0,0,101,0,-101
4451,0,0,98,0,-98
4452,1,1,189,1327,1138
4453,1,0,75,0,-75
4454,1,0,48,0,-48
4455,1,0,12,0,-12
4456,1,1,83,1363,1280
4457,1,0,111,0,-111
4458,1,0,24,0,-24
4459,1,1,810,1939,1129
4460,0,0,31,0,-31
4461,1,0,85,0,-85
4462,0,0,19,0,-19
4463,1,0,52,0,-52
4464,0,0,106,0,-106
4465,1,0,26,0,-26
4466,0,0,18,0,-18
4467,1,0,104,0,-104
4468,1,1,1151,1223,72
4469,0,0,205,0,-205
4470,1,0,18,0,-18
4471,1,1,464,1372,908
4472,1,1,1196,1632,436
4473,1,0,6,0,-6
4474,0,0,38,0,-38
4475,1,1,66,2311,2245
4476,0,0,1,0,-1
4477,0,0,8,0,-8
4478,0,0,57,0,-57
4479,1,0,52,0,-52
4480,1,0,25,0,-25
4481,1,1,271,1611,1340
4482,1,0,17,0,-17
4483,1,0,105,0,-105
4484,1,1,150,1347,1197
4485,1,0,21,0,-21
4486,1,1,336,1605,1269
4487,1,0,133,0,-133
4488,0,0,129,0,-129
4489,0,0,8,0,-8
4490,1,1,729,1200,471
4491,1,1,503,1618,1115
4492,1,1,68,1540,1472
4493,0,0,207,0,-207
4494,0,0,51,0,-51
4495,1,0,147,0,-147
4496,1,1,608,1244,636
4497,1,0,111,0,-111
4498,1,0,63,0,-63
4499,1,1,697,1730,1033
4500,1,1,226,1225,999
4501,0,0,1,0,-1
4502,1,0,87,0,-87
4503,1,0,50,0,-50
4504,1,0,119,0,-119
4505,0,0,25,0,-25
4506,1,0,107,0,-107
4507,0,0,23,0,-23
4508,0,0,93,0,-93
4509,1,0,33,0,-33
4510,1,0,53,0,-53
4511,1,0,27,0,-27
4512,1,0,114,0,-114
4513,0,0,44,0,-44
4514,1,1,1219,1452,233
4515,0,0,96,0,-96
4516,0,0,11,0,-11
4517,1,0,48,0,-48
4518,0,0,4,0,-4
4519,1,1,188,1547,1359
4520,1,0,48,0,-48
4521,0,0,17,0,-17
4522,0,0,69,0,-69
4523,1,1,1110,1262,152
4524,1,1,74,1465,1391
4525,1,0,49,0,-49
4526,1,0,64,0,-64
4527,1,0,94,0,-94
4528,0,0,35,0,-35
4529,0,0,0,0,0
4530,1,1,73,1500,1427
4531,1,1,123,1256,1133
4532,1,1,256,1638,1382
4533,1,1,626,1494,868
4534,1,1,1097,1417,320
4535,1,1,449,1758,1309
4536,0,0,143,0,-143
4537,0,0,34,0,-34
4538,0,0,90,0,-90
4539,0,0,17,0,-17
4540,0,0,3,0,-3
4541,1,0,0,0,0
4542,1,1,585,1223,638
4543,1,0,51,0,-51
4544,1,0,78,0,-78
4545,0,0,16,0,-16
4546,0,0,17,0,-17
4547,1,1,309,1700,1391
4548,1,0,44,0,-44
4549,1,1,1510,1352,-158
4550,1,0,181,0,-181
4551,1,1,123,1219,1096
4552,0,0,21,0,-21
4553,1,1,127,1935,1808
4554,1,1,126,1299,1173
4555,1,0,48,0,-48
4556,0,0,0,0,0
4557,0,0,94,0,-94
4558,0,0,2,0,-2
4559,0,0,131,0,-131
4560,1,1,747,1315,568
4561,1,1,658,1229,571
4562,1,0,3,0,-3
4563,1,0,67,0,-67
4564,0,0,69,0,-69
4565,1,1,974,1291,317
4566,0,0,78,0,-78
4567,1,1,531,1620,1089
4568,0,0,52,0,-52
4569,0,0,28,0,-28
4570,1,0,33,0,-33
4571,1,0,94,0,-94
4572,0,0,35,0,-35
4573,1,1,111,2255,2144
4574,0,0,7,0,-7
4575,1,1,126,1680,1554
4576,1,0,4,0,-4
4577,1,0,10,0,-10
4578,1,1,608,1212,604
4579,1,1,494,1677,1183
4580,0,0,137,0,-137
4581,0,0,49,0,-49
4582,1,1,44,1258,1214
4583,1,0,5,0,-5
4584,1,1,850,1654,804
4585,1,1,558,1817,1259
4586,0,0,13,0,-13
4587,1,1,1179,1250,71
4588,0,0,21,0,-21
4589,1,1,16,2295,2279
4590,1,0,32,0,-32
4591,0,0,78,0,-78
4592,0,0,55,0,-55
4593,0,0,0,0,0
4594,0,0,21,0,-21
4595,0,0,27,0,-27
4596,0,0,42,0,-42
4597,1,0,2,0,-2
4598,1,1,258,2481,2223
4599,0,0,50,0,-50
4600,1,0,49,0,-49
4601,1,0,40,0,-40
4602,0,0,10,0,-10
4603,0,0,73,0,-73
4604,0,0,36,0,-36
4605,0,0,0,0,0
4606,1,1,148,1302,1154
4607,1,1,653,3109,2456
4608,1,0,26,0,-26
4609,0,0,209,0,-209
4610,0,0,4,0,-4
4611,1,1,1095,1950,855
4612,1,0,64,0,-64
4613,0,0,22,0,-22
4614,0,0,15,0,-15
4615,1,0,32,0,-32
4616,1,1,711,1223,512
4617,1,1,539,1427,888
4618,1,0,77,0,-77
4619,0,0,75,0,-75
4620,0,0,39,0,-39
4621,1,1,1326,6351,5025
4622,1,0,25,0,-25
4623,0,0,94,0,-94
4624,1,0,3,0,-3
4625,1,0,154,0,-154
4626,0,0,179,0,-179
4627,1,0,13,0,-13
4628,0,0,5,0,-5
4629,1,1,255,1493,1238
4630,0,0,141,0,-141
4631,0,0,70,0,-70
4632,1,0,29,0,-29
4633,1,0,26,0,-26
4634,0,0,90,0,-90
4635,1,0,17,0,-17
4636,1,1,549,1761,1212
4637,1,0,32,0,-32
4638,1,1,2054,1331,-723
4639,1,1,1218,1260,42
4640,1,1,160,1321,1161
4641,1,0,26,0,-26
4642,1,0,18,0,-18
4643,1,1,163,1308,1145
4644,0,0,67,0,-67
4645,1,1,140,1569,1429
4646,0,0,92,0,-92
4647,1,0,16,0,-16
4648,1,1,535,2537,2002
4649,1,0,1,0,-1
4650,0,0,180,0,-180
4651,0,0,145,0,-145
4652,0,0,35,0,-35
4653,1,1,224,1341,1117
4654,0,0,10,0,-10
4655,1,0,31,0,-31
4656,1,1,99,1770,1671
4657,0,0,15,0,-15
4658,1,1,15,1205,1190
4659,1,0,15,0,-15
4660,1,0,32,0,-32
4661,1,0,43,0,-43
4662,1,0,112,0,-112
4663,1,1,11,1378,1367
4664,0,0,294,0,-294
4665,0,0,51,0,-51
4666,1,1,951,1211,260
4667,0,0,67,0,-67
4668,1,1,1631,1868,237
4669,1,1,210,1716,1506
4670,1,1,606,1518,912
4671,0,0,101,0,-101
4672,1,0,1,0,-1
4673,1,0,75,0,-75
4674,1,0,5,0,-5
4675,0,0,52,0,-52
4676,1,1,811,2204,1393
4677,0,0,14,0,-14
4678,0,0,41,0,-41
4679,0,0,40,0,-40
4680,1,0,0,0,0
4681,1,0,123,0,-123
4682,1,1,254,1309,1055
4683,0,0,160,0,-160
4684,1,0,129,0,-129
4685,1,1,379,1230,851
4686,1,1,1466,2189,723
4687,1,1,620,1333,713
4688,0,0,23,0,-23
4689,0,0,33,0,-33
4690,0,0,87,0,-87
4691,0,0,0,0,0
4692,1,0,8,0,-8
4693,1,0,21,0,-21
4694,1,1,77,2351,2274
4695,0,0,18,0,-18
4696,1,0,10,0,-10
4697,0,0,5,0,-5
4698,0,0,19,0,-19
4699,0,0,40,0,-40
4700,1,1,388,1380,992
4701,0,0,19,0,-19
4702,1,1,430,1689,1259
4703,1,1,283,3334,3051
4704,1,0,6,0,-6
4705,0,0,37,0,-37
4706,1,0,132,0,-132
4707,1,1,987,1594,607
4708,0,0,104,0,-104
4709,0,0,23,0,-23
4710,0,0,14,0,-14
4711,1,1,883,1478,595
4712,1,0,148,0,-148
4713,1,0,80,0,-80
4714,1,1,180,1922,1742
4715,0,0,4,0,-4
4716,1,1,765,3682,2917
4717,0,0,5,0,-5
4718,1,1,292,1446,1154
4719,1,1,1298,1884,586
4720,0,0,10,0,-10
4721,0,0,6,0,-6
4722,1,1,294,1280,986
4723,1,1,35,2086,2051
4724,0,0,56,0,-56
4725,1,1,1046,1244,198
4726,1,1,415,1886,1471
4727,1,1,57,1275,1218
4728,1,0,22,0,-22
4729,0,0,21,0,-21
4730,1,1,615,1785,1170
4731,1,0,11,0,-11
4732,0,0,130,0,-130
4733,1,0,106,0,-106
4734,1,1,11,2055,2044
4735,0,0,132,0,-132
4736,0,0,35,0,-35
4737,1,0,69,0,-69
4738,1,1,699,1316,617
4739,1,0,3,0,-3
4740,0,0,35,0,-35
4741,0,0,15,0,-15
4742,1,1,256,1383,1127
4743,0,0,35,0,-35
4744,1,1,223,1608,1385
4745,1,1,396,2186,1790
4746,1,1,405,1332,927
4747,1,0,51,0,-51
4748,1,0,0,0,0
4749,0,0,10,0,-10
4750,1,1,494,1345,851
4751,1,1,411,1209,798
4752,1,0,17,0,-17
4753,1,1,733,1665,932
4754,0,0,66,0,-66
4755,0,0,204,0,-204
4756,0,0,23,0,-23
4757,0,0,84,0,-84
4758,0,0,1,0,-1
4759,0,0,100,0,-100
4760,1,1,90,1701,1611
4761,1,0,78,0,-78
4762,1,1,137,2278,2141
4763,1,0,30,0,-30
4764,1,0,171,0,-171
4765,1,1,499,1214,715
4766,0,0,8,0,-8
4767,1,1,277,3219,2942
4768,0,0,27,0,-27
4769,0,0,5,0,-5
4770,0,0,91,0,-91
4771,0,0,20,0,-20
4772,1,1,90,1577,1487
4773,0,0,5,0,-5
4774,1,0,15,0,-15
4775,0,0,1,0,-1
4776,1,1,323,1253,930
4777,0,0,12,0,-12
4778,1,1,559,1674,1115
4779,1,0,43,0,-43
4780,0,0,5,0,-5
4781,0,0,63,0,-63
4782,0,0,64,0,-64
4783,0,0,15,0,-15
4784,1,0,75,0,-75
4785,1,1,109,1710,1601
4786,1,0,28,0,-28
4787,0,0,27,0,-27
4788,0,0,61,0,-61
4789,0,0,5,0,-5
4790,0,0,42,0,-42
4791,1,0,105,0,-105
4792,1,1,1226,1555,329
4793,1,1,255,1283,1028
4794,0,0,16,0,-16
4795,1,0,45,0,-45
4796,1,0,9,0,-9
4797,0,0,0,0,0
4798,0,0,196,0,-196
4799,1,1,708,1206,498
4800,0,0,53,0,-53
4801,1,1,121,1482,1361
4802,0,0,6,0,-6
4803,1,0,29,0,-29
4804,0,0,36,0,-36
4805,0,0,47,0,-47
4806,1,0,18,0,-18
4807,0,0,41,0,-41
4808,1,1,1057,2075,1018
4809,1,0,131,0,-131
4810,0,0,29,0,-29
4811,0,0,18,0,-18
4812,1,0,10,0,-10
4813,0,0,23,0,-23
4814,1,0,18,0,-18
4815,1,0,47,0,-47
4816,0,0,12,0,-12
4817,1,1,30,1259,1229
4818,1,1,525,1227,702
4819,1,0,139,0,-139
4820,0,0,42,0,-42
4821,1,0,32,0,-32
4822,0,0,13,0,-13
4823,0,0,1,0,-1
4824,1,1,764,1208,444
4825,1,0,117,0,-117
4826,1,1,74,1778,1704
4827,0,0,2,0,-2
4828,0,0,11,0,-11
4829,0,0,38,0,-38
4830,0,0,45,0,-45
4831,0,0,2,0,-2
4832,0,0,14,0,-14
4833,0,0,5,0,-5
4834,1,1,1034,1300,266
4835,1,1,171,1210,1039
4836,1,1,38,1562,1524
4837,0,0,74,0,-74
4838,1,0,54,0,-54
4839,0,0,69,0,-69
4840,0,0,146,0,-146
4841,0,0,45,0,-45
4842,1,0,1,0,-1
4843,1,1,647,1531,884
4844,1,0,12,0,-12
4845,1,1,111,1332,1221
4846,0,0,90,0,-90
4847,1,1,580,1783,1203
4848,0,0,18,0,-18
4849,0,0,155,0,-155
4850,1,0,23,0,-23
4851,1,0,7,0,-7
4852,1,1,508,1928,1420
4853,0,0,9,0,-9
4854,0,0,35,0,-35
4855,1,0,25,0,-25
4856,1,1,637,1439,802
4857,0,0,89,0,-89
4858,1,0,15,0,-15
4859,0,0,1,0,-1
4860,0,0,1,0,-1
4861,1,0,14,0,-14
4862,1,1,75,1346,1271
4863,1,1,888,1280,392
4864,1,1,997,1525,528
4865,0,0,15,0,-15
4866,1,0,36,0,-36
4867,1,0,76,0,-76
4868,0,0,137,0,-137
4869,0,0,12,0,-12
4870,0,0,10,0,-10
4871,0,0,54,0,-54
4872,1,1,156,1697,1541
4873,1,1,1033,1291,258
4874,1,0,20,0,-20
4875,1,1,497,1728,1231
4876,0,0,0,0,0
4877,1,1,375,1462,1087
4878,0,0,24,0,-24
4879,1,0,51,0,-51
4880,0,0,5,0,-5
4881,1,1,289,3375,3086
4882,0,0,109,0,-109
4883,1,1,482,1508,1026
4884,1,0,3,0,-3
4885,0,0,29,0,-29
4886,1,1,233,1472,1239
4887,0,0,74,0,-74
4888,1,1,34,1336,1302
4889,0,0,167,0,-167
4890,1,1,359,2480,2121
4891,1,0,78,0,-78
4892,1,1,1364,1246,-118
4893,0,0,11,0,-11
4894,1,0,81,0,-81
4895,0,0,84,0,-84
4896,1,0,47,0,-47
4897,0,0,47,0,-47
4898,0,0,48,0,-48
4899,0,0,36,0,-36
4900,1,1,500,1406,906
4901,0,0,61,0,-61
4902,1,1,143,1246,1103
4903,0,0,70,0,-70
4904,1,0,80,0,-80
4905,1,1,75,1418,1343
4906,1,0,122,0,-122
4907,1,1,802,1993,1191
4908,1,1,240,1283,1043
4909,1,1,219,1207,988
4910,0,0,85,0,-85
4911,0,0,224,0,-224
4912,1,1,671,1394,723
4913,1,0,17,0,-17
4914,1,1,497,1366,869
4915,0,0,29,0,-29
4916,1,0,3,0,-3
4917,1,1,1285,1322,37
4918,1,1,314,1383,1069
4919,1,1,403,1262,859
4920,1,0,176,0,-176
4921,0,0,3,0,-3
4922,0,0,18,0,-18
4923,0,0,23,0,-23
4924,1,1,789,1361,572
4925,1,0,150,0,-150
4926,0,0,9,0,-9
4927,0,0,123,0,-123
4928,0,0,145,0,-145
4929,1,0,66,0,-66
4930,0,0,8,0,-8
4931,1,1,87,2771,2684
4932,1,0,4,0,-4
4933,0,0,16,0,-16
4934,0,0,56,0,-56
4935,0,0,56,0,-56
4936,1,1,368,2275,1907
4937,1,0,53,0,-53
4938,0,0,56,0,-56
4939,1,1,580,2311,1731
4940,0,0,32,0,-32
4941,0,0,27,0,-27
4942,1,1,209,1224,1015
4943,0,0,4,0,-4
4944,0,0,14,0,-14
4945,0,0,3,0,-3
4946,0,0,48,0,-48
4947,0,0,23,0,-23
4948,0,0,56,0,-56
4949,1,0,39,0,-39
4950,0,0,1,0,-1
4951,0,0,27,0,-27
4952,1,1,2183,1530,-653
4953,1,0,25,0,-25
4954,0,0,91,0,-91
4955,0,0,8,0,-8
4956,0,0,56,0,-56
4957,0,0,78,0,-78
4958,0,0,6,0,-6
4959,1,0,17,0,-17
4960,1,1,755,1397,642
4961,1,1,657,3022,2365
4962,0,0,211,0,-211
4963,1,0,11,0,-11
4964,1,1,932,1773,841
4965,1,1,433,1409,976
4966,1,0,14,0,-14
4967,1,1,879,1348,469
4968,1,0,44,0,-44
4969,1,0,53,0,-53
4970,0,0,70,0,-70
4971,1,0,96,0,-96
4972,1,0,17,0,-17
4973,1,0,143,0,-143
4974,1,0,99,0,-99
4975,1,1,599,1272,673
4976,1,1,306,1318,1012
4977,0,0,35,0,-35
4978,1,1,346,1840,1494
4979,0,0,5,0,-5
4980,0,0,39,0,-39
4981,1,1,159,1342,1183
4982,1,1,165,1232,1067
4983,1,0,193,0,-193
4984,0,0,44,0,-44
4985,1,0,183,0,-183
4986,0,0,4,0,-4
4987,1,0,109,0,-109
4988,0,0,70,0,-70
4989,1,1,861,1666,805
4990,0,0,197,0,-197
4991,0,0,24,0,-24
4992,0,0,43,0,-43
4993,1,0,0,0,0
4994,1,0,0,0,0
4995,0,0,85,0,-85
4996,0,0,101,0,-101
4997,1,0,65,0,-65
4998,1,0,13,0,-13
4999,1,1,184,1387,1203
5000,0,0,176,0,-176
5001,0,0,14,0,-14
5002,1,0,11,0,-11
5003,1,1,265,1284,1019
5004,0,0,108,0,-108
5005,1,1,280,1351,1071
5006,1,1,485,1350,865
5007,1,1,1256,1261,5
5008,1,1,154,1943,1789
5009,0,0,48,0,-48
5010,1,1,36,1434,1398
5011,1,0,7,0,-7
5012,1,1,1063,1758,695
5013,1,1,287,1241,954
5014,0,0,68,0,-68
5015,0,0,21,0,-21
5016,1,1,77,1282,1205
5017,1,1,334,1352,1018
5018,1,1,432,1257,825
5019,1,0,10,0,-10
5020,0,0,48,0,-48
5021,1,0,7,0,-7
5022,1,0,9,0,-9
5023,1,1,1212,1954,742
5024,1,0,65,0,-65
5025,1,1,510,1525,1015
5026,1,1,142,1472,1330
5027,0,0,24,0,-24
5028,1,0,78,0,-78
5029,0,0,41,0,-41
5030,1,0,52,0,-52
5031,1,1,810,1351,541
5032,1,1,71,1304,1233
5033,0,0,92,0,-92
5034,0,0,155,0,-155
5035,1,1,473,1274,801
5036,1,1,2258,3244,986
5037,1,0,89,0,-89
5038,1,0,101,0,-101
5039,1,0,13,0,-13
5040,1,1,1094,1454,360
5041,1,1,403,1305,902
5042,0,0,91,0,-91
5043,0,0,9,0,-9
5044,1,0,146,0,-146
5045,1,0,42,0,-42
5046,0,0,107,0,-107
5047,1,1,595,1340,745
5048,0,0,29,0,-29
5049,1,1,1146,1424,278
5050,1,0,57,0,-57
5051,0,0,72,0,-72
5052,1,1,126,1258,1132
5053,1,1,145,1227,1082
5054,0,0,117,0,-117
5055,0,0,17,0,-17
5056,0,0,32,0,-32
5057,0,0,14,0,-14
5058,1,0,16,0,-16
5059,1,1,382,2807,2425
5060,0,0,58,0,-58
5061,1,0,14,0,-14
5062,1,0,133,0,-133
5063,1,1,715,1354,639
5064,1,0,65,0,-65
5065,1,0,11,0,-11
5066,0,0,29,0,-29
5067,1,0,6,0,-6
5068,1,1,552,1308,756
5069,1,0,52,0,-52
5070,1,1,565,1272,707
5071,1,1,379,1660,1281
5072,1,1,344,1395,1051
5073,0,0,0,0,0
5074,1,1,554,1235,681
5075,0,0,16,0,-16
5076,0,0,73,0,-73
5077,0,0,67,0,-67
5078,1,0,65,0,-65
5079,0,0,114,0,-114
5080,0,0,18,0,-18
5081,1,1,47,2042,1995
5082,1,1,555,1224,669
5083,0,0,14,0,-14
5084,1,1,335,1627,1292
5085,1,1,604,1241,637
5086,1,1,89,1266,1177
5087,1,0,3,0,-3
5088,1,1,97,1479,1382
5089,1,1,175,1985,1810
5090,0,0,81,0,-81
5091,0,0,78,0,-78
5092,0,0,96,0,-96
5093,1,0,3,0,-3
5094,0,0,1,0,-1
5095,1,0,34,0,-34
5096,1,1,515,1781,1266
5097,1,1,34,1496,1462
5098,0,0,29,0,-29
5099,0,0,61,0,-61
5100,1,0,22,0,-22
5101,1,0,163,0,-163
5102,1,1,62,2321,2259
5103,1,1,138,1360,1222
5104,1,1,136,1213,1077
5105,0,0,11,0,-11
5106,1,0,20,0,-20
5107,1,1,806,1293,487
5108,0,0,94,0,-94
5109,1,0,18,0,-18
5110,1,1,221,1279,1058
5111,1,1,710,1422,712
5112,1,0,0,0,0
5113,0,0,76,0,-76
5114,0,0,42,0,-42
5115,1,0,26,0,-26
5116,1,0,108,0,-108
5117,1,0,34,0,-34
5118,1,1,201,1372,1171
5119,1,0,29,0,-29
5120,1,1,77,1384,1307
5121,1,0,18,0,-18
5122,1,0,14,0,-14
5123,0,0,8,0,-8
5124,1,0,20,0,-20
5125,1,1,366,1870,1504
5126,1,0,119,0,-119
5127,0,0,22,0,-22
5128,1,1,366,2405,2039
5129,1,1,135,1280,1145
5130,1,0,16,0,-16
5131,1,0,24,0,-24
5132,0,0,13,0,-13
5133,0,0,54,0,-54
5134,0,0,71,0,-71
5135,1,1,1184,1217,33
5136,0,0,17,0,-17
5137,0,0,68,0,-68
5138,0,0,46,0,-46
5139,1,1,125,1222,1097
5140,0,0,37,0,-37
5141,0,0,130,0,-130
5142,1,1,100,1987,1887
5143,0,0,5,0,-5
5144,1,1,1096,1405,309
5145,1,0,41,0,-41
5146,0,0,50,0,-50
5147,1,0,64,0,-64
5148,1,1,241,1282,1041
5149,1,0,84,0,-84
5150,0,0,109,0,-109
5151,0,0,0,0,0
5152,1,1,125,1492,1367
5153,1,1,320,1272,952
5154,1,1,158,1562,1404
5155,1,0,12,0,-12
5156,0,0,77,0,-77
5157,1,0,18,0,-18
5158,1,0,40,0,-40
5159,1,1,460,1620,1160
5160,1,0,72,0,-72
5161,1,1,703,1226,523
5162,1,1,957,1297,340
5163,1,0,82,0,-82
5164,1,1,153,1683,1530
5165,1,0,40,0,-40
5166,0,0,34,0,-34
5167,1,1,218,1223,1005
5168,1,0,14,0,-14
5169,1,0,20,0,-20
5170,1,0,17,0,-17
5171,0,0,5,0,-5
5172,1,0,39,0,-39
5173,1,1,1265,1619,354
5174,1,0,27,0,-27
5175,1,0,135,0,-135
5176,0,0,6,0,-6
5177,0,0,35,0,-35
5178,0,0,38,0,-38
5179,0,0,16,0,-16
5180,1,0,5,0,-5
5181,0,0,13,0,-13
5182,0,0,65,0,-65
5183,1,0,16,0,-16
5184,0,0,0,0,0
5185,1,1,422,2006,1584
5186,1,1,430,1229,799
5187,1,0,3,0,-3
5188,0,0,135,0,-135
5189,1,0,85,0,-85
5190,0,0,23,0,-23
5191,1,1,662,1648,986
5192,0,0,3,0,-3
5193,0,0,40,0,-40
5194,0,0,22,0,-22
5195,0,0,7,0,-7
5196,0,0,14,0,-14
5197,0,0,58,0,-58
5198,0,0,64,0,-64
5199,0,0,22,0,-22
5200,1,1,674,1257,583
5201,1,1,1091,1581,490
5202,0,0,10,0,-10
5203,1,0,11,0,-11
5204,1,0,126,0,-126
5205,1,0,95,0,-95
5206,1,1,587,1271,684
5207,1,0,88,0,-88
5208,0,0,15,0,-15
5209,1,0,55,0,-55
5210,1,1,242,1502,1260
5211,1,0,46,0,-46
5212,1,1,390,1279,889
5213,1,0,102,0,-102
5214,1,1,124,1270,1146
5215,0,0,15,0,-15
5216,1,1,487,1312,825
5217,0,0,14,0,-14
5218,1,0,23,0,-23
5219,0,0,9,0,-9
5220,1,1,79,1785,1706
5221,0,0,10,0,-10
5222,1,1,592,1654,1062
5223,1,0,77,0,-77
5224,1,0,18,0,-18
5225,1,1,124,2013,1889
5226,1,0,99,0,-99
5227,0,0,69,0,-69
5228,1,0,51,0,-51
5229,1,0,32,0,-32
5230,0,0,2,0,-2
5231,0,0,218,0,-218
5232,0,0,4,0,-4
5233,1,0,62,0,-62
5234,1,0,14,0,-14
5235,1,0,25,0,-25
5236,0,0,136,0,-136
5237,0,0,0,0,0
5238,1,1,63,2118,2055
5239,0,0,20,0,-20
5240,0,0,26,0,-26
5241,1,0,15,0,-15
5242,1,0,47,0,-47
5243,0,0,53,0,-53
5244,1,0,19,0,-19
5245,0,0,32,0,-32
5246,0,0,61,0,-61
5247,1,0,46,0,-46
5248,1,1,2898,1214,-1684
5249,1,0,43,0,-43
5250,1,1,787,1266,479
5251,0,0,90,0,-90
5252,0,0,29,0,-29
5253,1,1,121,1320,1199
5254,1,0,30,0,-30
5255,1,1,1021,1237,216
5256,1,1,265,2169,1904
5257,1,0,0,0,0
5258,0,0,115,0,-115
5259,1,0,22,0,-22
5260,1,0,160,0,-160
5261,1,1,203,1263,1060
5262,0,0,48,0,-48
5263,1,1,170,1312,1142
5264,0,0,3,0,-3
5265,0,0,46,0,-46
5266,1,1,382,1890,1508
5267,0,0,9,0,-9
5268,1,1,351,2000,1649
5269,0,0,15,0,-15
5270,1,1,1740,2401,661
5271,1,1,375,1343,968
5272,1,0,13,0,-13
5273,0,0,49,0,-49
5274,0,0,20,0,-20
5275,1,0,51,0,-51
5276,0,0,111,0,-111
5277,1,1,251,1407,1156
5278,0,0,45,0,-45
5279,0,0,172,0,-172
5280,0,0,40,0,-40
5281,1,0,157,0,-157
5282,1,1,83,1771,1688
5283,1,0,0,0,0
5284,1,0,8,0,-8
5285,0,0,109,0,-109
5286,1,0,13,0,-13
5287,1,0,17,0,-17
5288,1,1,1863,1250,-613
5289,1,0,87,0,-87
5290,0,0,25,0,-25
5291,1,0,23,0,-23
5292,1,1,89,1216,1127
5293,1,1,120,1500,1380
5294,1,1,923,1478,555
5295,1,0,55,0,-55
5296,0,0,74,0,-74
5297,1,1,1027,1443,416
5298,1,1,384,1286,902
5299,1,1,1450,1203,-247
5300,1,0,70,0,-70
5301,1,0,61,0,-61
5302,0,0,20,0,-20
5303,0,0,111,0,-111
5304,0,0,99,0,-99
5305,1,1,943,1529,586
5306,0,0,67,0,-67
5307,0,0,155,0,-155
5308,1,1,219,1415,1196
5309,1,0,7,0,-7
5310,0,0,38,0,-38
5311,0,0,107,0,-107
5312,1,0,33,0,-33
5313,1,0,129,0,-129
5314,1,0,78,0,-78
5315,1,1,777,1266,489
5316,1,1,566,1320,754
5317,0,0,142,0,-142
5318,0,0,29,0,-29
5319,1,1,718,1260,542
5320,0,0,38,0,-38
5321,0,0,38,0,-38
5322,1,1,290,1452,1162
5323,0,0,112,0,-112
5324,1,1,465,1825,1360
5325,1,0,11,0,-11
5326,1,1,541,1235,694
5327,1,1,287,1538,1251
5328,1,0,19,0,-19
5329,0,0,67,0,-67
5330,1,0,7,0,-7
5331,0,0,66,0,-66
5332,1,0,3,0,-3
5333,0,0,29,0,-29
5334,1,1,1349,1425,76
5335,1,1,78,1443,1365
5336,1,0,35,0,-35
5337,1,0,4,0,-4
5338,1,1,410,1522,1112
5339,1,1,260,1392,1132
5340,0,0,21,0,-21
5341,1,1,624,2438,1814
5342,0,0,21,0,-21
5343,1,1,242,1400,1158
5344,1,0,86,0,-86
5345,0,0,8,0,-8
5346,1,1,224,1200,976
5347,1,1,806,1391,585
5348,0,0,5,0,-5
5349,1,0,5,0,-5
5350,0,0,3,0,-3
5351,1,1,166,1334,1168
5352,0,0,63,0,-63
5353,0,0,129,0,-129
5354,0,0,30,0,-30
5355,1,0,48,0,-48
5356,0,0,19,0,-19
5357,1,1,831,1266,435
5358,1,0,60,0,-60
5359,1,0,6,0,-6
5360,1,1,769,1251,482
5361,0,0,7,0,-7
5362,0,0,22,0,-22
5363,1,1,37,1235,1198
5364,1,1,1365,2055,690
5365,1,1,504,2580,2076
5366,0,0,38,0,-38
5367,0,0,20,0,-20
5368,0,0,4,0,-4
5369,0,0,7,0,-7
5370,0,0,22,0,-22
5371,1,1,251,1725,1474
5372,1,1,230,1480,1250
5373,1,0,181,0,-181
5374,0,0,5,0,-5
5375,1,0,77,0,-77
5376,1,1,579,1324,745
5377,1,1,137,1236,1099
5378,0,0,28,0,-28
5379,1,0,133,0,-133
5380,1,0,17,0,-17
5381,0,0,6,0,-6
5382,1,0,20,0,-20
5383,0,0,10,0,-10
5384,1,0,69,0,-69
5385,0,0,61,0,-61
5386,1,1,138,1556,1418
5387,0,0,24,0,-24
5388,1,1,167,1297,1130
5389,0,0,37,0,-37
5390,1,0,72,0,-72
5391,0,0,97,0,-97
5392,1,1,40,1518,1478
5393,1,1,195,1858,1663
5394,1,1,106,1838,1732
5395,1,1,905,1405,500
5396,1,0,31,0,-31
5397,1,1,110,1370,1260
5398,1,1,136,1290,1154
5399,1,0,48,0,-48
5400,1,1,421,1443,1022
5401,1,1,989,2198,1209
5402,1,1,1000,1282,282
5403,1,1,1084,1298,214
5404,0,0,5,0,-5
5405,1,0,53,0,-53
5406,1,1,960,1712,752
5407,1,0,39,0,-39
5408,1,0,10,0,-10
5409,0,0,15,0,-15
5410,1,1,252,1690,1438
5411,1,1,859,1372,513
5412,1,1,59,1253,1194
5413,1,0,14,0,-14
5414,1,0,9,0,-9
5415,1,0,26,0,-26
5416,1,1,502,1381,879
5417,1,1,219,1225,1006
5418,0,0,5,0,-5
5419,1,1,3311,1773,-1538
5420,1,0,9,0,-9
5421,0,0,24,0,-24
5422,1,0,5,0,-5
5423,1,1,130,1663,1533
5424,0,0,32,0,-32
5425,1,0,6,0,-6
5426,0,0,107,0,-107
5427,1,0,7,0,-7
5428,1,0,21,0,-21
5429,1,1,519,1218,699
5430,1,1,153,2012,1859
5431,0,0,5,0,-5
5432,1,0,53,0,-53
5433,1,1,1121,1685,564
5434,1,1,577,1535,958
5435,0,0,24,0,-24
5436,1,0,124,0,-124
5437,1,1,466,1326,860
5438,0,0,45,0,-45
5439,1,1,2896,1343,-1553
5440,1,1,968,1315,347
5441,0,0,35,0,-35
5442,1,0,44,0,-44
5443,1,0,101,0,-101
5444,1,0,123,0,-123
5445,1,1,84,1301,1217
5446,1,1,76,1414,1338
5447,0,0,27,0,-27
5448,1,0,39,0,-39
5449,1,1,111,1205,1094
5450,1,1,1650,2270,620
5451,1,0,19,0,-19
5452,0,0,10,0,-10
5453,0,0,163,0,-163
5454,1,1,278,1213,935
5455,0,0,28,0,-28
5456,0,0,5,0,-5
5457,1,0,90,0,-90
5458,1,1,343,1204,861
5459,1,1,527,1704,1177
5460,1,1,166,1522,1356
5461,0,0,58,0,-58
5462,0,0,75,0,-75
5463,1,0,59,0,-59
5464,1,1,106,1426,1320
5465,1,1,527,1290,763
5466,0,0,67,0,-67
5467,0,0,7,0,-7
5468,0,0,33,0,-33
5469,1,1,531,1419,888
5470,0,0,29,0,-29
5471,1,1,298,1236,938
5472,1,1,196,1428,1232
5473,1,0,81,0,-81
5474,1,0,12,0,-12
5475,0,0,41,0,-41
5476,1,1,987,1211,224
5477,0,0,47,0,-47
5478,1,1,647,1374,727
5479,0,0,2,0,-2
5480,0,0,20,0,-20
5481,0,0,13,0,-13
5482,0,0,23,0,-23
5483,0,0,25,0,-25
5484,1,0,40,0,-40
5485,0,0,16,0,-16
5486,1,1,902,1967,1065
5487,1,1,137,1850,1713
5488,0,0,39,0,-39
5489,1,0,83,0,-83
5490,1,1,43,2113,2070
5491,1,0,11,0,-11
5492,1,1,264,1316,1052
5493,1,1,816,1416,600
5494,1,0,2,0,-2
5495,0,0,24,0,-24
5496,1,0,1,0,-1
5497,1,0,13,0,-13
5498,1,0,39,0,-39
5499,1,0,11,0,-11
5500,0,0,113,0,-113
5501,0,0,17,0,-17
5502,0,0,104,0,-104
5503,0,0,13,0,-13
5504,0,0,0,0,0
5505,0,0,5,0,-5
5506,1,1,289,1268,979
5507,1,0,3,0,-3
5508,0,0,12,0,-12
5509,0,0,2,0,-2
5510,1,0,49,0,-49
5511,0,0,18,0,-18
5512,1,0,111,0,-111
5513,1,1,727,1281,554
5514,1,1,697,1253,556
5515,1,1,174,1435,1261
5516,1,1,207,1242,1035
5517,0,0,38,0,-38
5518,0,0,45,0,-45
5519,1,0,31,0,-31
5520,0,0,105,0,-105
5521,1,1,486,1579,1093
5522,0,0,231,0,-231
5523,0,0,18,0,-18
5524,1,0,37,0,-37
5525,1,1,1073,1553,480
5526,0,0,82,0,-82
5527,1,0,40,0,-40
5528,1,0,2,0,-2
5529,0,0,11,0,-11
5530,1,1,282,1726,1444
5531,1,1,469,1457,988
5532,1,1,177,1246,1069
5533,0,0,20,0,-20
5534,1,0,47,0,-47
5535,0,0,102,0,-102
5536,1,0,98,0,-98
5537,1,0,4,0,-4
5538,0,0,18,0,-18
5539,1,0,111,0,-111
5540,0,0,8,0,-8
5541,0,0,11,0,-11
5542,1,1,348,1526,1178
5543,1,0,91,0,-91
5544,1,0,9,0,-9
5545,1,1,90,1209,1119
5546,1,0,13,0,-13
5547,0,0,41,0,-41
5548,1,1,1324,1250,-74
5549,1,0,70,0,-70
5550,1,0,8,0,-8
5551,1,0,21,0,-21
5552,1,0,26,0,-26
5553,1,1,1936,1421,-515
5554,1,0,106,0,-106
5555,1,0,35,0,-35
5556,0,0,186,0,-186
5557,1,0,59,0,-59
5558,0,0,56,0,-56
5559,1,0,25,0,-25
5560,0,0,24,0,-24
5561,0,0,149,0,-149
5562,0,0,3,0,-3
5563,0,0,98,0,-98
5564,1,1,591,1421,830
5565,1,1,982,3633,2651
5566,1,0,134,0,-134
5567,0,0,20,0,-20
5568,1,0,16,0,-16
5569,1,1,913,1452,539
5570,1,0,25,0,-25
5571,0,0,98,0,-98
5572,1,1,226,1336,1110
5573,1,1,264,1525,1261
5574,1,1,1604,1269,-335
5575,0,0,23,0,-23
5576,1,1,454,2001,1547
5577,1,0,82,0,-82
5578,1,1,560,1458,898
5579,0,0,45,0,-45
5580,0,0,25,0,-25
5581,1,0,43,0,-43
5582,0,0,14,0,-14
5583,0,0,130,0,-130
5584,0,0,28,0,-28
5585,0,0,34,0,-34
5586,0,0,165,0,-165
5587,0,0,202,0,-202
5588,1,0,16,0,-16
5589,1,1,1846,1241,-605
5590,0,0,48,0,-48
5591,0,0,6,0,-6
5592,1,0,12,0,-12
5593,1,1,276,1494,1218
5594,1,1,410,1730,1320
5595,1,0,79,0,-79
5596,1,1,210,1423,1213
5597,1,0,104,0,-104
5598,1,1,555,1579,1024
5599,0,0,2,0,-2
5600,1,0,5,0,-5
5601,0,0,34,0,-34
5602,0,0,0,0,0
5603,1,0,20,0,-20
5604,1,1,443,1296,853
5605,0,0,9,0,-9
5606,1,1,376,1425,1049
5607,1,0,69,0,-69
5608,1,1,545,1232,687
5609,1,1,273,2217,1944
5610,1,1,279,1353,1074
5611,0,0,37,0,-37
5612,1,1,1200,1378,178
5613,1,1,914,1282,368
5614,1,1,508,2013,1505
5615,1,0,9,0,-9
5616,0,0,24,0,-24
5617,1,0,128,0,-128
5618,1,1,909,1893,984
5619,1,1,149,1794,1645
5620,1,0,15,0,-15
5621,1,1,905,1216,311
5622,1,1,69,1418,1349
5623,0,0,22,0,-22
5624,0,0,8,0,-8
5625,1,0,3,0,-3
5626,1,1,159,3410,3251
5627,0,0,21,0,-21
5628,1,0,95,0,-95
5629,1,0,27,0,-27
5630,1,0,182,0,-182
5631,1,1,725,1463,738
5632,1,0,53,0,-53
5633,1,0,70,0,-70
5634,1,1,875,1225,350
5635,1,1,1806,1569,-237
5636,0,0,88,0,-88
5637,0,0,3,0,-3
5638,1,0,65,0,-65
5639,1,0,46,0,-46
5640,0,0,25,0,-25
5641,1,0,41,0,-41
5642,0,0,46,0,-46
5643,1,0,96,0,-96
5644,0,0,6,0,-6
5645,1,1,569,1730,1161
5646,1,0,25,0,-25
5647,1,1,407,1206,799
5648,0,0,35,0,-35
5649,1,1,29,1675,1646
5650,0,0,1,0,-1
5651,0,0,60,0,-60
5652,0,0,9,0,-9
5653,1,1,235,2304,2069
5654,1,1,123,1572,1449
5655,0,0,28,0,-28
5656,0,0,51,0,-51
5657,1,1,1288,1808,520
5658,1,1,1079,1537,458
5659,1,0,59,0,-59
5660,0,0,4,0,-4
5661,1,1,466,1604,1138
5662,0,0,24,0,-24
5663,0,0,34,0,-34
5664,1,0,41,0,-41
5665,1,0,26,0,-26
5666,1,0,37,0,-37
5667,0,0,36,0,-36
5668,0,0,71,0,-71
5669,1,0,67,0,-67
5670,0,0,101,0,-101
5671,0,0,5,0,-5
5672,0,0,10,0,-10
5673,1,1,879,1451,572
5674,1,0,24,0,-24
5675,1,0,29,0,-29
5676,1,0,4,0,-4
5677,0,0,90,0,-90
5678,1,1,1284,1643,359
5679,0,0,79,0,-79
5680,1,0,22,0,-22
5681,0,0,29,0,-29
5682,1,1,1044,2854,1810
5683,1,0,27,0,-27
5684,0,0,54,0,-54
5685,1,0,59,0,-59
5686,1,1,93,2497,2404
5687,0,0,87,0,-87
5688,1,0,25,0,-25
5689,0,0,88,0,-88
5690,0,0,51,0,-51
5691,1,0,55,0,-55
5692,0,0,238,0,-238
5693,1,0,83,0,-83
5694,1,0,85,0,-85
5695,1,0,27,0,-27
5696,1,0,9,0,-9
5697,1,0,47,0,-47
5698,1,1,114,1308,1194
5699,0,0,46,0,-46
5700,1,0,14,0,-14
5701,0,0,29,0,-29
5702,1,1,552,2689,2137
5703,1,1,326,2291,1965
5704,1,1,861,1321,460
5705,1,0,112,0,-112
5706,0,0,15,0,-15
5707,1,1,949,1351,402
5708,0,0,32,0,-32
5709,1,0,41,0,-41
5710,1,1,424,1580,1156
5711,1,1,709,2138,1429
5712,0,0,10,0,-10
5713,1,0,38,0,-38
5714,0,0,44,0,-44
5715,0,0,142,0,-142
5716,0,0,17,0,-17
5717,1,0,45,0,-45
5718,1,0,2,0,-2
5719,0,0,6,0,-6
5720,1,0,72,0,-72
5721,1,0,19,0,-19
5722,1,1,102,1238,1136
5723,1,0,21,0,-21
5724,0,0,23,0,-23
5725,0,0,11,0,-11
5726,0,0,15,0,-15
5727,0,0,1,0,-1
5728,1,0,26,0,-26
5729,0,0,15,0,-15
5730,0,0,131,0,-131
5731,1,0,87,0,-87
5732,1,1,1209,1253,44
5733,0,0,11,0,-11
5734,0,0,24,0,-24
5735,1,0,40,0,-40
5736,1,1,705,1868,1163
5737,1,1,276,2615,2339
5738,1,0,83,0,-83
5739,1,1,242,1822,1580
5740,0,0,42,0,-42
5741,0,0,8,0,-8
5742,1,0,3,0,-3
5743,0,0,12,0,-12
5744,0,0,10,0,-10
5745,1,0,43,0,-43
5746,1,0,32,0,-32
5747,1,1,471,1518,1047
5748,1,1,605,1217,612
5749,1,1,403,1966,1563
5750,0,0,57,0,-57
5751,1,0,27,0,-27
5752,1,1,183,1264,1081
5753,1,0,42,0,-42
5754,1,0,3,0,-3
5755,1,0,27,0,-27
5756,1,0,8,0,-8
5757,1,0,75,0,-75
5758,0,0,124,0,-124
5759,0,0,61,0,-61
5760,0,0,83,0,-83
5761,1,0,8,0,-8
5762,1,0,8,0,-8
5763,1,0,35,0,-35
5764,1,0,25,0,-25
5765,1,1,3392,1598,-1794
5766,1,1,694,1509,815
5767,1,1,116,3189,3073
5768,1,1,3110,1447,-1663
5769,0,0,16,0,-16
5770,0,0,2,0,-2
5771,1,1,251,2153,1902
5772,0,0,1,0,-1
5773,1,1,327,1704,1377
5774,1,0,18,0,-18
5775,0,0,152,0,-152
5776,1,1,132,1240,1108
5777,0,0,20,0,-20
5778,0,0,19,0,-19
5779,0,0,64,0,-64
5780,0,0,65,0,-65
5781,1,1,364,1596,1232
5782,0,0,17,0,-17
5783,0,0,59,0,-59
5784,0,0,73,0,-73
5785,1,1,286,1235,949
5786,1,1,118,1558,1440
5787,1,0,1,0,-1
5788,1,1,426,1330,904
5789,1,1,947,1237,290
5790,1,0,75,0,-75
5791,1,1,188,1260,1072
5792,1,0,90,0,-90
5793,0,0,11,0,-11
5794,1,0,12,0,-12
5795,0,0,107,0,-107
5796,1,0,21,0,-21
5797,1,1,435,1320,885
5798,1,0,49,0,-49
5799,1,1,67,1257,1190
5800,1,0,89,0,-89
5801,0,0,1,0,-1
5802,1,1,56,1569,1513
5803,1,0,0,0,0
5804,1,1,1026,1791,765
5805,1,0,82,0,-82
5806,1,0,52,0,-52
5807,1,0,12,0,-12
5808,1,0,25,0,-25
5809,1,1,1148,1234,86
5810,0,0,5,0,-5
5811,0,0,39,0,-39
5812,0,0,71,0,-71
5813,1,0,25,0,-25
5814,1,0,52,0,-52
5815,0,0,59,0,-59
5816,0,0,5,0,-5
5817,0,0,35,0,-35
5818,1,0,2,0,-2
5819,1,0,67,0,-67
5820,1,1,2739,1517,-1222
5821,1,0,10,0,-10
5822,1,1,586,1583,997
5823,1,0,36,0,-36
5824,0,0,43,0,-43
5825,1,1,371,1271,900
5826,1,1,536,1214,678
5827,1,1,205,1354,1149
5828,1,1,260,2187,1927
5829,0,0,41,0,-41
5830,0,0,65,0,-65
5831,1,1,464,1540,1076
5832,0,0,26,0,-26
5833,1,1,350,1956,1606
5834,1,0,55,0,-55
5835,1,1,163,1258,1095
5836,1,0,21,0,-21
5837,1,1,43,1324,1281
5838,1,1,1061,1420,359
5839,0,0,16,0,-16
5840,1,1,259,1298,1039
5841,1,1,328,1322,994
5842,0,0,23,0,-23
5843,1,1,231,1728,1497
5844,0,0,217,0,-217
5845,0,0,37,0,-37
5846,1,1,179,1481,1302
5847,0,0,45,0,-45
5848,0,0,33,0,-33
5849,0,0,9,0,-9
5850,1,1,178,1477,1299
5851,1,0,20,0,-20
5852,1,0,17,0,-17
5853,0,0,49,0,-49
5854,0,0,1,0,-1
5855,1,0,14,0,-14
5856,0,0,139,0,-139
5857,0,0,118,0,-118
5858,0,0,104,0,-104
5859,1,1,255,1425,1170
5860,0,0,87,0,-87
5861,0,0,274,0,-274
5862,0,0,109,0,-109
5863,1,1,889,1759,870
5864,1,1,1563,1736,173
5865,1,0,0,0,0
5866,0,0,15,0,-15
5867,0,0,125,0,-125
5868,0,0,96,0,-96
5869,1,1,199,2417,2218
5870,1,1,105,1747,1642
5871,1,1,629,1537,908
5872,0,0,14,0,-14
5873,0,0,35,0,-35
5874,1,0,68,0,-68
5875,1,1,612,1543,931
5876,1,0,133,0,-133
5877,0,0,10,0,-10
5878,1,1,691,1603,912
5879,0,0,139,0,-139
5880,1,0,59,0,-59
5881,1,1,737,1645,908
5882,1,1,299,1227,928
5883,0,0,65,0,-65
5884,0,0,32,0,-32
5885,1,1,41,1582,1541
5886,0,0,22,0,-22
5887,0,0,71,0,-71
5888,1,1,806,1229,423
5889,0,0,51,0,-51
5890,1,0,313,0,-313
5891,1,0,20,0,-20
5892,1,1,436,1745,1309
5893,1,1,647,1291,644
5894,1,0,3,0,-3
5895,0,0,107,0,-107
5896,1,0,29,0,-29
5897,1,1,288,1581,1293
5898,0,0,42,0,-42
5899,0,0,83,0,-83
5900,1,0,68,0,-68
5901,0,0,13,0,-13
5902,1,1,464,1217,753
5903,1,1,253,1427,1174
5904,1,0,113,0,-113
5905,1,0,16,0,-16
5906,0,0,131,0,-131
5907,1,0,4,0,-4
5908,1,1,385,1422,1037
5909,0,0,93,0,-93
5910,0,0,28,0,-28
5911,0,0,21,0,-21
5912,1,1,777,1200,423
5913,1,1,625,1215,590
5914,0,0,56,0,-56
5915,0,0,60,0,-60
5916,0,0,34,0,-34
5917,0,0,11,0,-11
5918,1,1,1154,1566,412
5919,1,0,28,0,-28
5920,1,0,5,0,-5
5921,0,0,21,0,-21
5922,1,1,115,1789,1674
5923,1,1,134,1330,1196
5924,1,0,15,0,-15
5925,0,0,111,0,-111
5926,0,0,9,0,-9
5927,1,1,1476,1721,245
5928,0,0,73,0,-73
5929,1,1,503,1461,958
5930,1,1,287,1419,1132
5931,1,0,5,0,-5
5932,1,1,2477,2467,-10
5933,1,1,376,1650,1274
5934,1,1,2317,1678,-639
5935,0,0,60,0,-60
5936,1,0,69,0,-69
5937,1,0,210,0,-210
5938,1,1,503,1204,701
5939,1,1,170,1302,1132
5940,0,0,30,0,-30
5941,0,0,105,0,-105
5942,1,0,127,0,-127
5943,1,0,49,0,-49
5944,0,0,71,0,-71
5945,1,1,488,1217,729
5946,0,0,75,0,-75
5947,1,0,20,0,-20
5948,1,0,56,0,-56
5949,0,0,312,0,-312
5950,1,0,101,0,-101
5951,1,1,432,1270,838
5952,1,0,19,0,-19
5953,0,0,44,0,-44
5954,1,0,3,0,-3
5955,1,0,16,0,-16
5956,1,0,56,0,-56
5957,0,0,42,0,-42
5958,0,0,65,0,-65
5959,1,1,1001,2438,1437
5960,1,0,22,0,-22
5961,1,1,822,1619,797
5962,1,1,105,1215,1110
5963,1,0,92,0,-92
5964,0,0,112,0,-112
5965,0,0,31,0,-31
5966,0,0,202,0,-202
5967,1,1,225,2137,1912
5968,1,1,41,1584,1543
5969,0,0,2,0,-2
5970,1,1,285,1370,1085
5971,1,1,433,1653,1220
5972,1,0,93,0,-93
5973,1,0,29,0,-29
5974,1,1,529,2324,1795
5975,1,0,14,0,-14
5976,1,1,142,1549,1407
5977,1,0,107,0,-107
5978,0,0,12,0,-12
5979,1,1,1136,1246,110
5980,1,0,104,0,-104
5981,1,0,2,0,-2
5982,1,0,55,0,-55
5983,0,0,19,0,-19
5984,0,0,6,0,-6
5985,1,0,15,0,-15
5986,1,1,855,1541,686
5987,0,0,52,0,-52
5988,1,1,226,1240,1014
5989,0,0,42,0,-42
5990,1,1,498,1591,1093
5991,1,1,177,1301,1124
5992,1,1,254,1556,1302
5993,0,0,27,0,-27
5994,0,0,2,0,-2
5995,0,0,47,0,-47
5996,1,0,64,0,-64
5997,1,0,37,0,-37
5998,1,1,552,2146,1594
5999,0,0,197,0,-197
6000,0,0,22,0,-22
6001,0,0,7,0,-7
6002,0,0,65,0,-65
6003,0,0,4,0,-4
6004,1,1,485,1240,755
6005,0,0,11,0,-11
6006,0,0,101,0,-101
6007,1,1,198,1390,1192
6008,1,1,453,1578,1125
6009,1,1,323,1216,893
6010,1,0,56,0,-56
6011,0,0,7,0,-7
6012,1,0,66,0,-66
6013,1,1,692,2181,1489
6014,1,1,750,1399,649
6015,1,0,24,0,-24
6016,1,1,117,1272,1155
6017,0,0,31,0,-31
6018,1,1,437,1292,855
6019,1,0,20,0,-20
6020,1,0,12,0,-12
6021,1,1,61,1205,1144
6022,0,0,58,0,-58
6023,1,0,176,0,-176
6024,0,0,3,0,-3
6025,0,0,66,0,-66
6026,1,0,6,0,-6
6027,1,0,12,0,-12
6028,1,1,1445,3026,1581
6029,1,1,702,1342,640
6030,1,1,209,2098,1889
6031,1,1,260,1917,1657
6032,1,0,11,0,-11
6033,0,0,85,0,-85
6034,1,1,86,1355,1269
6035,1,1,376,1707,1331
6036,1,0,22,0,-22
6037,0,0,3,0,-3
6038,0,0,53,0,-53
6039,1,1,188,1664,1476
6040,1,1,439,1264,825
6041,0,0,38,0,-38
6042,0,0,12,0,-12
6043,0,0,48,0,-48
6044,0,0,201,0,-201
6045,0,0,13,0,-13
6046,1,0,3,0,-3
6047,1,1,2031,1323,-708
6048,1,1,62,1541,1479
6049,0,0,9,0,-9
6050,1,0,8,0,-8
6051,0,0,7,0,-7
6052,0,0,31,0,-31
6053,1,1,397,2345,1948
6054,1,1,56,1207,1151
6055,1,0,5,0,-5
6056,1,0,13,0,-13
6057,0,0,53,0,-53
6058,0,0,4,0,-4
6059,0,0,26,0,-26
6060,1,0,8,0,-8
6061,1,0,107,0,-107
6062,1,1,173,1232,1059
6063,0,0,76,0,-76
6064,1,0,36,0,-36
6065,1,0,21,0,-21
6066,1,1,598,1535,937
6067,1,1,340,1311,971
6068,1,0,149,0,-149
6069,1,0,4,0,-4
6070,1,1,312,1632,1320
6071,0,0,2,0,-2
6072,0,0,132,0,-132
6073,0,0,54,0,-54
6074,1,0,47,0,-47
6075,1,0,11,0,-11
6076,1,0,42,0,-42
6077,1,0,9,0,-9
6078,1,0,7,0,-7
6079,1,0,9,0,-9
6080,1,0,53,0,-53
6081,0,0,37,0,-37
6082,1,0,5,0,-5
6083,1,1,223,1646,1423
6084,1,0,34,0,-34
6085,1,0,3,0,-3
6086,0,0,14,0,-14
6087,0,0,76,0,-76
6088,1,0,40,0,-40
6089,0,0,2,0,-2
6090,0,0,52,0,-52
6091,1,1,394,1899,1505
6092,1,1,833,1518,685
6093,1,0,22,0,-22
6094,1,1,241,1262,1021
6095,1,0,13,0,-13
6096,0,0,9,0,-9
6097,1,0,23,0,-23
6098,1,0,18,0,-18
6099,0,0,82,0,-82
6100,1,0,99,0,-99
6101,1,1,610,1319,709
6102,0,0,167,0,-167
6103,1,1,824,1305,481
6104,1,1,95,1316,1221
6105,1,1,115,14811,14696
6106,1,0,56,0,-56
6107,1,1,83,1384,1301
6108,0,0,42,0,-42
6109,0,0,25,0,-25
6110,1,0,85,0,-85
6111,1,0,35,0,-35
6112,0,0,4,0,-4
6113,1,1,548,1631,1083
6114,1,0,7,0,-7
6115,0,0,30,0,-30
6116,0,0,63,0,-63
6117,0,0,19,0,-19
6118,0,0,4,0,-4
6119,0,0,105,0,-105
6120,0,0,2,0,-2
6121,1,1,25,1428,1403
6122,1,0,22,0,-22
6123,0,0,26,0,-26
6124,0,0,20,0,-20
6125,1,1,592,1233,641
6126,1,0,52,0,-52
6127,0,0,124,0,-124
6128,0,0,27,0,-27
6129,0,0,71,0,-71
6130,1,1,300,2938,2638
6131,0,0,24,0,-24
6132,1,1,1116,2171,1055
6133,1,0,5,0,-5
6134,0,0,9,0,-9
6135,1,0,8,0,-8
6136,1,1,63,1372,1309
6137,1,0,80,0,-80
6138,1,0,27,0,-27
6139,0,0,6,0,-6
6140,1,1,736,1779,1043
6141,0,0,3,0,-3
6142,1,1,379,1440,1061
6143,0,0,14,0,-14
6144,1,1,1164,2107,943
6145,1,0,4,0,-4
6146,1,1,180,1889,1709
6147,0,0,30,0,-30
6148,1,1,216,2564,2348
6149,1,1,767,1257,490
6150,0,0,20,0,-20
6151,0,0,254,0,-254
6152,1,0,18,0,-18
6153,0,0,68,0,-68
6154,1,0,35,0,-35
6155,1,0,31,0,-31
6156,1,0,6,0,-6
6157,0,0,23,0,-23
6158,1,1,903,1308,405
6159,0,0,9,0,-9
6160,1,1,269,1559,1290
6161,1,1,189,1204,1015
6162,1,0,66,0,-66
6163,1,1,567,1517,950
6164,1,0,76,0,-76
6165,1,0,0,0,0
6166,1,0,8,0,-8
6167,0,0,25,0,-25
6168,0,0,24,0,-24
6169,0,0,10,0,-10
6170,1,0,153,0,-153
6171,1,1,435,2196,1761
6172,0,0,121,0,-121
6173,1,0,34,0,-34
6174,1,0,0,0,0
6175,0,0,20,0,-20
6176,1,1,573,2009,1436
6177,1,0,9,0,-9
6178,0,0,38,0,-38
6179,1,0,7,0,-7
6180,1,1,218,2810,2592
6181,0,0,46,0,-46
6182,0,0,1,0,-1
6183,1,0,74,0,-74
6184,1,0,12,0,-12
6185,1,1,816,1356,540
6186,1,1,354,1365,1011
6187,1,1,1124,1399,275
6188,0,0,72,0,-72
6189,0,0,68,0,-68
6190,1,0,2,0,-2
6191,0,0,40,0,-40
6192,1,0,13,0,-13
6193,1,0,62,0,-62
6194,1,0,22,0,-22
6195,0,0,8,0,-8
6196,1,1,1556,1423,-133
6197,1,0,45,0,-45
6198,1,1,104,1480,1376
6199,1,1,419,1291,872
6200,0,0,2,0,-2
6201,1,0,0,0,0
6202,0,0,11,0,-11
6203,1,1,105,1500,1395
6204,1,1,232,1637,1405
6205,1,1,185,2014,1829
6206,1,0,21,0,-21
6207,1,0,63,0,-63
6208,1,0,8,0,-8
6209,1,0,53,0,-53
6210,1,0,16,0,-16
6211,0,0,207,0,-207
6212,1,1,235,1482,1247
6213,1,1,660,1377,717
6214,1,0,100,0,-100
6215,0,0,18,0,-18
6216,0,0,19,0,-19
6217,1,0,6,0,-6
6218,0,0,6,0,-6
6219,0,0,32,0,-32
6220,1,0,10,0,-10
6221,0,0,66,0,-66
6222,0,0,16,0,-16
6223,0,0,82,0,-82
6224,1,1,398,1744,1346
6225,1,0,36,0,-36
6226,1,0,91,0,-91
6227,1,1,1188,1413,225
6228,1,0,44,0,-44
6229,0,0,19,0,-19
6230,0,0,16,0,-16
6231,1,1,449,1509,1060
6232,0,0,91,0,-91
6233,1,0,112,0,-112
6234,1,1,254,1272,1018
6235,0,0,5,0,-5
6236,1,0,29,0,-29
6237,1,0,64,0,-64
6238,1,1,810,1262,452
6239,1,0,21,0,-21
6240,1,1,1614,1391,-223
6241,0,0,42,0,-42
6242,1,1,268,2131,1863
6243,1,1,138,1677,1539
6244,1,1,591,2022,1431
6245,1,0,6,0,-6
6246,1,0,94,0,-94
6247,1,0,13,0,-13
6248,0,0,107,0,-107
6249,0,0,118,0,-118
6250,0,0,39,0,-39
6251,1,1,954,1909,955
6252,0,0,30,0,-30
6253,1,0,52,0,-52
6254,1,0,90,0,-90
6255,1,0,26,0,-26
6256,0,0,105,0,-105
6257,1,0,181,0,-181
6258,0,0,99,0,-99
6259,1,1,702,1206,504
6260,0,0,3,0,-3
6261,1,1,607,1257,650
6262,1,0,106,0,-106
6263,0,0,80,0,-80
6264,1,0,86,0,-86
6265,1,1,80,1362,1282
6266,1,0,12,0,-12
6267,1,1,124,1297,1173
6268,1,0,5,0,-5
6269,0,0,18,0,-18
6270,0,0,9,0,-9
6271,0,0,20,0,-20
6272,0,0,68,0,-68
6273,1,0,0,0,0
6274,0,0,48,0,-48
6275,1,0,6,0,-6
6276,0,0,19,0,-19
6277,1,0,78,0,-78
6278,1,1,297,1671,1374
6279,0,0,92,0,-92
6280,1,1,108,1298,1190
6281,0,0,9,0,-9
6282,0,0,10,0,-10
6283,1,0,6,0,-6
6284,0,0,10,0,-10
6285,0,0,25,0,-25
6286,1,0,32,0,-32
6287,0,0,39,0,-39
6288,0,0,8,0,-8
6289,1,0,37,0,-37
6290,1,1,198,1208,1010
6291,1,1,45,1248,1203
6292,1,1,225,1795,1570
6293,1,0,20,0,-20
6294,1,0,53,0,-53
6295,0,0,71,0,-71
6296,1,0,0,0,0
6297,1,1,319,1385,1066
6298,1,0,58,0,-58
6299,0,0,0,0,0
6300,1,1,1116,1361,245
6301,1,1,402,2804,2402
6302,1,1,597,1207,610
6303,0,0,29,0,-29
6304,0,0,28,0,-28
6305,1,0,117,0,-117
6306,1,1,1394,1372,-22
6307,1,0,13,0,-13
6308,1,0,185,0,-185
6309,0,0,85,0,-85
6310,1,0,180,0,-180
6311,0,0,11,0,-11
6312,1,1,514,1402,888
6313,1,1,389,1376,987
6314,1,1,382,1364,982
6315,1,0,41,0,-41
6316,0,0,10,0,-10
6317,1,1,840,1597,757
6318,0,0,70,0,-70
6319,1,0,133,0,-133
6320,1,0,62,0,-62
6321,1,1,424,1718,1294
6322,1,0,11,0,-11
6323,1,0,54,0,-54
6324,1,0,28,0,-28
6325,1,1,123,1632,1509
6326,1,0,63,0,-63
6327,1,1,172,1204,1032
6328,0,0,8,0,-8
6329,1,0,36,0,-36
6330,1,0,26,0,-26
6331,0,0,13,0,-13
6332,0,0,183,0,-183
6333,1,1,244,1690,1446
6334,1,1,532,1221,689
6335,0,0,38,0,-38
6336,0,0,166,0,-166
6337,1,0,2,0,-2
6338,1,1,819,1548,729
6339,0,0,9,0,-9
6340,1,1,93,1334,1241
6341,1,1,459,1812,1353
6342,1,1,554,1320,766
6343,1,0,88,0,-88
6344,0,0,26,0,-26
6345,1,0,20,0,-20
6346,0,0,2,0,-2
6347,1,1,184,2664,2480
6348,1,0,82,0,-82
6349,0,0,5,0,-5
6350,1,1,1477,1526,49
6351,0,0,20,0,-20
6352,1,1,294,1883,1589
6353,1,0,49,0,-49
6354,1,1,2299,2181,-118
6355,1,0,190,0,-190
6356,0,0,23,0,-23
6357,0,0,29,0,-29
6358,1,0,6,0,-6
6359,0,0,47,0,-47
6360,0,0,21,0,-21
6361,0,0,35,0,-35
6362,0,0,49,0,-49
6363,1,1,133,1245,1112
6364,1,1,200,1362,1162
6365,1,0,58,0,-58
6366,1,0,262,0,-262
6367,1,1,347,1354,1007
6368,0,0,3,0,-3
6369,1,1,517,1436,919
6370,1,1,212,1331,1119
6371,0,0,105,0,-105
6372,1,1,565,1200,635
6373,0,0,10,0,-10
6374,1,0,52,0,-52
6375,1,1,630,2380,1750
6376,1,0,97,0,-97
6377,0,0,16,0,-16
6378,1,0,84,0,-84
6379,1,0,78,0,-78
6380,0,0,12,0,-12
6381,0,0,34,0,-34
6382,0,0,68,0,-68
6383,1,1,599,1289,690
6384,1,1,795,1325,530
6385,0,0,25,0,-25
6386,1,0,73,0,-73
6387,0,0,4,0,-4
6388,1,0,24,0,-24
6389,1,0,5,0,-5
6390,1,0,170,0,-170
6391,1,1,399,1940,1541
6392,1,0,186,0,-186
6393,1,1,1512,1259,-253
6394,1,1,45,1339,1294
6395,1,0,209,0,-209
6396,1,1,210,1241,1031
6397,1,1,413,1286,873
6398,1,1,1407,1221,-186
6399,1,0,17,0,-17
6400,0,0,21,0,-21
6401,1,0,29,0,-29
6402,0,0,44,0,-44
6403,0,0,39,0,-39
6404,1,1,131,2550,2419
6405,0,0,59,0,-59
6406,1,1,49,1679,1630
6407,1,0,18,0,-18
6408,1,1,302,1297,995
6409,1,0,4,0,-4
6410,0,0,93,0,-93
6411,1,0,77,0,-77
6412,0,0,14,0,-14
6413,1,0,4,0,-4
6414,0,0,63,0,-63
6415,1,0,3,0,-3
6416,0,0,92,0,-92
6417,1,0,152,0,-152
6418,0,0,17,0,-17
6419,1,1,1063,1213,150
6420,1,0,28,0,-28
6421,1,1,600,1583,983
6422,0,0,100,0,-100
6423,1,0,2,0,-2
6424,0,0,104,0,-104
6425,0,0,124,0,-124
6426,1,1,566,1731,1165
6427,1,1,216,1779,1563
6428,1,0,10,0,-10
6429,1,1,35,1619,1584
6430,0,0,40,0,-40
6431,1,0,37,0,-37
6432,1,1,874,1289,415
6433,1,0,66,0,-66
6434,1,0,104,0,-104
6435,1,1,348,1259,911
6436,1,1,88,1265,1177
6437,0,0,60,0,-60
6438,1,0,70,0,-70
6439,1,0,51,0,-51
6440,1,1,212,2008,1796
6441,1,1,324,2083,1759
6442,1,1,243,1547,1304
6443,1,1,1010,1653,643
6444,1,1,1387,2513,1126
6445,1,0,19,0,-19
6446,1,0,145,0,-145
6447,1,1,325,1504,1179
6448,1,1,157,1262,1105
6449,0,0,23,0,-23
6450,0,0,41,0,-41
6451,0,0,11,0,-11
6452,0,0,3,0,-3
6453,1,0,19,0,-19
6454,1,1,496,1525,1029
6455,1,0,56,0,-56
6456,0,0,8,0,-8
6457,1,0,31,0,-31
6458,0,0,11,0,-11
6459,1,0,43,0,-43
6460,1,1,232,1220,988
6461,1,1,57,1858,1801
6462,0,0,3,0,-3
6463,0,0,31,0,-31
6464,0,0,3,0,-3
6465,1,0,1,0,-1
6466,1,0,89,0,-89
6467,1,1,1576,1661,85
6468,1,0,121,0,-121
6469,1,1,194,1426,1232
6470,1,1,284,1218,934
6471,0,0,81,0,-81
6472,1,1,369,1230,861
6473,0,0,14,0,-14
6474,0,0,2,0,-2
6475,1,1,116,1236,1120
6476,1,0,59,0,-59
6477,1,0,17,0,-17
6478,1,0,40,0,-40
6479,1,0,16,0,-16
6480,0,0,38,0,-38
6481,0,0,106,0,-106
6482,1,0,14,0,-14
6483,1,0,26,0,-26
6484,1,0,128,0,-128
6485,1,1,879,1821,942
6486,1,0,18,0,-18
6487,0,0,41,0,-41
6488,0,0,25,0,-25
6489,1,1,1350,1359,9
6490,0,0,102,0,-102
6491,0,0,20,0,-20
6492,1,1,418,1575,1157
6493,0,0,35,0,-35
6494,0,0,17,0,-17
6495,0,0,38,0,-38
6496,1,1,381,1304,923
6497,1,0,39,0,-39
6498,1,0,69,0,-69
6499,1,1,297,2214,1917
6500,1,0,15,0,-15
6501,0,0,5,0,-5
6502,1,0,103,0,-103
6503,1,1,899,2768,1869
6504,0,0,45,0,-45
6505,1,0,59,0,-59
6506,0,0,130,0,-130
6507,0,0,2,0,-2
6508,1,0,12,0,-12
6509,0,0,67,0,-67
6510,1,1,990,1225,235
6511,1,0,135,0,-135
6512,1,0,30,0,-30
6513,1,1,107,1353,1246
6514,1,0,18,0,-18
6515,0,0,86,0,-86
6516,1,0,35,0,-35
6517,0,0,39,0,-39
6518,0,0,95,0,-95
6519,0,0,55,0,-55
6520,1,1,118,1761,1643
6521,1,1,65,1311,1246
6522,1,1,1805,1210,-595
6523,1,0,31,0,-31
6524,0,0,17,0,-17
6525,1,0,81,0,-81
6526,1,1,1160,2263,1103
6527,1,1,87,1422,1335
6528,1,0,73,0,-73
6529,1,0,38,0,-38
6530,1,0,44,0,-44
6531,1,0,1,0,-1
6532,0,0,132,0,-132
6533,1,0,113,0,-113
6534,0,0,18,0,-18
6535,1,1,39,9848,9809
6536,1,1,586,1416,830
6537,1,1,706,1420,714
6538,1,0,132,0,-132
6539,1,0,14,0,-14
6540,0,0,136,0,-136
6541,0,0,81,0,-81
6542,0,0,19,0,-19
6543,0,0,26,0,-26
6544,1,0,45,0,-45
6545,1,0,54,0,-54
6546,1,0,0,0,0
6547,1,1,55,1403,1348
6548,1,0,15,0,-15
6549,1,1,2789,1254,-1535
6550,1,0,89,0,-89
6551,0,0,60,0,-60
6552,1,1,1521,1206,-315
6553,1,1,728,1321,593
6554,1,0,38,0,-38
6555,0,0,136,0,-136
6556,1,1,347,1439,1092
6557,0,0,116,0,-116
6558,0,0,159,0,-159
6559,1,1,1955,1311,-644
6560,1,1,255,1354,1099
6561,1,0,154,0,-154
6562,0,0,71,0,-71
6563,0,0,19,0,-19
6564,1,0,2,0,-2
6565,1,1,1550,1311,-239
6566,1,1,651,1652,1001
6567,0,0,14,0,-14
6568,0,0,4,0,-4
6569,0,0,231,0,-231
6570,0,0,58,0,-58
6571,0,0,131,0,-131
6572,1,1,413,1359,946
6573,1,1,82,1314,1232
6574,0,0,95,0,-95
6575,1,1,814,1602,788
6576,1,0,38,0,-38
6577,1,1,109,1909,1800
6578,1,0,161,0,-161
6579,1,0,31,0,-31
6580,1,0,14,0,-14
6581,0,0,32,0,-32
6582,1,0,35,0,-35
6583,1,0,11,0,-11
6584,1,1,327,1336,1009
6585,1,1,2182,2129,-53
6586,1,0,23,0,-23
6587,1,0,9,0,-9
6588,0,0,18,0,-18
6589,0,0,70,0,-70
6590,1,1,594,1514,920
6591,1,1,227,1203,976
6592,1,0,2,0,-2
6593,1,1,51,1201,1150
6594,1,1,701,1353,652
6595,0,0,68,0,-68
6596,0,0,11,0,-11
6597,0,0,104,0,-104
6598,1,1,452,3043,2591
6599,0,0,18,0,-18
6600,1,0,75,0,-75
6601,1,1,2540,1522,-1018
6602,0,0,3,0,-3
6603,1,0,54,0,-54
6604,1,1,844,1298,454
6605,1,1,764,1621,857
6606,1,1,770,1314,544
6607,0,0,18,0,-18
6608,1,1,477,1270,793
6609,1,1,43,1414,1371
6610,0,0,9,0,-9
6611,1,0,93,0,-93
6612,0,0,94,0,-94
6613,1,1,639,1270,631
6614,1,1,247,1380,1133
6615,0,0,48,0,-48
6616,1,1,2479,1510,-969
6617,0,0,6,0,-6
6618,0,0,5,0,-5
6619,0,0,7,0,-7
6620,1,1,489,1469,980
6621,0,0,105,0,-105
6622,0,0,64,0,-64
6623,0,0,96,0,-96
6624,1,0,50,0,-50
6625,1,0,38,0,-38
6626,1,0,13,0,-13
6627,1,0,24,0,-24
6628,1,0,118,0,-118
6629,1,0,59,0,-59
6630,0,0,12,0,-12
6631,1,1,264,1511,1247
6632,1,1,1088,1384,296
6633,0,0,40,0,-40
6634,1,0,77,0,-77
6635,0,0,18,0,-18
6636,0,0,58,0,-58
6637,1,1,177,1237,1060
6638,1,0,322,0,-322
6639,0,0,23,0,-23
6640,1,0,53,0,-53
6641,1,1,345,1251,906
6642,0,0,35,0,-35
6643,1,0,107,0,-107
6644,1,1,406,1340,934
6645,1,1,378,1345,967
6646,0,0,20,0,-20
6647,1,0,9,0,-9
6648,0,0,44,0,-44
6649,1,0,83,0,-83
6650,1,1,186,1552,1366
6651,1,0,301,0,-301
6652,1,1,335,1649,1314
6653,1,0,19,0,-19
6654,1,0,265,0,-265
6655,0,0,3,0,-3
6656,1,0,87,0,-87
6657,0,0,21,0,-21
6658,1,1,557,1535,978
6659,1,1,86,1377,1291
6660,0,0,23,0,-23
6661,0,0,27,0,-27
6662,1,0,11,0,-11
6663,0,0,17,0,-17
6664,1,0,176,0,-176
6665,0,0,73,0,-73
6666,1,0,29,0,-29
6667,1,0,15,0,-15
6668,1,1,68,1823,1755
6669,0,0,5,0,-5
6670,1,1,734,1237,503
6671,0,0,77,0,-77
6672,0,0,16,0,-16
6673,0,0,13,0,-13
6674,0,0,33,0,-33
6675,1,0,33,0,-33
6676,1,0,54,0,-54
6677,1,1,230,1303,1073
6678,0,0,0,0,0
6679,0,0,94,0,-94
6680,0,0,44,0,-44
6681,0,0,18,0,-18
6682,1,1,210,1496,1286
6683,0,0,23,0,-23
6684,0,0,94,0,-94
6685,1,1,717,1342,625
6686,1,1,117,2363,2246
6687,1,0,54,0,-54
6688,0,0,18,0,-18
6689,1,1,2065,1463,-602
6690,1,0,8,0,-8
6691,0,0,160,0,-160
6692,1,0,152,0,-152
6693,1,1,620,1781,1161
6694,0,0,45,0,-45
6695,1,0,23,0,-23
6696,1,1,1658,1329,-329
6697,0,0,45,0,-45
6698,0,0,25,0,-25
6699,0,0,127,0,-127
6700,1,1,137,1424,1287
6701,0,0,138,0,-138
6702,1,0,10,0,-10
6703,0,0,72,0,-72
6704,0,0,2,0,-2
6705,0,0,85,0,-85
6706,1,0,212,0,-212
6707,1,0,17,0,-17
6708,1,0,28,0,-28
6709,0,0,73,0,-73
6710,0,0,2,0,-2
6711,1,1,41,1411,1370
6712,0,0,65,0,-65
6713,1,1,389,1370,981
6714,0,0,40,0,-40
6715,1,1,189,1222,1033
6716,0,0,54,0,-54
6717,1,1,920,1403,483
6718,0,0,10,0,-10
6719,0,0,30,0,-30
6720,1,1,186,1302,1116
6721,1,0,9,0,-9
6722,0,0,30,0,-30
6723,0,0,4,0,-4
6724,0,0,131,0,-131
6725,1,0,97,0,-97
6726,1,0,77,0,-77
6727,0,0,0,0,0
6728,1,1,1288,1468,180
6729,1,0,76,0,-76
6730,0,0,105,0,-105
6731,0,0,20,0,-20
6732,1,1,220,1475,1255
6733,0,0,25,0,-25
6734,0,0,139,0,-139
6735,1,1,67,1516,1449
6736,1,0,25,0,-25
6737,0,0,23,0,-23
6738,0,0,122,0,-122
6739,1,1,85,1281,1196
6740,1,0,162,0,-162
6741,1,1,1200,1317,117
6742,0,0,33,0,-33
6743,1,1,1257,1649,392
6744,1,1,153,1559,1406
6745,1,0,55,0,-55
6746,1,0,126,0,-126
6747,0,0,39,0,-39
6748,1,0,72,0,-72
6749,0,0,47,0,-47
6750,0,0,58,0,-58
6751,1,1,220,1591,1371
6752,1,1,2123,1340,-783
6753,1,1,1228,1222,-6
6754,1,0,42,0,-42
6755,1,1,1336,1737,401
6756,0,0,57,0,-57
6757,0,0,57,0,-57
6758,0,0,13,0,-13
6759,0,0,165,0,-165
6760,0,0,91,0,-91
6761,1,0,3,0,-3
6762,1,1,583,1301,718
6763,0,0,50,0,-50
6764,1,0,11,0,-11
6765,0,0,11,0,-11
6766,0,0,10,0,-10
6767,1,0,149,0,-149
6768,1,0,110,0,-110
6769,1,1,99,2735,2636
6770,0,0,13,0,-13
6771,0,0,16,0,-16
6772,1,0,19,0,-19
6773,1,0,0,0,0
6774,0,0,41,0,-41
6775,1,0,28,0,-28
6776,0,0,3,0,-3
6777,1,0,271,0,-271
6778,0,0,41,0,-41
6779,0,0,21,0,-21
6780,1,0,5,0,-5
6781,1,0,46,0,-46
6782,1,1,103,1244,1141
6783,0,0,59,0,-59
6784,1,1,429,2652,2223
6785,0,0,0,0,0
6786,1,0,91,0,-91
6787,1,1,546,1923,1377
6788,0,0,133,0,-133
6789,0,0,95,0,-95
6790,0,0,80,0,-80
6791,0,0,26,0,-26
6792,1,1,791,2376,1585
6793,0,0,52,0,-52
6794,1,0,70,0,-70
6795,0,0,3,0,-3
6796,0,0,72,0,-72
6797,1,0,17,0,-17
6798,1,0,13,0,-13
6799,0,0,9,0,-9
6800,0,0,124,0,-124
6801,0,0,18,0,-18
6802,1,1,126,1368,1242
6803,0,0,104,0,-104
6804,0,0,32,0,-32
6805,0,0,117,0,-117
6806,0,0,85,0,-85
6807,0,0,7,0,-7
6808,1,0,51,0,-51
6809,1,1,566,1341,775
6810,0,0,30,0,-30
6811,1,1,150,1392,1242
6812,1,1,969,1455,486
6813,0,0,24,0,-24
6814,0,0,46,0,-46
6815,1,1,330,1223,893
6816,0,0,46,0,-46
6817,0,0,25,0,-25
6818,1,1,796,1583,787
6819,0,0,53,0,-53
6820,1,1,176,1267,1091
6821,0,0,58,0,-58
6822,1,1,1567,1850,283
6823,0,0,14,0,-14
6824,1,0,122,0,-122
6825,0,0,10,0,-10
6826,1,0,63,0,-63
6827,1,0,17,0,-17
6828,1,0,19,0,-19
6829,0,0,64,0,-64
6830,1,1,1062,1282,220
6831,1,1,1038,1497,459
6832,0,0,3,0,-3
6833,1,1,302,1510,1208
6834,1,1,667,1246,579
6835,1,1,332,1734,1402
6836,1,0,61,0,-61
6837,1,1,414,1382,968
6838,1,1,64,1759,1695
6839,0,0,17,0,-17
6840,0,0,28,0,-28
6841,0,0,6,0,-6
6842,0,0,67,0,-67
6843,1,1,255,1396,1141
6844,0,0,23,0,-23
6845,1,0,31,0,-31
6846,0,0,17,0,-17
6847,1,0,26,0,-26
6848,1,0,32,0,-32
6849,0,0,37,0,-37
6850,1,1,65,1249,1184
6851,1,1,456,1230,774
6852,1,1,622,2075,1453
6853,1,1,1015,1221,206
6854,0,0,67,0,-67
6855,0,0,7,0,-7
6856,1,1,184,1909,1725
6857,0,0,12,0,-12
6858,0,0,9,0,-9
6859,1,0,160,0,-160
6860,1,0,35,0,-35
6861,1,1,1252,2273,1021
6862,1,1,126,1540,1414
6863,0,0,15,0,-15
6864,0,0,41,0,-41
6865,1,1,1435,2350,915
6866,1,0,17,0,-17
6867,1,1,225,1488,1263
6868,0,0,190,0,-190
6869,1,1,152,1246,1094
6870,0,0,71,0,-71
6871,1,0,6,0,-6
6872,1,1,1348,1246,-102
6873,0,0,80,0,-80
6874,0,0,88,0,-88
6875,0,0,57,0,-57
6876,1,0,34,0,-34
6877,0,0,173,0,-173
6878,1,1,949,1530,581
6879,1,0,62,0,-62
6880,0,0,23,0,-23
6881,1,1,1199,2160,961
6882,1,1,349,1524,1175
6883,0,0,31,0,-31
6884,1,0,59,0,-59
6885,1,1,532,1441,909
6886,0,0,37,0,-37
6887,1,1,680,2121,1441
6888,1,0,25,0,-25
6889,0,0,14,0,-14
6890,0,0,95,0,-95
6891,0,0,34,0,-34
6892,0,0,37,0,-37
6893,0,0,103,0,-103
6894,0,0,54,0,-54
6895,1,0,1,0,-1
6896,1,0,72,0,-72
6897,0,0,42,0,-42
6898,1,0,24,0,-24
6899,1,1,416,1200,784
6900,0,0,22,0,-22
6901,1,1,419,1566,1147
6902,0,0,86,0,-86
6903,1,0,16,0,-16
6904,0,0,2,0,-2
6905,1,0,3,0,-3
6906,1,0,32,0,-32
6907,1,0,17,0,-17
6908,1,1,188,1204,1016
6909,1,0,165,0,-165
6910,1,0,3,0,-3
6911,0,0,295,0,-295
6912,1,1,85,1595,1510
6913,1,0,63,0,-63
6914,1,1,475,1273,798
6915,1,0,8,0,-8
6916,0,0,11,0,-11
6917,1,1,921,1465,544
6918,1,1,62,1620,1558
6919,1,0,4,0,-4
6920,1,1,107,1678,1571
6921,0,0,15,0,-15
6922,1,1,524,1703,1179
6923,1,1,1144,1236,92
6924,1,1,518,1210,692
6925,1,0,150,0,-150
6926,0,0,54,0,-54
6927,1,1,464,2215,1751
6928,0,0,13,0,-13
6929,1,1,533,6649,6116
6930,1,0,9,0,-9
6931,1,0,27,0,-27
6932,1,1,310,2021,1711
6933,0,0,56,0,-56
6934,0,0,2,0,-2
6935,1,0,13,0,-13
6936,0,0,24,0,-24
6937,0,0,108,0,-108
6938,0,0,38,0,-38
6939,0,0,66,0,-66
6940,0,0,37,0,-37
6941,0,0,11,0,-11
6942,1,0,163,0,-163
6943,1,0,28,0,-28
6944,1,1,153,2839,2686
6945,1,0,31,0,-31
6946,1,0,3,0,-3
6947,1,0,13,0,-13
6948,0,0,11,0,-11
6949,0,0,94,0,-94
6950,1,1,178,1416,1238
6951,1,0,33,0,-33
6952,0,0,17,0,-17
6953,1,1,229,1273,1044
6954,1,0,6,0,-6
6955,0,0,26,0,-26
6956,1,1,176,1272,1096
6957,0,0,8,0,-8
6958,1,0,30,0,-30
6959,0,0,93,0,-93
6960,1,0,24,0,-24
6961,0,0,77,0,-77
6962,0,0,43,0,-43
6963,1,1,174,1488,1314
6964,0,0,4,0,-4
6965,0,0,76,0,-76
6966,1,0,19,0,-19
6967,1,1,781,1321,540
6968,0,0,15,0,-15
6969,0,0,128,0,-128
6970,1,1,68,1683,1615
6971,0,0,186,0,-186
6972,1,0,63,0,-63
6973,1,0,3,0,-3
6974,1,1,295,1273,978
6975,1,0,184,0,-184
6976,1,0,95,0,-95
6977,0,0,123,0,-123
6978,0,0,38,0,-38
6979,0,0,8,0,-8
6980,0,0,28,0,-28
6981,0,0,23,0,-23
6982,1,1,200,1256,1056
6983,0,0,130,0,-130
6984,0,0,27,0,-27
6985,1,0,6,0,-6
6986,0,0,3,0,-3
6987,1,0,74,0,-74
6988,0,0,212,0,-212
6989,1,0,58,0,-58
6990,0,0,2,0,-2
6991,1,0,26,0,-26
6992,0,0,12,0,-12
6993,1,0,1,0,-1
6994,1,1,238,2252,2014
6995,1,1,678,2460,1782
6996,0,0,48,0,-48
6997,1,0,106,0,-106
6998,1,0,54,0,-54
6999,1,1,140,1378,1238
7000,1,1,317,1237,920
7001,1,1,46,2313,2267
7002,1,1,1068,1222,154
7003,0,0,33,0,-33
7004,0,0,48,0,-48
7005,1,1,392,1410,1018
7006,1,0,35,0,-35
7007,1,1,685,1423,738
7008,1,0,8,0,-8
7009,0,0,21,0,-21
7010,1,1,978,1437,459
7011,1,0,32,0,-32
7012,0,0,13,0,-13
7013,0,0,9,0,-9
7014,0,0,103,0,-103
7015,0,0,2,0,-2
7016,1,0,41,0,-41
7017,0,0,94,0,-94
7018,1,0,25,0,-25
7019,0,0,67,0,-67
7020,1,1,395,1250,855
7021,0,0,46,0,-46
7022,0,0,33,0,-33
7023,0,0,25,0,-25
7024,0,0,31,0,-31
7025,1,0,171,0,-171
7026,1,0,10,0,-10
7027,0,0,39,0,-39
7028,1,1,603,1354,751
7029,1,0,159,0,-159
7030,1,1,302,1262,960
7031,1,1,231,1797,1566
7032,1,0,67,0,-67
7033,1,0,215,0,-215
7034,1,1,961,1240,279
7035,1,0,4,0,-4
7036,0,0,11,0,-11
7037,1,1,1608,1917,309
7038,1,1,295,1350,1055
7039,0,0,27,0,-27
7040,0,0,9,0,-9
7041,0,0,5,0,-5
7042,0,0,19,0,-19
7043,0,0,162,0,-162
7044,1,1,122,3560,3438
7045,1,0,20,0,-20
7046,1,1,333,1313,980
7047,1,1,413,1571,1158
7048,1,0,24,0,-24
7049,1,1,447,1285,838
7050,1,1,4189,1216,-2973
7051,1,0,51,0,-51
7052,0,0,43,0,-43
7053,0,0,57,0,-57
7054,1,1,1159,1945,786
7055,1,1,449,1276,827
7056,1,0,24,0,-24
7057,0,0,9,0,-9
7058,0,0,17,0,-17
7059,1,0,30,0,-30
7060,0,0,39,0,-39
7061,0,0,87,0,-87
7062,1,1,189,1263,1074
7063,0,0,20,0,-20
7064,0,0,5,0,-5
7065,1,0,55,0,-55
7066,1,1,203,1275,1072
7067,1,0,36,0,-36
7068,1,0,115,0,-115
7069,1,0,62,0,-62
7070,1,1,822,1336,514
7071,0,0,89,0,-89
7072,1,1,364,3016,2652
7073,1,0,104,0,-104
7074,0,0,16,0,-16
7075,1,1,653,2516,1863
7076,1,0,55,0,-55
7077,1,0,22,0,-22
7078,1,1,276,1556,1280
7079,1,0,5,0,-5
7080,1,0,16,0,-16
7081,0,0,28,0,-28
7082,1,0,6,0,-6
7083,0,0,36,0,-36
7084,1,1,237,1284,1047
7085,0,0,3,0,-3
7086,0,0,23,0,-23
7087,1,1,277,2249,1972
7088,1,0,157,0,-157
7089,0,0,47,0,-47
7090,1,1,240,1233,993
7091,1,0,149,0,-149
7092,1,1,490,1389,899
7093,0,0,5,0,-5
7094,0,0,0,0,0
7095,0,0,66,0,-66
7096,0,0,73,0,-73
7097,1,0,7,0,-7
7098,1,1,255,1999,1744
7099,0,0,78,0,-78
7100,1,1,423,1744,1321
7101,1,1,120,1353,1233
7102,0,0,0,0,0
7103,1,0,57,0,-57
7104,0,0,3,0,-3
7105,1,1,60,2314,2254
7106,1,1,83,1220,1137
7107,0,0,31,0,-31
7108,1,0,53,0,-53
7109,1,1,228,1307,1079
7110,1,1,163,1315,1152
7111,0,0,223,0,-223
7112,1,1,476,1372,896
7113,1,0,32,0,-32
7114,0,0,67,0,-67
7115,1,0,35,0,-35
7116,0,0,45,0,-45
7117,0,0,25,0,-25
7118,1,1,123,1533,1410
7119,1,1,776,1429,653
7120,1,0,121,0,-121
7121,1,0,20,0,-20
7122,1,0,14,0,-14
7123,1,0,6,0,-6
7124,0,0,21,0,-21
7125,1,1,614,1362,748
7126,1,0,28,0,-28
7127,1,0,101,0,-101
7128,1,1,495,1240,745
7129,0,0,44,0,-44
7130,0,0,28,0,-28
7131,1,0,54,0,-54
7132,0,0,45,0,-45
7133,1,1,132,1392,1260
7134,0,0,48,0,-48
7135,1,0,69,0,-69
7136,1,0,3,0,-3
7137,1,0,32,0,-32
7138,1,1,232,1269,1037
7139,1,0,42,0,-42
7140,0,0,92,0,-92
7141,1,0,16,0,-16
7142,1,0,22,0,-22
7143,1,0,44,0,-44
7144,1,0,4,0,-4
7145,0,0,68,0,-68
7146,1,0,41,0,-41
7147,0,0,54,0,-54
7148,0,0,41,0,-41
7149,0,0,39,0,-39
7150,0,0,118,0,-118
7151,1,0,137,0,-137
7152,1,1,108,1288,1180
7153,1,1,118,1409,1291
7154,1,1,182,1326,1144
7155,0,0,18,0,-18
7156,0,0,67,0,-67
7157,1,1,855,1223,368
7158,1,0,98,0,-98
7159,0,0,27,0,-27
7160,0,0,3,0,-3
7161,0,0,17,0,-17
7162,0,0,26,0,-26
7163,1,1,54,1458,1404
7164,1,1,194,2431,2237
7165,0,0,66,0,-66
7166,1,1,200,2181,1981
7167,0,0,49,0,-49
7168,0,0,106,0,-106
7169,1,1,221,1224,1003
7170,1,1,90,1810,1720
7171,0,0,130,0,-130
7172,1,0,26,0,-26
7173,0,0,38,0,-38
7174,1,1,127,1371,1244
7175,1,0,74,0,-74
7176,0,0,91,0,-91
7177,0,0,21,0,-21
7178,0,0,0,0,0
7179,1,0,185,0,-185
7180,0,0,5,0,-5
7181,1,0,4,0,-4
7182,0,0,279,0,-279
7183,1,1,120,1458,1338
7184,1,0,81,0,-81
7185,1,1,442,1476,1034
7186,0,0,1,0,-1
7187,1,0,3,0,-3
7188,1,1,198,1724,1526
7189,1,0,108,0,-108
7190,1,0,41,0,-41
7191,1,0,25,0,-25
7192,1,0,46,0,-46
7193,0,0,1,0,-1
7194,0,0,30,0,-30
7195,1,0,71,0,-71
7196,1,1,537,1842,1305
7197,1,1,314,1449,1135
7198,1,1,177,1237,1060
7199,1,1,1138,1366,228
7200,0,0,49,0,-49
7201,0,0,22,0,-22
7202,0,0,10,0,-10
7203,0,0,33,0,-33
7204,1,1,530,1687,1157
7205,0,0,28,0,-28
7206,1,1,1932,1525,-407
7207,1,1,528,1608,1080
7208,0,0,24,0,-24
7209,0,0,53,0,-53
7210,1,1,1576,1218,-358
7211,1,1,187,3965,3778
7212,0,0,130,0,-130
7213,1,1,1032,1471,439
7214,1,0,29,0,-29
7215,0,0,33,0,-33
7216,0,0,38,0,-38
7217,1,0,12,0,-12
7218,0,0,17,0,-17
7219,1,0,16,0,-16
7220,1,1,562,1429,867
7221,1,0,42,0,-42
7222,0,0,5,0,-5
7223,1,1,787,1495,708
7224,0,0,3,0,-3
7225,0,0,28,0,-28
7226,0,0,38,0,-38
7227,1,0,5,0,-5
7228,0,0,245,0,-245
7229,1,1,398,1271,873
7230,0,0,24,0,-24
7231,0,0,127,0,-127
7232,1,1,665,1243,578
7233,1,0,59,0,-59
7234,1,0,14,0,-14
7235,1,1,590,1233,643
7236,0,0,30,0,-30
7237,0,0,8,0,-8
7238,1,1,160,1272,1112
7239,1,0,47,0,-47
7240,0,0,337,0,-337
7241,1,1,981,2360,1379
7242,0,0,53,0,-53
7243,1,1,71,1770,1699
7244,1,0,199,0,-199
7245,0,0,20,0,-20
7246,1,1,1244,1321,77
7247,0,0,21,0,-21
7248,0,0,14,0,-14
7249,1,1,799,1236,437
7250,1,0,114,0,-114
7251,0,0,1,0,-1
7252,0,0,18,0,-18
7253,1,0,34,0,-34
7254,1,0,111,0,-111
7255,0,0,77,0,-77
7256,1,0,23,0,-23
7257,1,1,251,1260,1009
7258,0,0,32,0,-32
7259,0,0,78,0,-78
7260,0,0,3,0,-3
7261,1,1,420,1289,869
7262,1,0,68,0,-68
7263,1,1,906,2605,1699
7264,0,0,44,0,-44
7265,0,0,67,0,-67
7266,1,1,558,1620,1062
7267,1,0,50,0,-50
7268,0,0,49,0,-49
7269,1,1,361,2088,1727
7270,1,1,258,1508,1250
7271,0,0,57,0,-57
7272,0,0,67,0,-67
7273,1,1,349,2192,1843
7274,1,1,501,1242,741
7275,0,0,125,0,-125
7276,1,0,48,0,-48
7277,1,0,54,0,-54
7278,1,1,258,1625,1367
7279,0,0,30,0,-30
7280,0,0,25,0,-25
7281,1,0,18,0,-18
7282,0,0,0,0,0
7283,0,0,37,0,-37
7284,1,0,12,0,-12
7285,1,0,93,0,-93
7286,0,0,33,0,-33
7287,0,0,23,0,-23
7288,1,0,16,0,-16
7289,1,0,5,0,-5
7290,0,0,200,0,-200
7291,1,0,147,0,-147
7292,0,0,123,0,-123
7293,1,0,63,0,-63
7294,0,0,6,0,-6
7295,1,0,37,0,-37
7296,1,0,12,0,-12
7297,1,1,4371,1342,-3029
7298,1,1,116,1235,1119
7299,0,0,21,0,-21
7300,0,0,45,0,-45
7301,1,0,5,0,-5
7302,1,1,848,1650,802
7303,0,0,74,0,-74
7304,0,0,20,0,-20
7305,1,0,74,0,-74
7306,0,0,53,0,-53
7307,1,0,4,0,-4
7308,1,1,859,1394,535
7309,0,0,62,0,-62
7310,1,0,61,0,-61
7311,1,1,587,1334,747
7312,0,0,14,0,-14
7313,1,0,2,0,-2
7314,0,0,56,0,-56
7315,1,1,175,1243,1068
7316,1,0,33,0,-33
7317,1,1,205,1281,1076
7318,1,0,38,0,-38
7319,1,0,59,0,-59
7320,0,0,2,0,-2
7321,1,1,370,1902,1532
7322,0,0,86,0,-86
7323,0,0,41,0,-41
7324,1,1,222,1295,1073
7325,1,1,531,2397,1866
7326,1,0,13,0,-13
7327,0,0,50,0,-50
7328,1,0,16,0,-16
7329,0,0,173,0,-173
7330,1,1,421,1429,1008
7331,1,0,0,0,0
7332,1,0,108,0,-108
7333,1,0,63,0,-63
7334,1,1,2282,1221,-1061
7335,1,1,641,1440,799
7336,1,1,390,1766,1376
7337,0,0,93,0,-93
7338,1,1,348,1250,902
7339,0,0,10,0,-10
7340,0,0,19,0,-19
7341,1,0,2,0,-2
7342,0,0,33,0,-33
7343,0,0,20,0,-20
7344,0,0,107,0,-107
7345,1,0,91,0,-91
7346,1,0,31,0,-31
7347,0,0,47,0,-47
7348,1,0,62,0,-62
7349,1,1,599,1873,1274
7350,1,1,662,2083,1421
7351,1,0,5,0,-5
7352,1,0,16,0,-16
7353,1,1,586,2082,1496
7354,1,1,303,1354,1051
7355,1,1,155,1390,1235
7356,0,0,17,0,-17
7357,1,1,317,1217,900
7358,0,0,89,0,-89
7359,1,0,14,0,-14
7360,1,0,23,0,-23
7361,0,0,22,0,-22
7362,1,0,61,0,-61
7363,1,0,52,0,-52
7364,1,0,5,0,-5
7365,0,0,44,0,-44
7366,1,1,1411,1480,69
7367,1,1,463,1580,1117
7368,1,0,95,0,-95
7369,0,0,11,0,-11
7370,0,0,58,0,-58
7371,0,0,28,0,-28
7372,1,1,663,1767,1104
7373,1,0,81,0,-81
7374,1,0,60,0,-60
7375,0,0,34,0,-34
7376,1,0,111,0,-111
7377,1,1,318,1923,1605
7378,1,0,104,0,-104
7379,0,0,173,0,-173
7380,0,0,11,0,-11
7381,0,0,45,0,-45
7382,1,0,35,0,-35
7383,0,0,40,0,-40
7384,1,0,67,0,-67
7385,1,0,46,0,-46
7386,1,1,126,1257,1131
7387,1,1,315,1267,952
7388,1,0,36,0,-36
7389,0,0,67,0,-67
7390,1,0,51,0,-51
7391,1,0,50,0,-50
7392,0,0,30,0,-30
7393,0,0,6,0,-6
7394,1,1,666,1359,693
7395,1,0,30,0,-30
7396,1,0,1,0,-1
7397,1,0,52,0,-52
7398,0,0,6,0,-6
7399,0,0,30,0,-30
7400,0,0,27,0,-27
7401,1,1,400,1491,1091
7402,1,0,205,0,-205
7403,0,0,15,0,-15
7404,1,1,517,1781,1264
7405,1,0,64,0,-64
7406,1,0,117,0,-117
7407,0,0,43,0,-43
7408,0,0,10,0,-10
7409,1,0,29,0,-29
7410,1,0,6,0,-6
7411,1,1,436,1600,1164
7412,1,1,429,1896,1467
7413,1,0,49,0,-49
7414,1,0,10,0,-10
7415,0,0,20,0,-20
7416,1,1,422,1624,1202
7417,1,1,470,1259,789
7418,1,1,1057,1210,153
7419,0,0,5,0,-5
7420,1,1,236,2370,2134
7421,1,1,237,1263,1026
7422,1,1,1475,1301,-174
7423,1,1,350,1226,876
7424,0,0,70,0,-70
7425,0,0,2,0,-2
7426,1,1,495,1233,738
7427,0,0,121,0,-121
7428,0,0,39,0,-39
7429,0,0,20,0,-20
7430,1,0,53,0,-53
7431,1,0,37,0,-37
7432,1,1,1887,1340,-547
7433,1,1,216,1238,1022
7434,0,0,114,0,-114
7435,1,1,72,2417,2345
7436,0,0,16,0,-16
7437,0,0,2,0,-2
7438,0,0,7,0,-7
7439,0,0,98,0,-98
7440,1,1,464,1749,1285
7441,1,0,11,0,-11
7442,1,1,388,1776,1388
7443,0,0,32,0,-32
7444,0,0,48,0,-48
7445,1,0,114,0,-114
7446,1,0,102,0,-102
7447,1,1,482,1257,775
7448,0,0,11,0,-11
7449,0,0,58,0,-58
7450,1,1,359,1364,1005
7451,0,0,46,0,-46
7452,1,0,8,0,-8
7453,0,0,28,0,-28
7454,0,0,4,0,-4
7455,0,0,14,0,-14
7456,1,0,37,0,-37
7457,1,0,29,0,-29
7458,1,1,583,1263,680
7459,1,1,1356,1244,-112
7460,1,0,6,0,-6
7461,1,1,803,1315,512
7462,1,1,283,2017,1734
7463,1,0,2,0,-2
7464,1,0,74,0,-74
7465,0,0,35,0,-35
7466,1,1,635,1319,684
7467,0,0,3,0,-3
7468,1,0,23,0,-23
7469,1,1,489,2141,1652
7470,1,0,22,0,-22
7471,0,0,37,0,-37
7472,1,0,44,0,-44
7473,1,0,57,0,-57
7474,0,0,5,0,-5
7475,0,0,1,0,-1
7476,0,0,141,0,-141
7477,1,0,13,0,-13
7478,0,0,74,0,-74
7479,0,0,4,0,-4
7480,1,0,59,0,-59
7481,0,0,1,0,-1
7482,0,0,88,0,-88
7483,1,1,1622,1220,-402
7484,1,0,48,0,-48
7485,1,0,80,0,-80
7486,1,1,359,1632,1273
7487,1,0,17,0,-17
7488,1,0,21,0,-21
7489,0,0,1,0,-1
7490,1,0,33,0,-33
7491,0,0,123,0,-123
7492,1,0,60,0,-60
7493,1,0,27,0,-27
7494,0,0,23,0,-23
7495,0,0,34,0,-34
7496,1,1,102,1458,1356
7497,1,1,191,1655,1464
7498,0,0,7,0,-7
7499,0,0,84,0,-84
7500,1,1,163,1663,1500
7501,0,0,5,0,-5
7502,0,0,11,0,-11
7503,1,1,151,1345,1194
7504,0,0,129,0,-129
7505,1,0,116,0,-116
7506,1,1,250,1236,986
7507,0,0,22,0,-22
7508,1,1,237,1220,983
7509,0,0,283,0,-283
7510,1,0,64,0,-64
7511,1,1,440,1212,772
7512,1,0,33,0,-33
7513,1,0,39,0,-39
7514,1,1,358,1447,1089
7515,0,0,20,0,-20
7516,1,0,24,0,-24
7517,0,0,64,0,-64
7518,1,0,12,0,-12
7519,1,1,1233,1283,50
7520,1,1,205,3011,2806
7521,1,1,1339,1394,55
7522,0,0,10,0,-10
7523,0,0,12,0,-12
7524,1,0,49,0,-49
7525,1,0,20,0,-20
7526,1,0,21,0,-21
7527,0,0,85,0,-85
7528,1,1,143,1477,1334
7529,1,0,116,0,-116
7530,1,0,3,0,-3
7531,1,0,82,0,-82
7532,1,1,337,1746,1409
7533,1,1,394,1237,843
7534,0,0,2,0,-2
7535,1,0,47,0,-47
7536,1,0,20,0,-20
7537,0,0,99,0,-99
7538,0,0,18,0,-18
7539,0,0,18,0,-18
7540,1,0,13,0,-13
7541,0,0,62,0,-62
7542,1,1,914,1368,454
7543,1,1,902,1545,643
7544,0,0,106,0,-106
7545,0,0,10,0,-10
7546,0,0,12,0,-12
7547,1,0,7,0,-7
7548,1,1,544,1747,1203
7549,0,0,12,0,-12
7550,0,0,10,0,-10
7551,1,1,208,1333,1125
7552,0,0,14,0,-14
7553,1,0,26,0,-26
7554,0,0,41,0,-41
7555,1,0,52,0,-52
7556,1,1,118,1343,1225
7557,0,0,47,0,-47
7558,0,0,76,0,-76
7559,1,1,112,1453,1341
7560,1,0,8,0,-8
7561,1,1,166,1421,1255
7562,1,1,323,2025,1702
7563,0,0,97,0,-97
7564,1,1,245,2318,2073
7565,1,0,7,0,-7
7566,0,0,1,0,-1
7567,0,0,38,0,-38
7568,1,0,72,0,-72
7569,1,0,29,0,-29
7570,1,0,50,0,-50
7571,0,0,172,0,-172
7572,0,0,47,0,-47
7573,1,0,17,0,-17
7574,0,0,52,0,-52
7575,1,1,182,1237,1055
7576,1,0,33,0,-33
7577,0,0,122,0,-122
7578,0,0,13,0,-13
7579,1,0,156,0,-156
7580,1,1,706,1211,505
7581,0,0,10,0,-10
7582,0,0,27,0,-27
7583,0,0,8,0,-8
7584,0,0,40,0,-40
7585,0,0,28,0,-28
7586,1,0,16,0,-16
7587,1,0,75,0,-75
7588,1,0,26,0,-26
7589,0,0,216,0,-216
7590,1,0,30,0,-30
7591,1,0,52,0,-52
7592,1,0,195,0,-195
7593,1,0,57,0,-57
7594,1,1,110,1837,1727
7595,1,0,5,0,-5
7596,1,0,25,0,-25
7597,1,0,17,0,-17
7598,1,0,65,0,-65
7599,0,0,38,0,-38
7600,0,0,29,0,-29
7601,1,1,650,1229,579
7602,1,1,466,1538,1072
7603,1,0,24,0,-24
7604,1,1,592,1481,889
7605,1,0,43,0,-43
7606,0,0,1,0,-1
7607,1,0,3,0,-3
7608,0,0,40,0,-40
7609,1,0,70,0,-70
7610,0,0,25,0,-25
7611,1,1,350,1842,1492
7612,1,0,64,0,-64
7613,1,0,1,0,-1
7614,0,0,25,0,-25
7615,1,1,587,2055,1468
7616,0,0,12,0,-12
7617,0,0,104,0,-104
7618,1,1,1171,1261,90
7619,1,0,8,0,-8
7620,1,1,312,1423,1111
7621,1,1,520,1445,925
7622,1,1,80,1261,1181
7623,0,0,7,0,-7
7624,1,0,3,0,-3
7625,0,0,22,0,-22
7626,1,1,1311,1299,-12
7627,1,1,416,1439,1023
7628,1,0,3,0,-3
7629,0,0,73,0,-73
7630,1,0,60,0,-60
7631,1,0,64,0,-64
7632,1,1,203,1331,1128
7633,0,0,71,0,-71
7634,1,0,18,0,-18
7635,0,0,58,0,-58
7636,1,1,609,1383,774
7637,1,0,172,0,-172
7638,0,0,48,0,-48
7639,1,0,22,0,-22
7640,0,0,5,0,-5
7641,1,0,43,0,-43
7642,0,0,16,0,-16
7643,1,1,14,1451,1437
7644,0,0,66,0,-66
7645,0,0,6,0,-6
7646,1,1,205,1315,1110
7647,1,1,1464,1217,-247
7648,0,0,2,0,-2
7649,1,1,40,1685,1645
7650,1,1,277,1211,934
7651,0,0,18,0,-18
7652,0,0,46,0,-46
7653,1,0,112,0,-112
7654,0,0,30,0,-30
7655,1,0,5,0,-5
7656,1,1,145,1701,1556
7657,0,0,188,0,-188
7658,0,0,40,0,-40
7659,0,0,76,0,-76
7660,1,1,43,1375,1332
7661,1,1,185,1265,1080
7662,0,0,24,0,-24
7663,1,0,29,0,-29
7664,1,1,294,2102,1808
7665,0,0,35,0,-35
7666,0,0,11,0,-11
7667,1,0,62,0,-62
7668,1,0,30,0,-30
7669,1,0,107,0,-107
7670,0,0,52,0,-52
7671,0,0,56,0,-56
7672,0,0,71,0,-71
7673,0,0,84,0,-84
7674,0,0,35,0,-35
7675,1,0,20,0,-20
7676,0,0,2,0,-2
7677,1,1,33,1341,1308
7678,0,0,64,0,-64
7679,1,1,266,1931,1665
7680,1,1,115,1773,1658
7681,1,1,73,1357,1284
7682,1,1,745,1230,485
7683,1,1,381,2234,1853
7684,1,1,788,1206,418
7685,1,1,288,1210,922
7686,1,0,119,0,-119
7687,1,0,5,0,-5
7688,0,0,12,0,-12
7689,0,0,22,0,-22
7690,1,1,55,1346,1291
7691,1,0,7,0,-7
7692,0,0,5,0,-5
7693,0,0,9,0,-9
7694,0,0,4,0,-4
7695,1,0,10,0,-10
7696,0,0,8,0,-8
7697,1,0,12,0,-12
7698,0,0,15,0,-15
7699,1,0,28,0,-28
7700,0,0,31,0,-31
7701,0,0,12,0,-12
7702,1,1,187,2135,1948
7703,0,0,33,0,-33
7704,0,0,80,0,-80
7705,1,1,1019,3588,2569
7706,0,0,27,0,-27
7707,0,0,67,0,-67
7708,0,0,93,0,-93
7709,1,0,76,0,-76
7710,1,0,75,0,-75
7711,1,1,415,1264,849
7712,0,0,68,0,-68
7713,0,0,12,0,-12
7714,0,0,94,0,-94
7715,1,0,251,0,-251
7716,1,1,1968,1328,-640
7717,0,0,58,0,-58
7718,1,0,39,0,-39
7719,0,0,1,0,-1
7720,1,1,815,1812,997
7721,1,1,128,2728,2600
7722,1,0,3,0,-3
7723,1,1,851,1349,498
7724,0,0,144,0,-144
7725,1,1,213,1739,1526
7726,0,0,89,0,-89
7727,1,0,130,0,-130
7728,1,1,787,1276,489
7729,1,0,15,0,-15
7730,1,0,54,0,-54
7731,1,1,182,1332,1150
7732,1,0,19,0,-19
7733,1,0,30,0,-30
7734,0,0,26,0,-26
7735,1,1,675,1362,687
7736,1,1,2245,1584,-661
7737,0,0,16,0,-16
7738,1,0,91,0,-91
7739,0,0,17,0,-17
7740,1,1,553,1407,854
7741,1,0,26,0,-26
7742,0,0,29,0,-29
7743,0,0,5,0,-5
7744,1,0,55,0,-55
7745,1,1,153,1285,1132
7746,0,0,30,0,-30
7747,1,1,893,1393,500
7748,1,0,128,0,-128
7749,0,0,42,0,-42
7750,1,0,58,0,-58
7751,1,1,1880,2209,329
7752,1,0,5,0,-5
7753,1,0,100,0,-100
7754,0,0,2,0,-2
7755,0,0,93,0,-93
7756,1,0,247,0,-247
7757,0,0,10,0,-10
7758,1,1,353,1367,1014
7759,1,1,201,1235,1034
7760,1,1,1617,1281,-336
7761,1,0,11,0,-11
7762,1,1,1388,1272,-116
7763,0,0,106,0,-106
7764,0,0,91,0,-91
7765,0,0,12,0,-12
7766,1,0,27,0,-27
7767,0,0,4,0,-4
7768,0,0,8,0,-8
7769,1,1,269,1537,1268
7770,0,0,6,0,-6
7771,0,0,13,0,-13
7772,1,1,296,1242,946
7773,0,0,1,0,-1
7774,1,1,602,1301,699
7775,1,0,8,0,-8
7776,0,0,192,0,-192
7777,1,0,22,0,-22
7778,1,1,669,1210,541
7779,0,0,45,0,-45
7780,1,1,16,1222,1206
7781,0,0,13,0,-13
7782,1,1,561,1259,698
7783,0,0,55,0,-55
7784,0,0,62,0,-62
7785,0,0,42,0,-42
7786,1,1,213,1255,1042
7787,0,0,35,0,-35
7788,1,1,229,1418,1189
7789,1,0,23,0,-23
7790,0,0,1,0,-1
7791,1,1,44,1613,1569
7792,0,0,172,0,-172
7793,0,0,88,0,-88
7794,0,0,3,0,-3
7795,1,1,458,1648,1190
7796,0,0,5,0,-5
7797,1,0,10,0,-10
7798,1,1,119,1251,1132
7799,1,1,440,1531,1091
7800,0,0,127,0,-127
7801,0,0,84,0,-84
7802,1,0,119,0,-119
7803,1,1,244,1358,1114
7804,0,0,30,0,-30
7805,1,0,27,0,-27
7806,0,0,15,0,-15
7807,1,1,49,1234,1185
7808,1,0,73,0,-73
7809,0,0,29,0,-29
7810,1,1,271,1229,958
7811,1,0,30,0,-30
7812,1,1,411,1380,969
7813,0,0,8,0,-8
7814,1,0,7,0,-7
7815,0,0,6,0,-6
7816,0,0,34,0,-34
7817,0,0,60,0,-60
7818,1,0,12,0,-12
7819,1,0,20,0,-20
7820,1,1,78,1423,1345
7821,0,0,175,0,-175
7822,0,0,26,0,-26
7823,0,0,19,0,-19
7824,0,0,28,0,-28
7825,1,1,1254,2135,881
7826,1,0,27,0,-27
7827,0,0,8,0,-8
7828,1,1,123,1383,1260
7829,1,1,149,1325,1176
7830,1,1,209,1770,1561
7831,1,1,626,1213,587
7832,1,1,1527,1940,413
7833,1,0,3,0,-3
7834,1,1,686,1470,784
7835,0,0,15,0,-15
7836,0,0,354,0,-354
7837,1,0,2,0,-2
7838,0,0,17,0,-17
7839,0,0,97,0,-97
7840,1,0,11,0,-11
7841,0,0,83,0,-83
7842,0,0,17,0,-17
7843,1,0,22,0,-22
7844,0,0,58,0,-58
7845,1,0,10,0,-10
7846,1,0,46,0,-46
7847,0,0,90,0,-90
7848,1,1,1785,2431,646
7849,1,0,20,0,-20
7850,1,1,2586,2127,-459
7851,1,1,534,1585,1051
7852,1,0,12,0,-12
7853,0,0,25,0,-25
7854,1,0,16,0,-16
7855,1,0,33,0,-33
7856,0,0,157,0,-157
7857,0,0,30,0,-30
7858,0,0,42,0,-42
7859,1,0,48,0,-48
7860,1,0,16,0,-16
7861,0,0,48,0,-48
7862,1,1,340,1388,1048
7863,1,1,193,1264,1071
7864,0,0,32,0,-32
7865,1,0,18,0,-18
7866,1,1,225,1496,1271
7867,1,0,67,0,-67
7868,0,0,32,0,-32
7869,1,1,134,1216,1082
7870,1,0,14,0,-14
7871,0,0,7,0,-7
7872,1,1,270,1232,962
7873,1,0,13,0,-13
7874,1,0,3,0,-3
7875,0,0,122,0,-122
7876,1,0,38,0,-38
7877,0,0,5,0,-5
7878,1,1,403,1457,1054
7879,1,1,1289,1287,-2
7880,1,0,27,0,-27
7881,1,0,8,0,-8
7882,1,0,11,0,-11
7883,1,1,199,1236,1037
7884,1,0,40,0,-40
7885,1,0,30,0,-30
7886,1,1,74,1350,1276
7887,1,0,11,0,-11
7888,1,1,1804,2341,537
7889,1,0,44,0,-44
7890,1,1,386,1425,1039
7891,1,1,542,1300,758
7892,0,0,79,0,-79
7893,1,0,3,0,-3
7894,1,1,211,1971,1760
7895,0,0,0,0,0
7896,1,0,13,0,-13
7897,0,0,123,0,-123
7898,1,1,714,1248,534
7899,1,0,36,0,-36
7900,0,0,11,0,-11
7901,1,1,120,2303,2183
7902,1,1,36,1401,1365
7903,1,0,9,0,-9
7904,1,1,435,1201,766
7905,0,0,10,0,-10
7906,0,0,33,0,-33
7907,1,0,6,0,-6
7908,1,1,286,1259,973
7909,0,0,2,0,-2
7910,1,1,129,1611,1482
7911,0,0,38,0,-38
7912,0,0,36,0,-36
7913,1,1,331,1642,1311
7914,1,1,571,1538,967
7915,1,1,466,1318,852
7916,0,0,15,0,-15
7917,0,0,155,0,-155
7918,0,0,50,0,-50
7919,0,0,40,0,-40
7920,1,0,186,0,-186
7921,0,0,33,0,-33
7922,0,0,8,0,-8
7923,0,0,77,0,-77
7924,1,1,531,1353,822
7925,1,0,124,0,-124
7926,0,0,78,0,-78
7927,0,0,99,0,-99
7928,1,0,59,0,-59
7929,1,0,240,0,-240
7930,1,1,507,1804,1297
7931,1,0,21,0,-21
7932,1,1,290,2112,1822
7933,1,1,268,1372,1104
7934,1,0,33,0,-33
7935,0,0,38,0,-38
7936,0,0,13,0,-13
7937,1,0,34,0,-34
7938,1,1,428,1349,921
7939,1,0,88,0,-88
7940,0,0,9,0,-9
7941,0,0,10,0,-10
7942,1,0,83,0,-83
7943,1,1,495,2427,1932
7944,0,0,16,0,-16
7945,1,1,929,1309,380
7946,1,0,6,0,-6
7947,1,0,62,0,-62
7948,1,1,314,1778,1464
7949,1,1,1916,1341,-575
7950,0,0,102,0,-102
7951,1,0,10,0,-10
7952,1,1,209,2085,1876
7953,0,0,65,0,-65
7954,0,0,201,0,-201
7955,1,0,71,0,-71
7956,0,0,10,0,-10
7957,0,0,24,0,-24
7958,1,1,260,1270,1010
7959,0,0,26,0,-26
7960,1,1,1945,1360,-585
7961,0,0,61,0,-61
7962,1,0,4,0,-4
7963,0,0,114,0,-114
7964,1,0,82,0,-82
7965,1,0,53,0,-53
7966,0,0,57,0,-57
7967,0,0,34,0,-34
7968,0,0,64,0,-64
7969,0,0,26,0,-26
7970,0,0,11,0,-11
7971,0,0,5,0,-5
7972,0,0,40,0,-40
7973,1,0,14,0,-14
7974,1,1,33,1225,1192
7975,0,0,102,0,-102
7976,1,0,98,0,-98
7977,1,1,436,1430,994
7978,1,1,474,1454,980
7979,1,0,32,0,-32
7980,1,1,176,1269,1093
7981,0,0,108,0,-108
7982,1,0,8,0,-8
7983,1,1,640,2599,1959
7984,1,1,201,1244,1043
7985,1,0,43,0,-43
7986,1,1,150,3285,3135
7987,0,0,118,0,-118
7988,0,0,42,0,-42
7989,1,1,543,1575,1032
7990,1,1,733,1231,498
7991,0,0,15,0,-15
7992,1,0,15,0,-15
7993,1,1,1172,2035,863
7994,1,0,206,0,-206
7995,1,1,575,1326,751
7996,1,0,3,0,-3
7997,1,1,192,1806,1614
7998,1,0,2,0,-2
7999,1,0,60,0,-60
8000,0,0,30,0,-30
8001,1,1,569,1376,807
8002,0,0,31,0,-31
8003,0,0,23,0,-23
8004,0,0,21,0,-21
8005,1,1,635,1265,630
8006,1,1,418,1359,941
8007,0,0,17,0,-17
8008,1,0,7,0,-7
8009,0,0,35,0,-35
8010,0,0,4,0,-4
8011,1,0,12,0,-12
8012,1,0,87,0,-87
8013,0,0,15,0,-15
8014,0,0,4,0,-4
8015,0,0,146,0,-146
8016,1,1,218,1240,1022
8017,1,1,297,1348,1051
8018,1,1,1380,1473,93
8019,1,0,31,0,-31
8020,1,1,819,1240,421
8021,0,0,18,0,-18
8022,0,0,87,0,-87
8023,1,0,11,0,-11
8024,0,0,78,0,-78
8025,1,0,0,0,0
8026,0,0,55,0,-55
8027,0,0,21,0,-21
8028,0,0,57,0,-57
8029,0,0,1,0,-1
8030,1,0,151,0,-151
8031,0,0,113,0,-113
8032,0,0,17,0,-17
8033,0,0,29,0,-29
8034,0,0,14,0,-14
8035,0,0,17,0,-17
8036,1,0,8,0,-8
8037,1,1,1801,1244,-557
8038,0,0,118,0,-118
8039,1,0,78,0,-78
8040,1,0,1,0,-1
8041,1,1,34,1340,1306
8042,0,0,49,0,-49
8043,1,1,332,1955,1623
8044,1,1,1386,1400,14
8045,0,0,24,0,-24
8046,0,0,213,0,-213
8047,1,0,2,0,-2
8048,0,0,166,0,-166
8049,1,1,469,1593,1124
8050,1,1,18,1514,1496
8051,0,0,1,0,-1
8052,0,0,61,0,-61
8053,0,0,89,0,-89
8054,1,1,530,2086,1556
8055,0,0,233,0,-233
8056,1,1,24,1554,1530
8057,1,0,66,0,-66
8058,1,1,240,1431,1191
8059,1,0,34,0,-34
8060,1,0,1,0,-1
8061,0,0,35,0,-35
8062,1,1,405,1327,922
8063,1,0,3,0,-3
8064,1,1,426,1316,890
8065,1,1,1112,1348,236
8066,0,0,138,0,-138
8067,0,0,53,0,-53
8068,1,0,20,0,-20
8069,1,1,135,1220,1085
8070,0,0,17,0,-17
8071,0,0,124,0,-124
8072,1,0,3,0,-3
8073,0,0,46,0,-46
8074,0,0,52,0,-52
8075,1,0,21,0,-21
8076,0,0,11,0,-11
8077,0,0,69,0,-69
8078,1,0,28,0,-28
8079,0,0,81,0,-81
8080,0,0,72,0,-72
8081,0,0,35,0,-35
8082,0,0,3,0,-3
8083,1,1,680,1706,1026
8084,0,0,95,0,-95
8085,0,0,28,0,-28
8086,1,0,99,0,-99
8087,1,1,706,1364,658
8088,1,1,489,1408,919
8089,1,0,17,0,-17
8090,1,0,32,0,-32
8091,1,0,4,0,-4
8092,0,0,4,0,-4
8093,1,0,11,0,-11
8094,0,0,56,0,-56
8095,1,1,205,1246,1041
8096,0,0,13,0,-13
8097,0,0,52,0,-52
8098,1,0,183,0,-183
8099,1,0,12,0,-12
8100,1,1,1425,1218,-207
8101,0,0,41,0,-41
8102,0,0,70,0,-70
8103,1,1,173,2515,2342
8104,0,0,121,0,-121
8105,1,1,359,1419,1060
8106,0,0,49,0,-49
8107,0,0,22,0,-22
8108,0,0,6,0,-6
8109,1,1,293,2085,1792
8110,1,0,82,0,-82
8111,1,0,46,0,-46
8112,1,0,44,0,-44
8113,1,0,46,0,-46
8114,1,1,1198,1418,220
8115,1,0,89,0,-89
8116,1,0,26,0,-26
8117,0,0,130,0,-130
8118,1,1,791,1347,556
8119,0,0,67,0,-67
8120,1,1,668,1309,641
8121,0,0,23,0,-23
8122,1,1,126,1355,1229
8123,1,0,56,0,-56
8124,1,1,1029,1291,262
8125,1,1,1314,1604,290
8126,1,1,1185,1380,195
8127,0,0,60,0,-60
8128,1,0,19,0,-19
8129,0,0,28,0,-28
8130,1,1,670,1232,562
8131,1,0,182,0,-182
8132,1,0,117,0,-117
8133,1,1,1591,1470,-121
8134,1,0,174,0,-174
8135,1,0,16,0,-16
8136,0,0,68,0,-68
8137,1,0,13,0,-13
8138,1,0,78,0,-78
8139,1,0,53,0,-53
8140,1,0,18,0,-18
8141,1,1,106,1426,1320
8142,1,0,45,0,-45
8143,1,1,390,1553,1163
8144,1,1,739,2020,1281
8145,1,0,32,0,-32
8146,1,1,402,1324,922
8147,0,0,136,0,-136
8148,0,0,0,0,0
8149,0,0,51,0,-51
8150,0,0,12,0,-12
8151,1,0,23,0,-23
8152,0,0,6,0,-6
8153,0,0,25,0,-25
8154,0,0,38,0,-38
8155,1,0,145,0,-145
8156,0,0,214,0,-214
8157,1,1,1001,1361,360
8158,1,0,45,0,-45
8159,1,1,280,2128,1848
8160,1,0,7,0,-7
8161,1,1,490,1714,1224
8162,1,1,147,2513,2366
8163,1,0,51,0,-51
8164,1,0,42,0,-42
8165,0,0,27,0,-27
8166,1,0,47,0,-47
8167,1,0,101,0,-101
8168,1,0,12,0,-12
8169,1,0,94,0,-94
8170,1,0,9,0,-9
8171,1,0,118,0,-118
8172,1,1,466,1203,737
8173,1,1,444,1259,815
8174,0,0,56,0,-56
8175,0,0,1,0,-1
8176,1,0,6,0,-6
8177,1,1,61,1353,1292
8178,1,1,186,1288,1102
8179,1,1,847,2236,1389
8180,1,0,2,0,-2
8181,1,0,10,0,-10
8182,1,0,71,0,-71
8183,0,0,31,0,-31
8184,1,1,87,1342,1255
8185,1,0,46,0,-46
8186,0,0,76,0,-76
8187,0,0,0,0,0
8188,1,1,717,1346,629
8189,0,0,216,0,-216
8190,0,0,18,0,-18
8191,0,0,8,0,-8
8192,1,1,1071,1482,411
8193,1,1,419,1342,923
8194,1,0,58,0,-58
8195,1,1,1868,1243,-625
8196,1,0,90,0,-90
8197,1,0,54,0,-54
8198,0,0,31,0,-31
8199,0,0,47,0,-47
8200,0,0,28,0,-28
8201,0,0,84,0,-84
8202,1,0,32,0,-32
8203,0,0,57,0,-57
8204,1,1,972,1323,351
8205,1,1,180,1435,1255
8206,1,0,10,0,-10
8207,1,0,29,0,-29
8208,1,0,21,0,-21
8209,1,0,34,0,-34
8210,1,1,554,2207,1653
8211,1,1,253,1298,1045
8212,0,0,210,0,-210
8213,1,1,701,1453,752
8214,1,1,13,1644,1631
8215,1,1,300,1249,949
8216,1,0,154,0,-154
8217,0,0,96,0,-96
8218,0,0,131,0,-131
8219,1,1,230,2997,2767
8220,0,0,59,0,-59
8221,0,0,26,0,-26
8222,1,1,432,1225,793
8223,1,0,116,0,-116
8224,0,0,41,0,-41
8225,1,0,74,0,-74
8226,1,1,328,1344,1016
8227,1,1,338,1385,1047
8228,1,1,622,1426,804
8229,0,0,59,0,-59
8230,0,0,7,0,-7
8231,1,1,510,1485,975
8232,0,0,64,0,-64
8233,0,0,33,0,-33
8234,1,0,73,0,-73
8235,1,0,2,0,-2
8236,1,0,0,0,0
8237,1,1,50,1481,1431
8238,1,0,70,0,-70
8239,1,1,227,1309,1082
8240,1,0,93,0,-93
8241,1,1,1263,2201,938
8242,0,0,7,0,-7
8243,0,0,24,0,-24
8244,0,0,86,0,-86
8245,0,0,1,0,-1
8246,1,1,68,1224,1156
8247,0,0,89,0,-89
8248,0,0,11,0,-11
8249,0,0,23,0,-23
8250,1,1,27,3690,3663
8251,0,0,29,0,-29
8252,0,0,1,0,-1
8253,1,1,1141,1313,172
8254,0,0,36,0,-36
8255,1,0,15,0,-15
8256,1,1,1096,1503,407
8257,1,0,38,0,-38
8258,1,1,371,1815,1444
8259,1,1,484,1569,1085
8260,0,0,45,0,-45
8261,1,1,287,1693,1406
8262,0,0,10,0,-10
8263,1,1,1561,1584,23
8264,1,0,5,0,-5
8265,1,1,103,1265,1162
8266,0,0,171,0,-171
8267,1,1,417,1221,804
8268,0,0,13,0,-13
8269,1,1,1498,3105,1607
8270,1,0,30,0,-30
8271,0,0,33,0,-33
8272,1,1,160,1462,1302
8273,1,0,56,0,-56
8274,0,0,33,0,-33
8275,1,1,697,2189,1492
8276,1,1,285,2909,2624
8277,1,0,16,0,-16
8278,1,1,474,1345,871
8279,1,0,6,0,-6
8280,1,0,1,0,-1
8281,1,1,433,1202,769
8282,1,1,801,1201,400
8283,1,0,56,0,-56
8284,1,1,198,1363,1165
8285,1,0,39,0,-39
8286,1,1,586,1743,1157
8287,1,0,87,0,-87
8288,0,0,0,0,0
8289,0,0,40,0,-40
8290,0,0,31,0,-31
8291,1,0,85,0,-85
8292,1,0,58,0,-58
8293,0,0,6,0,-6
8294,1,1,251,1270,1019
8295,1,0,44,0,-44
8296,1,1,498,1862,1364
8297,0,0,23,0,-23
8298,0,0,212,0,-212
8299,1,1,821,5727,4906
8300,0,0,36,0,-36
8301,0,0,0,0,0
8302,1,1,401,1621,1220
8303,0,0,59,0,-59
8304,1,0,43,0,-43
8305,1,0,13,0,-13
8306,0,0,42,0,-42
8307,0,0,35,0,-35
8308,1,1,1266,1235,-31
8309,1,1,428,1638,1210
8310,1,0,19,0,-19
8311,1,0,82,0,-82
8312,1,0,24,0,-24
8313,1,0,59,0,-59
8314,1,1,1174,1269,95
8315,1,0,36,0,-36
8316,1,0,29,0,-29
8317,0,0,78,0,-78
8318,1,0,3,0,-3
8319,0,0,81,0,-81
8320,1,0,27,0,-27
8321,1,1,245,1262,1017
8322,1,1,673,1261,588
8323,1,0,4,0,-4
8324,1,1,203,1407,1204
8325,1,0,4,0,-4
8326,1,1,423,1236,813
8327,1,1,1880,1337,-543
8328,1,1,508,2060,1552
8329,1,0,36,0,-36
8330,1,1,2085,1719,-366
8331,0,0,117,0,-117
8332,1,0,171,0,-171
8333,0,0,24,0,-24
8334,1,0,110,0,-110
8335,1,0,76,0,-76
8336,1,1,1461,1505,44
8337,1,0,29,0,-29
8338,0,0,14,0,-14
8339,0,0,67,0,-67
8340,1,1,78,1226,1148
8341,1,1,55,1387,1332
8342,0,0,1,0,-1
8343,1,0,159,0,-159
8344,1,0,38,0,-38
8345,1,1,1618,1535,-83
8346,0,0,36,0,-36
8347,0,0,58,0,-58
8348,1,1,79,1259,1180
8349,1,0,28,0,-28
8350,1,0,28,0,-28
8351,1,0,33,0,-33
8352,1,1,1135,1274,139
8353,1,1,1060,1397,337
8354,0,0,58,0,-58
8355,0,0,158,0,-158
8356,1,1,960,1356,396
8357,1,1,87,1288,1201
8358,1,1,247,1653,1406
8359,1,0,13,0,-13
8360,0,0,74,0,-74
8361,0,0,21,0,-21
8362,0,0,58,0,-58
8363,1,0,99,0,-99
8364,0,0,19,0,-19
8365,0,0,63,0,-63
8366,1,1,705,1200,495
8367,0,0,30,0,-30
8368,1,1,33,1351,1318
8369,1,1,1672,1787,115
8370,1,1,152,1337,1185
8371,0,0,53,0,-53
8372,1,0,88,0,-88
8373,1,0,11,0,-11
8374,1,1,327,2006,1679
8375,1,0,0,0,0
8376,0,0,69,0,-69
8377,1,0,143,0,-143
8378,1,1,196,2387,2191
8379,1,1,455,1581,1126
8380,1,1,1080,1274,194
8381,0,0,22,0,-22
8382,0,0,97,0,-97
8383,0,0,105,0,-105
8384,1,0,136,0,-136
8385,0,0,34,0,-34
8386,1,0,23,0,-23
8387,0,0,0,0,0
8388,1,0,1,0,-1
8389,1,0,7,0,-7
8390,1,1,217,1302,1085
8391,1,1,211,1491,1280
8392,0,0,162,0,-162
8393,0,0,5,0,-5
8394,1,0,6,0,-6
8395,1,1,413,1223,810
8396,1,0,67,0,-67
8397,1,1,111,1328,1217
8398,1,0,68,0,-68
8399,1,1,227,1740,1513
8400,1,0,168,0,-168
8401,0,0,48,0,-48
8402,1,1,784,1399,615
8403,1,1,103,1378,1275
8404,0,0,71,0,-71
8405,1,0,87,0,-87
8406,1,1,408,1396,988
8407,1,1,160,1705,1545
8408,1,0,9,0,-9
8409,1,0,15,0,-15
8410,1,1,367,2629,2262
8411,0,0,35,0,-35
8412,1,1,72,1924,1852
8413,0,0,35,0,-35
8414,1,0,8,0,-8
8415,0,0,72,0,-72
8416,1,0,66,0,-66
8417,1,1,652,1506,854
8418,0,0,102,0,-102
8419,0,0,23,0,-23
8420,1,0,236,0,-236
8421,1,0,22,0,-22
8422,0,0,35,0,-35
8423,1,1,420,1480,1060
8424,0,0,65,0,-65
8425,0,0,39,0,-39
8426,0,0,2,0,-2
8427,0,0,4,0,-4
8428,1,1,461,1506,1045
8429,1,0,63,0,-63
8430,1,0,7,0,-7
8431,0,0,39,0,-39
8432,1,0,5,0,-5
8433,1,0,12,0,-12
8434,0,0,18,0,-18
8435,1,1,583,1271,688
8436,1,1,499,1499,1000
8437,0,0,21,0,-21
8438,1,0,91,0,-91
8439,1,0,5,0,-5
8440,1,0,15,0,-15
8441,1,0,23,0,-23
8442,0,0,50,0,-50
8443,0,0,28,0,-28
8444,1,0,21,0,-21
8445,1,1,54,2286,2232
8446,0,0,8,0,-8
8447,1,1,1908,1344,-564
8448,1,0,21,0,-21
8449,1,1,541,1418,877
8450,1,1,142,1410,1268
8451,1,0,16,0,-16
8452,1,0,67,0,-67
8453,0,0,33,0,-33
8454,0,0,67,0,-67
8455,1,1,367,1801,1434
8456,0,0,89,0,-89
8457,1,0,46,0,-46
8458,0,0,5,0,-5
8459,0,0,26,0,-26
8460,0,0,2,0,-2
8461,0,0,3,0,-3
8462,0,0,4,0,-4
8463,0,0,16,0,-16
8464,1,1,1356,1538,182
8465,1,1,1294,2346,1052
8466,1,1,573,1203,630
8467,1,1,348,1228,880
8468,0,0,57,0,-57
8469,0,0,54,0,-54
8470,1,0,11,0,-11
8471,0,0,8,0,-8
8472,1,1,132,1317,1185
8473,1,0,41,0,-41
8474,0,0,68,0,-68
8475,1,1,111,2417,2306
8476,1,0,52,0,-52
8477,0,0,19,0,-19
8478,1,0,24,0,-24
8479,0,0,0,0,0
8480,1,0,108,0,-108
8481,0,0,6,0,-6
8482,1,1,465,1287,822
8483,1,1,1178,1231,53
8484,0,0,18,0,-18
8485,1,1,30,1971,1941
8486,0,0,19,0,-19
8487,1,0,0,0,0
8488,1,0,55,0,-55
8489,1,0,21,0,-21
8490,0,0,30,0,-30
8491,0,0,83,0,-83
8492,1,1,1212,1218,6
8493,0,0,6,0,-6
8494,1,1,314,1299,985
8495,0,0,33,0,-33
8496,1,1,829,1371,542
8497,1,0,121,0,-121
8498,1,1,694,1430,736
8499,0,0,53,0,-53
8500,0,0,74,0,-74
8501,0,0,25,0,-25
8502,0,0,32,0,-32
8503,1,1,79,1974,1895
8504,1,1,246,1210,964
8505,1,1,138,1204,1066
8506,0,0,7,0,-7
8507,0,0,153,0,-153
8508,0,0,21,0,-21
8509,1,0,73,0,-73
8510,1,0,54,0,-54
8511,0,0,40,0,-40
8512,0,0,3,0,-3
8513,0,0,107,0,-107
8514,1,0,57,0,-57
8515,1,0,77,0,-77
8516,0,0,12,0,-12
8517,1,0,74,0,-74
8518,1,0,202,0,-202
8519,1,0,75,0,-75
8520,0,0,7,0,-7
8521,1,1,578,1275,697
8522,1,0,130,0,-130
8523,1,0,54,0,-54
8524,1,1,230,1712,1482
8525,1,1,468,1255,787
8526,1,0,26,0,-26
8527,1,1,116,1363,1247
8528,1,0,1,0,-1
8529,1,1,735,1724,989
8530,0,0,9,0,-9
8531,0,0,6,0,-6
8532,1,0,79,0,-79
8533,1,1,231,1874,1643
8534,1,0,62,0,-62
8535,1,0,76,0,-76
8536,1,1,361,1255,894
8537,0,0,64,0,-64
8538,0,0,1,0,-1
8539,0,0,56,0,-56
8540,1,0,9,0,-9
8541,1,1,324,1273,949
8542,1,0,99,0,-99
8543,0,0,3,0,-3
8544,0,0,18,0,-18
8545,0,0,53,0,-53
8546,1,0,16,0,-16
8547,1,1,1845,1295,-550
8548,1,0,47,0,-47
8549,0,0,70,0,-70
8550,0,0,19,0,-19
8551,0,0,23,0,-23
8552,0,0,20,0,-20
8553,0,0,160,0,-160
8554,1,1,175,1251,1076
8555,1,0,34,0,-34
8556,0,0,7,0,-7
8557,1,0,41,0,-41
8558,1,0,45,0,-45
8559,1,0,0,0,0
8560,0,0,0,0,0
8561,1,0,42,0,-42
8562,1,0,82,0,-82
8563,1,1,46,1591,1545
8564,1,0,147,0,-147
8565,0,0,26,0,-26
8566,1,1,165,1341,1176
8567,1,1,276,1788,1512
8568,1,1,1211,1299,88
8569,1,1,1873,1228,-645
8570,1,1,344,1212,868
8571,0,0,1,0,-1
8572,1,1,409,1406,997
8573,1,0,39,0,-39
8574,1,0,7,0,-7
8575,0,0,71,0,-71
8576,1,0,238,0,-238
8577,0,0,31,0,-31
8578,1,0,41,0,-41
8579,1,1,354,1549,1195
8580,0,0,26,0,-26
8581,1,0,35,0,-35
8582,0,0,11,0,-11
8583,1,0,115,0,-115
8584,1,1,521,1438,917
8585,1,0,330,0,-330
8586,0,0,142,0,-142
8587,1,0,2,0,-2
8588,1,1,694,1267,573
8589,0,0,25,0,-25
8590,1,1,100,1477,1377
8591,1,0,38,0,-38
8592,1,1,652,1905,1253
8593,1,1,199,1324,1125
8594,1,1,15,1239,1224
8595,1,1,52,1558,1506
8596,1,1,86,1393,1307
8597,1,0,13,0,-13
8598,1,0,6,0,-6
8599,0,0,1,0,-1
8600,1,1,69,1376,1307
8601,1,0,116,0,-116
8602,1,0,173,0,-173
8603,0,0,150,0,-150
8604,0,0,37,0,-37
8605,0,0,104,0,-104
8606,1,0,86,0,-86
8607,0,0,18,0,-18
8608,0,0,58,0,-58
8609,1,1,238,1628,1390
8610,1,0,154,0,-154
8611,0,0,63,0,-63
8612,0,0,6,0,-6
8613,1,1,467,1529,1062
8614,1,1,181,1229,1048
8615,0,0,104,0,-104
8616,0,0,21,0,-21
8617,0,0,35,0,-35
8618,1,0,53,0,-53
8619,0,0,18,0,-18
8620,0,0,24,0,-24
8621,1,0,31,0,-31
8622,1,1,552,1452,900
8623,0,0,3,0,-3
8624,1,0,62,0,-62
8625,1,1,622,1467,845
8626,1,0,22,0,-22
8627,0,0,60,0,-60
8628,0,0,18,0,-18
8629,1,0,33,0,-33
8630,1,0,10,0,-10
8631,1,0,10,0,-10
8632,1,1,2120,1554,-566
8633,0,0,17,0,-17
8634,1,1,595,1331,736
8635,0,0,255,0,-255
8636,1,0,55,0,-55
8637,1,0,32,0,-32
8638,1,1,119,1208,1089
8639,1,0,20,0,-20
8640,1,1,143,1415,1272
8641,0,0,95,0,-95
8642,1,1,701,1343,642
8643,1,1,911,1414,503
8644,1,1,241,1333,1092
8645,0,0,42,0,-42
8646,1,0,273,0,-273
8647,1,0,11,0,-11
8648,1,0,41,0,-41
8649,1,0,33,0,-33
8650,1,0,9,0,-9
8651,0,0,4,0,-4
8652,1,1,250,1579,1329
8653,1,0,110,0,-110
8654,0,0,40,0,-40
8655,0,0,39,0,-39
8656,1,1,1257,1901,644
8657,1,1,83,1965,1882
8658,0,0,51,0,-51
8659,0,0,36,0,-36
8660,0,0,33,0,-33
8661,0,0,8,0,-8
8662,1,1,481,1492,1011
8663,1,1,727,1553,826
8664,1,0,5,0,-5
8665,1,0,27,0,-27
8666,1,0,18,0,-18
8667,1,0,54,0,-54
8668,0,0,31,0,-31
8669,1,1,607,1332,725
8670,0,0,39,0,-39
8671,1,1,168,1216,1048
8672,0,0,45,0,-45
8673,0,0,35,0,-35
8674,1,1,250,1244,994
8675,0,0,47,0,-47
8676,0,0,13,0,-13
8677,1,1,255,2547,2292
8678,0,0,15,0,-15
8679,0,0,25,0,-25
8680,1,0,64,0,-64
8681,1,1,1037,2905,1868
8682,0,0,4,0,-4
8683,1,1,982,1811,829
8684,0,0,45,0,-45
8685,0,0,53,0,-53
8686,0,0,7,0,-7
8687,1,1,89,1634,1545
8688,0,0,27,0,-27
8689,1,0,16,0,-16
8690,1,0,99,0,-99
8691,1,1,1685,1204,-481
8692,0,0,30,0,-30
8693,1,0,6,0,-6
8694,1,0,58,0,-58
8695,1,1,40,1233,1193
8696,1,0,0,0,0
8697,0,0,33,0,-33
8698,0,0,4,0,-4
8699,0,0,164,0,-164
8700,1,0,28,0,-28
8701,1,0,21,0,-21
8702,1,1,905,1581,676
8703,0,0,18,0,-18
8704,1,0,24,0,-24
8705,1,1,204,1242,1038
8706,0,0,46,0,-46
8707,0,0,45,0,-45
8708,0,0,20,0,-20
8709,1,0,6,0,-6
8710,1,1,1154,1446,292
8711,1,0,12,0,-12
8712,0,0,19,0,-19
8713,1,1,64,1257,1193
8714,1,1,40,1364,1324
8715,1,1,1356,1750,394
8716,1,0,54,0,-54
8717,0,0,67,0,-67
8718,1,0,13,0,-13
8719,0,0,29,0,-29
8720,1,1,344,1740,1396
8721,1,1,17,1429,1412
8722,0,0,22,0,-22
8723,1,0,20,0,-20
8724,1,1,373,1460,1087
8725,0,0,16,0,-16
8726,0,0,4,0,-4
8727,1,0,39,0,-39
8728,0,0,26,0,-26
8729,0,0,9,0,-9
8730,1,1,593,1669,1076
8731,1,1,1060,1408,348
8732,0,0,69,0,-69
8733,0,0,30,0,-30
8734,0,0,325,0,-325
8735,1,1,77,1227,1150
8736,1,1,530,1936,1406
8737,1,0,193,0,-193
8738,1,0,4,0,-4
8739,1,0,122,0,-122
8740,1,0,27,0,-27
8741,1,1,333,1460,1127
8742,0,0,81,0,-81
8743,1,1,568,2855,2287
8744,0,0,55,0,-55
8745,1,0,35,0,-35
8746,1,0,3,0,-3
8747,1,0,87,0,-87
8748,1,0,21,0,-21
8749,1,0,14,0,-14
8750,1,1,161,1947,1786
8751,0,0,84,0,-84
8752,1,1,120,1465,1345
8753,0,0,50,0,-50
8754,1,1,806,1532,726
8755,0,0,75,0,-75
8756,0,0,41,0,-41
8757,0,0,54,0,-54
8758,1,1,554,1610,1056
8759,0,0,57,0,-57
8760,1,1,718,1237,519
8761,1,0,32,0,-32
8762,0,0,10,0,-10
8763,1,1,239,1973,1734
8764,1,0,27,0,-27
8765,1,0,21,0,-21
8766,1,0,73,0,-73
8767,0,0,33,0,-33
8768,0,0,75,0,-75
8769,0,0,0,0,0
8770,0,0,24,0,-24
8771,1,1,99,3647,3548
8772,1,0,29,0,-29
8773,0,0,61,0,-61
8774,1,0,67,0,-67
8775,1,1,2073,1208,-865
8776,1,0,35,0,-35
8777,1,1,250,1312,1062
8778,1,0,36,0,-36
8779,1,0,64,0,-64
8780,1,1,86,1470,1384
8781,1,1,955,1452,497
8782,1,0,7,0,-7
8783,1,1,211,1438,1227
8784,0,0,74,0,-74
8785,1,0,10,0,-10
8786,0,0,15,0,-15
8787,1,1,219,1317,1098
8788,1,0,34,0,-34
8789,1,1,487,1312,825
8790,0,0,223,0,-223
8791,1,1,561,1276,715
8792,1,1,915,2069,1154
8793,1,0,159,0,-159
8794,1,1,386,1564,1178
8795,0,0,1,0,-1
8796,1,1,159,1569,1410
8797,1,1,308,1618,1310
8798,1,0,19,0,-19
8799,0,0,26,0,-26
8800,0,0,9,0,-9
8801,0,0,74,0,-74
8802,0,0,8,0,-8
8803,1,0,74,0,-74
8804,1,1,1651,1257,-394
8805,1,1,96,1334,1238
8806,0,0,20,0,-20
8807,0,0,4,0,-4
8808,0,0,8,0,-8
8809,1,1,586,1292,706
8810,1,1,581,1554,973
8811,0,0,10,0,-10
8812,1,1,601,1784,1183
8813,1,0,9,0,-9
8814,1,1,463,1266,803
8815,0,0,140,0,-140
8816,1,1,1107,1352,245
8817,0,0,170,0,-170
8818,0,0,151,0,-151
8819,0,0,35,0,-35
8820,0,0,32,0,-32
8821,0,0,67,0,-67
8822,1,0,63,0,-63
8823,1,0,24,0,-24
8824,0,0,35,0,-35
8825,1,1,392,2026,1634
8826,1,0,105,0,-105
8827,0,0,203,0,-203
8828,0,0,57,0,-57
8829,0,0,27,0,-27
8830,0,0,6,0,-6
8831,1,0,31,0,-31
8832,0,0,23,0,-23
8833,1,0,5,0,-5
8834,1,0,12,0,-12
8835,0,0,17,0,-17
8836,0,0,16,0,-16
8837,1,1,167,1684,1517
8838,0,0,58,0,-58
8839,1,1,103,1368,1265
8840,0,0,34,0,-34
8841,0,0,5,0,-5
8842,0,0,2,0,-2
8843,0,0,10,0,-10
8844,0,0,143,0,-143
8845,1,0,43,0,-43
8846,1,0,41,0,-41
8847,1,0,31,0,-31
8848,0,0,2,0,-2
8849,0,0,31,0,-31
8850,1,1,184,1673,1489
8851,1,1,811,1332,521
8852,0,0,51,0,-51
8853,1,0,8,0,-8
8854,1,1,528,1367,839
8855,0,0,21,0,-21
8856,1,0,4,0,-4
8857,1,1,52,1586,1534
8858,0,0,6,0,-6
8859,1,0,19,0,-19
8860,1,0,4,0,-4
8861,1,1,428,1343,915
8862,1,0,57,0,-57
8863,1,1,159,1381,1222
8864,1,0,35,0,-35
8865,1,1,374,1674,1300
8866,1,1,151,1642,1491
8867,1,1,56,1297,1241
8868,0,0,32,0,-32
8869,1,0,110,0,-110
8870,1,0,10,0,-10
8871,1,0,150,0,-150
8872,1,0,47,0,-47
8873,1,1,211,1440,1229
8874,0,0,8,0,-8
8875,0,0,154,0,-154
8876,0,0,11,0,-11
8877,1,0,120,0,-120
8878,0,0,155,0,-155
8879,1,0,41,0,-41
8880,1,0,10,0,-10
8881,1,1,344,1345,1001
8882,1,0,3,0,-3
8883,1,0,106,0,-106
8884,1,1,1396,1382,-14
8885,1,0,79,0,-79
8886,0,0,63,0,-63
8887,0,0,17,0,-17
8888,1,0,22,0,-22
8889,1,0,56,0,-56
8890,0,0,12,0,-12
8891,1,1,2100,1457,-643
8892,0,0,58,0,-58
8893,0,0,31,0,-31
8894,0,0,9,0,-9
8895,1,0,14,0,-14
8896,1,0,32,0,-32
8897,1,1,256,1366,1110
8898,0,0,93,0,-93
8899,1,1,971,1302,331
8900,1,0,41,0,-41
8901,1,1,1043,1350,307
8902,1,0,11,0,-11
8903,0,0,23,0,-23
8904,1,0,27,0,-27
8905,1,0,43,0,-43
8906,1,0,42,0,-42
8907,1,1,1031,1391,360
8908,0,0,91,0,-91
8909,0,0,89,0,-89
8910,1,1,177,1294,1117
8911,1,0,41,0,-41
8912,1,1,1384,1230,-154
8913,0,0,169,0,-169
8914,0,0,7,0,-7
8915,0,0,133,0,-133
8916,1,0,11,0,-11
8917,1,1,776,1277,501
8918,0,0,131,0,-131
8919,0,0,4,0,-4
8920,0,0,21,0,-21
8921,0,0,42,0,-42
8922,0,0,16,0,-16
8923,1,1,923,1411,488
8924,0,0,24,0,-24
8925,0,0,16,0,-16
8926,1,0,25,0,-25
8927,1,1,45,1588,1543
8928,0,0,64,0,-64
8929,1,1,219,1507,1288
8930,0,0,25,0,-25
8931,1,0,33,0,-33
8932,1,1,628,1281,653
8933,1,0,30,0,-30
8934,0,0,10,0,-10
8935,1,0,33,0,-33
8936,1,0,36,0,-36
8937,0,0,26,0,-26
8938,1,1,437,1240,803
8939,1,1,205,1723,1518
8940,0,0,21,0,-21
8941,1,0,7,0,-7
8942,1,0,67,0,-67
8943,1,0,54,0,-54
8944,0,0,68,0,-68
8945,0,0,40,0,-40
8946,0,0,13,0,-13
8947,1,1,575,1528,953
8948,1,1,1329,1643,314
8949,0,0,82,0,-82
8950,1,1,105,1464,1359
8951,1,0,11,0,-11
8952,1,1,379,2222,1843
8953,1,0,10,0,-10
8954,1,0,44,0,-44
8955,1,1,561,1268,707
8956,1,1,260,1937,1677
8957,0,0,117,0,-117
8958,1,0,31,0,-31
8959,1,0,40,0,-40
8960,0,0,87,0,-87
8961,1,1,213,2067,1854
8962,0,0,24,0,-24
8963,1,0,207,0,-207
8964,1,0,30,0,-30
8965,1,1,197,1268,1071
8966,1,0,6,0,-6
8967,0,0,17,0,-17
8968,1,1,360,1494,1134
8969,1,1,820,1649,829
8970,1,0,57,0,-57
8971,1,1,61,1324,1263
8972,0,0,29,0,-29
8973,0,0,52,0,-52
8974,1,1,860,3941,3081
8975,1,0,174,0,-174
8976,1,1,470,1427,957
8977,0,0,7,0,-7
8978,1,1,164,1551,1387
8979,0,0,133,0,-133
8980,1,0,66,0,-66
8981,1,1,1290,1344,54
8982,1,1,568,1835,1267
8983,1,1,96,1405,1309
8984,0,0,424,0,-424
8985,1,1,255,5013,4758
8986,0,0,21,0,-21
8987,0,0,12,0,-12
8988,0,0,78,0,-78
8989,0,0,25,0,-25
8990,0,0,121,0,-121
8991,1,0,160,0,-160
8992,0,0,8,0,-8
8993,0,0,178,0,-178
8994,0,0,43,0,-43
8995,1,1,272,1212,940
8996,1,0,18,0,-18
8997,0,0,48,0,-48
8998,1,0,194,0,-194
8999,0,0,196,0,-196
9000,1,1,346,1291,945
9001,1,0,17,0,-17
9002,0,0,40,0,-40
9003,1,0,16,0,-16
9004,1,0,0,0,0
9005,0,0,35,0,-35
9006,0,0,11,0,-11
9007,1,0,5,0,-5
9008,0,0,0,0,0
9009,1,1,599,1795,1196
9010,1,1,425,1260,835
9011,0,0,84,0,-84
9012,0,0,96,0,-96
9013,1,1,1011,1787,776
9014,0,0,46,0,-46
9015,0,0,19,0,-19
9016,0,0,89,0,-89
9017,0,0,48,0,-48
9018,1,0,5,0,-5
9019,1,0,122,0,-122
9020,1,0,1,0,-1
9021,1,0,25,0,-25
9022,0,0,30,0,-30
9023,0,0,101,0,-101
9024,0,0,37,0,-37
9025,0,0,53,0,-53
9026,0,0,47,0,-47
9027,1,0,33,0,-33
9028,0,0,2,0,-2
9029,0,0,1,0,-1
9030,1,1,216,1559,1343
9031,1,1,55,1379,1324
9032,0,0,85,0,-85
9033,1,0,18,0,-18
9034,0,0,12,0,-12
9035,0,0,73,0,-73
9036,0,0,48,0,-48
9037,1,1,1222,1253,31
9038,1,0,2,0,-2
9039,0,0,32,0,-32
9040,1,0,1,0,-1
9041,0,0,33,0,-33
9042,0,0,35,0,-35
9043,1,1,526,1960,1434
9044,1,1,459,1454,995
9045,1,0,69,0,-69
9046,0,0,30,0,-30
9047,1,1,689,2738,2049
9048,1,1,746,1659,913
9049,0,0,19,0,-19
9050,1,1,898,1569,671
9051,0,0,28,0,-28
9052,0,0,96,0,-96
9053,0,0,101,0,-101
9054,0,0,15,0,-15
9055,1,0,251,0,-251
9056,1,0,89,0,-89
9057,1,0,28,0,-28
9058,0,0,22,0,-22
9059,0,0,76,0,-76
9060,0,0,12,0,-12
9061,1,0,105,0,-105
9062,1,0,11,0,-11
9063,0,0,66,0,-66
9064,1,0,52,0,-52
9065,1,1,255,1553,1298
9066,0,0,35,0,-35
9067,1,1,1063,1341,278
9068,1,0,26,0,-26
9069,0,0,10,0,-10
9070,0,0,6,0,-6
9071,1,0,24,0,-24
9072,1,0,28,0,-28
9073,0,0,52,0,-52
9074,0,0,56,0,-56
9075,1,1,313,1288,975
9076,0,0,107,0,-107
9077,1,0,24,0,-24
9078,1,0,30,0,-30
9079,0,0,133,0,-133
9080,0,0,62,0,-62
9081,0,0,80,0,-80
9082,1,1,267,1477,1210
9083,1,1,339,1371,1032
9084,0,0,8,0,-8
9085,0,0,31,0,-31
9086,1,1,119,1665,1546
9087,1,1,298,1586,1288
9088,0,0,179,0,-179
9089,1,1,108,1691,1583
9090,1,0,50,0,-50
9091,0,0,13,0,-13
9092,0,0,0,0,0
9093,1,0,14,0,-14
9094,0,0,79,0,-79
9095,0,0,142,0,-142
9096,1,1,102,2680,2578
9097,0,0,136,0,-136
9098,1,0,1,0,-1
9099,1,0,63,0,-63
9100,0,0,38,0,-38
9101,0,0,40,0,-40
9102,1,1,1236,1447,211
9103,1,0,41,0,-41
9104,1,1,339,1398,1059
9105,0,0,4,0,-4
9106,1,0,33,0,-33
9107,0,0,30,0,-30
9108,0,0,19,0,-19
9109,1,1,124,1382,1258
9110,1,1,123,1268,1145
9111,1,0,15,0,-15
9112,1,0,18,0,-18
9113,0,0,5,0,-5
9114,0,0,13,0,-13
9115,1,0,213,0,-213
9116,1,1,370,1430,1060
9117,0,0,77,0,-77
9118,1,0,12,0,-12
9119,1,0,90,0,-90
9120,1,0,31,0,-31
9121,1,1,539,1508,969
9122,0,0,106,0,-106
9123,1,0,9,0,-9
9124,1,0,81,0,-81
9125,1,1,1530,1344,-186
9126,0,0,22,0,-22
9127,1,1,75,1206,1131
9128,1,0,138,0,-138
9129,0,0,31,0,-31
9130,0,0,39,0,-39
9131,0,0,14,0,-14
9132,0,0,36,0,-36
9133,0,0,11,0,-11
9134,1,0,21,0,-21
9135,1,1,50,1353,1303
9136,1,1,249,1224,975
9137,1,0,23,0,-23
9138,0,0,0,0,0
9139,0,0,97,0,-97
9140,0,0,24,0,-24
9141,0,0,2,0,-2
9142,0,0,71,0,-71
9143,0,0,89,0,-89
9144,0,0,2,0,-2
9145,1,0,0,0,0
9146,1,0,17,0,-17
9147,0,0,3,0,-3
9148,1,0,197,0,-197
9149,1,0,7,0,-7
9150,1,0,1,0,-1
9151,0,0,25,0,-25
9152,0,0,36,0,-36
9153,1,0,102,0,-102
9154,1,0,358,0,-358
9155,0,0,35,0,-35
9156,1,1,245,1755,1510
9157,1,0,40,0,-40
9158,1,0,44,0,-44
9159,0,0,133,0,-133
9160,1,1,401,1539,1138
9161,1,1,684,1323,639
9162,0,0,24,0,-24
9163,1,0,62,0,-62
9164,1,1,348,1348,1000
9165,1,0,80,0,-80
9166,1,1,2403,1273,-1130
9167,1,0,16,0,-16
9168,0,0,29,0,-29
9169,0,0,18,0,-18
9170,0,0,62,0,-62
9171,1,0,10,0,-10
9172,1,1,300,1603,1303
9173,1,0,7,0,-7
9174,0,0,8,0,-8
9175,0,0,55,0,-55
9176,0,0,29,0,-29
9177,1,0,26,0,-26
9178,1,1,147,1389,1242
9179,0,0,9,0,-9
9180,1,1,435,1298,863
9181,1,0,41,0,-41
9182,1,0,9,0,-9
9183,1,1,927,2561,1634
9184,0,0,38,0,-38
9185,1,1,1938,1308,-630
9186,0,0,42,0,-42
9187,1,1,360,1432,1072
9188,0,0,41,0,-41
9189,0,0,31,0,-31
9190,1,1,781,1262,481
9191,1,1,52,1565,1513
9192,1,0,45,0,-45
9193,0,0,109,0,-109
9194,0,0,59,0,-59
9195,1,1,1245,1255,10
9196,1,1,154,1322,1168
9197,0,0,8,0,-8
9198,1,0,50,0,-50
9199,1,1,317,1896,1579
9200,0,0,45,0,-45
9201,1,1,64,1262,1198
9202,0,0,135,0,-135
9203,0,0,25,0,-25
9204,0,0,9,0,-9
9205,0,0,41,0,-41
9206,0,0,81,0,-81
9207,0,0,11,0,-11
9208,1,0,18,0,-18
9209,0,0,90,0,-90
9210,1,1,698,2157,1459
9211,1,0,107,0,-107
9212,1,0,73,0,-73
9213,0,0,16,0,-16
9214,0,0,28,0,-28
9215,1,1,120,2347,2227
9216,0,0,19,0,-19
9217,1,0,37,0,-37
9218,1,1,562,1313,751
9219,0,0,1,0,-1
9220,1,1,103,1587,1484
9221,1,0,244,0,-244
9222,1,1,516,1778,1262
9223,0,0,31,0,-31
9224,1,0,9,0,-9
9225,0,0,3,0,-3
9226,1,1,91,1358,1267
9227,0,0,30,0,-30
9228,0,0,7,0,-7
9229,1,0,15,0,-15
9230,1,1,598,1851,1253
9231,1,1,109,1200,1091
9232,1,1,274,1227,953
9233,0,0,81,0,-81
9234,1,0,126,0,-126
9235,0,0,88,0,-88
9236,1,0,6,0,-6
9237,1,1,979,1316,337
9238,0,0,32,0,-32
9239,1,1,995,1391,396
9240,1,1,198,2162,1964
9241,1,0,160,0,-160
9242,1,0,37,0,-37
9243,1,1,433,1448,1015
9244,1,1,232,1428,1196
9245,1,0,76,0,-76
9246,1,0,26,0,-26
9247,0,0,2,0,-2
9248,1,0,7,0,-7
9249,1,0,48,0,-48
9250,1,1,625,1875,1250
9251,0,0,18,0,-18
9252,0,0,44,0,-44
9253,1,1,463,1224,761
9254,1,1,1085,1880,795
9255,1,0,26,0,-26
9256,1,0,78,0,-78
9257,0,0,0,0,0
9258,1,1,404,1271,867
9259,0,0,48,0,-48
9260,1,1,511,2032,1521
9261,1,0,5,0,-5
9262,1,1,2839,1549,-1290
9263,0,0,2,0,-2
9264,1,0,25,0,-25
9265,0,0,63,0,-63
9266,1,0,27,0,-27
9267,1,0,0,0,0
9268,1,0,60,0,-60
9269,0,0,0,0,0
9270,0,0,43,0,-43
9271,0,0,71,0,-71
9272,1,1,399,1394,995
9273,1,1,1594,1310,-284
9274,1,1,629,1874,1245
9275,1,1,234,1758,1524
9276,1,1,289,1272,983
9277,1,1,359,1236,877
9278,1,0,104,0,-104
9279,0,0,108,0,-108
9280,1,0,2,0,-2
9281,0,0,49,0,-49
9282,1,1,438,1270,832
9283,1,0,65,0,-65
9284,1,1,379,1419,1040
9285,0,0,9,0,-9
9286,1,0,19,0,-19
9287,1,1,401,1610,1209
9288,1,0,102,0,-102
9289,1,0,4,0,-4
9290,1,1,320,1504,1184
9291,0,0,6,0,-6
9292,0,0,19,0,-19
9293,0,0,88,0,-88
9294,1,0,38,0,-38
9295,1,1,54,2047,1993
9296,0,0,154,0,-154
9297,1,0,38,0,-38
9298,1,1,1233,1337,104
9299,1,1,559,1426,867
9300,0,0,1,0,-1
9301,0,0,2,0,-2
9302,0,0,34,0,-34
9303,1,0,21,0,-21
9304,1,0,75,0,-75
9305,0,0,66,0,-66
9306,1,0,27,0,-27
9307,1,0,41,0,-41
9308,0,0,48,0,-48
9309,1,1,144,1470,1326
9310,1,1,100,1431,1331
9311,0,0,26,0,-26
9312,1,0,51,0,-51
9313,1,1,44,1461,1417
9314,1,0,45,0,-45
9315,0,0,72,0,-72
9316,1,0,178,0,-178
9317,0,0,21,0,-21
9318,1,1,142,1224,1082
9319,0,0,100,0,-100
9320,1,0,81,0,-81
9321,0,0,38,0,-38
9322,1,1,410,1796,1386
9323,1,0,72,0,-72
9324,1,0,66,0,-66
9325,0,0,52,0,-52
9326,0,0,81,0,-81
9327,1,1,146,1594,1448
9328,1,0,98,0,-98
9329,0,0,38,0,-38
9330,1,1,540,1299,759
9331,0,0,92,0,-92
9332,0,0,15,0,-15
9333,1,1,283,2065,1782
9334,0,0,160,0,-160
9335,1,0,125,0,-125
9336,0,0,21,0,-21
9337,1,1,915,1325,410
9338,1,1,977,1304,327
9339,1,1,545,1275,730
9340,1,0,34,0,-34
9341,0,0,8,0,-8
9342,0,0,184,0,-184
9343,0,0,63,0,-63
9344,0,0,10,0,-10
9345,0,0,308,0,-308
9346,1,0,22,0,-22
9347,1,0,112,0,-112
9348,0,0,28,0,-28
9349,1,0,15,0,-15
9350,1,0,11,0,-11
9351,0,0,15,0,-15
9352,1,1,1403,1225,-178
9353,1,1,44,1604,1560
9354,1,0,25,0,-25
9355,1,1,287,1359,1072
9356,1,1,997,2409,1412
9357,1,1,806,1874,1068
9358,1,0,74,0,-74
9359,0,0,20,0,-20
9360,0,0,45,0,-45
9361,1,0,27,0,-27
9362,1,0,41,0,-41
9363,1,1,1683,1420,-263
9364,1,0,74,0,-74
9365,1,1,320,1532,1212
9366,0,0,4,0,-4
9367,0,0,29,0,-29
9368,0,0,29,0,-29
9369,1,0,54,0,-54
9370,1,0,142,0,-142
9371,0,0,24,0,-24
9372,1,0,64,0,-64
9373,1,0,10,0,-10
9374,1,1,1167,1449,282
9375,0,0,39,0,-39
9376,1,1,1433,1938,505
9377,1,1,1183,1624,441
9378,1,1,1975,1411,-564
9379,0,0,25,0,-25
9380,1,0,67,0,-67
9381,1,1,308,1203,895
9382,1,1,1749,1227,-522
9383,1,1,140,1869,1729
9384,0,0,0,0,0
9385,1,1,302,1985,1683
9386,1,0,62,0,-62
9387,1,1,248,1612,1364
9388,1,1,214,1254,1040
9389,1,1,225,2423,2198
9390,1,1,771,1594,823
9391,0,0,26,0,-26
9392,1,0,9,0,-9
9393,1,0,92,0,-92
9394,1,0,63,0,-63
9395,1,1,586,2370,1784
9396,0,0,11,0,-11
9397,0,0,23,0,-23
9398,0,0,32,0,-32
9399,0,0,35,0,-35
9400,1,1,480,1325,845
9401,1,0,11,0,-11
9402,1,1,556,1592,1036
9403,1,0,81,0,-81
9404,1,1,469,1245,776
9405,1,0,23,0,-23
9406,1,1,813,1477,664
9407,1,1,1335,1313,-22
9408,0,0,33,0,-33
9409,1,1,115,1231,1116
9410,1,1,643,1282,639
9411,0,0,40,0,-40
9412,0,0,32,0,-32
9413,1,1,56,1258,1202
9414,0,0,33,0,-33
9415,0,0,11,0,-11
9416,1,1,212,1667,1455
9417,1,1,902,1414,512
9418,0,0,96,0,-96
9419,1,1,875,1341,466
9420,1,1,807,1396,589
9421,1,0,140,0,-140
9422,0,0,23,0,-23
9423,0,0,10,0,-10
9424,1,1,123,1677,1554
9425,1,1,345,1645,1300
9426,1,0,22,0,-22
9427,1,0,101,0,-101
9428,0,0,46,0,-46
9429,0,0,29,0,-29
9430,1,1,254,1246,992
9431,1,1,132,1467,1335
9432,1,0,3,0,-3
9433,0,0,50,0,-50
9434,1,0,114,0,-114
9435,1,0,8,0,-8
9436,1,1,150,1206,1056
9437,1,1,269,1498,1229
9438,1,0,69,0,-69
9439,1,0,37,0,-37
9440,0,0,56,0,-56
9441,1,1,728,1374,646
9442,1,0,1,0,-1
9443,1,0,54,0,-54
9444,0,0,70,0,-70
9445,0,0,25,0,-25
9446,1,0,117,0,-117
9447,0,0,19,0,-19
9448,1,1,509,1355,846
9449,0,0,285,0,-285
9450,1,1,1887,2250,363
9451,1,1,248,1247,999
9452,1,1,685,1536,851
9453,0,0,21,0,-21
9454,1,1,398,1201,803
9455,1,0,71,0,-71
9456,0,0,7,0,-7
9457,1,0,43,0,-43
9458,1,1,1278,2152,874
9459,1,0,169,0,-169
9460,0,0,26,0,-26
9461,1,1,165,1390,1225
9462,1,1,574,1682,1108
9463,0,0,50,0,-50
9464,0,0,131,0,-131
9465,0,0,2,0,-2
9466,1,1,735,1387,652
9467,0,0,10,0,-10
9468,1,1,398,1793,1395
9469,0,0,91,0,-91
9470,1,1,423,1372,949
9471,0,0,40,0,-40
9472,1,1,305,1508,1203
9473,1,0,67,0,-67
9474,0,0,128,0,-128
9475,1,0,75,0,-75
9476,1,1,74,1202,1128
9477,0,0,0,0,0
9478,1,1,648,1254,606
9479,1,0,17,0,-17
9480,1,0,22,0,-22
9481,0,0,8,0,-8
9482,1,0,11,0,-11
9483,1,0,158,0,-158
9484,0,0,167,0,-167
9485,1,1,674,1246,572
9486,1,0,61,0,-61
9487,0,0,100,0,-100
9488,1,0,35,0,-35
9489,0,0,76,0,-76
9490,0,0,60,0,-60
9491,1,1,138,3343,3205
9492,0,0,52,0,-52
9493,1,0,56,0,-56
9494,0,0,33,0,-33
9495,1,0,39,0,-39
9496,0,0,15,0,-15
9497,1,0,95,0,-95
9498,1,1,586,1790,1204
9499,0,0,98,0,-98
9500,1,1,389,1276,887
9501,0,0,30,0,-30
9502,0,0,7,0,-7
9503,1,0,30,0,-30
9504,0,0,18,0,-18
9505,0,0,26,0,-26
9506,0,0,11,0,-11
9507,1,0,38,0,-38
9508,0,0,1,0,-1
9509,0,0,26,0,-26
9510,1,1,642,1368,726
9511,0,0,20,0,-20
9512,1,0,145,0,-145
9513,1,0,22,0,-22
9514,0,0,204,0,-204
9515,1,0,0,0,0
9516,1,0,7,0,-7
9517,1,1,953,2028,1075
9518,0,0,8,0,-8
9519,0,0,247,0,-247
9520,0,0,9,0,-9
9521,0,0,2,0,-2
9522,0,0,13,0,-13
9523,1,1,2029,1602,-427
9524,0,0,27,0,-27
9525,0,0,40,0,-40
9526,0,0,75,0,-75
9527,1,0,9,0,-9
9528,0,0,21,0,-21
9529,1,0,18,0,-18
9530,1,1,425,1426,1001
9531,1,1,165,1251,1086
9532,1,0,56,0,-56
9533,0,0,32,0,-32
9534,1,0,15,0,-15
9535,1,1,23,1741,1718
9536,0,0,97,0,-97
9537,1,0,75,0,-75
9538,0,0,54,0,-54
9539,0,0,61,0,-61
9540,1,1,1502,1317,-185
9541,1,0,17,0,-17
9542,1,0,25,0,-25
9543,0,0,132,0,-132
9544,1,0,46,0,-46
9545,1,0,124,0,-124
9546,1,0,0,0,0
9547,0,0,62,0,-62
9548,0,0,152,0,-152
9549,1,1,260,1349,1089
9550,1,1,869,2625,1756
9551,1,1,1453,1302,-151
9552,0,0,39,0,-39
9553,0,0,30,0,-30
9554,0,0,49,0,-49
9555,1,1,1014,1278,264
9556,0,0,33,0,-33
9557,1,0,1,0,-1
9558,0,0,9,0,-9
9559,1,0,21,0,-21
9560,0,0,6,0,-6
9561,1,0,0,0,0
9562,1,1,274,1254,980
9563,0,0,37,0,-37
9564,1,0,41,0,-41
9565,1,1,1378,1323,-55
9566,1,0,179,0,-179
9567,0,0,124,0,-124
9568,1,0,87,0,-87
9569,1,0,12,0,-12
9570,0,0,83,0,-83
9571,1,0,99,0,-99
9572,1,0,15,0,-15
9573,0,0,17,0,-17
9574,1,1,325,1342,1017
9575,0,0,18,0,-18
9576,1,1,228,1659,1431
9577,1,1,712,1285,573
9578,1,1,359,1939,1580
9579,1,1,1007,1248,241
9580,1,0,15,0,-15
9581,0,0,0,0,0
9582,1,1,186,1355,1169
9583,0,0,32,0,-32
9584,0,0,22,0,-22
9585,0,0,4,0,-4
9586,1,1,1632,1471,-161
9587,1,1,88,2063,1975
9588,1,0,200,0,-200
9589,1,0,42,0,-42
9590,1,1,72,3008,2936
9591,1,0,7,0,-7
9592,1,1,1406,1376,-30
9593,0,0,27,0,-27
9594,0,0,2,0,-2
9595,1,1,46,1256,1210
9596,0,0,45,0,-45
9597,0,0,99,0,-99
9598,0,0,131,0,-131
9599,1,0,1,0,-1
9600,1,1,1882,1236,-646
9601,1,1,171,1299,1128
9602,1,0,21,0,-21
9603,1,0,9,0,-9
9604,1,1,180,1318,1138
9605,0,0,60,0,-60
9606,1,0,53,0,-53
9607,1,1,85,1258,1173
9608,1,0,17,0,-17
9609,1,0,64,0,-64
9610,0,0,8,0,-8
9611,0,0,135,0,-135
9612,1,0,46,0,-46
9613,0,0,4,0,-4
9614,1,1,1026,1349,323
9615,0,0,26,0,-26
9616,1,0,4,0,-4
9617,0,0,4,0,-4
9618,0,0,16,0,-16
9619,1,1,1174,1341,167
9620,1,0,9,0,-9
9621,1,0,47,0,-47
9622,1,0,26,0,-26
9623,0,0,59,0,-59
9624,1,1,732,1945,1213
9625,1,1,251,1411,1160
9626,0,0,51,0,-51
9627,0,0,183,0,-183
9628,1,0,67,0,-67
9629,0,0,55,0,-55
9630,0,0,17,0,-17
9631,1,0,49,0,-49
9632,1,0,42,0,-42
9633,1,1,120,1278,1158
9634,1,0,6,0,-6
9635,1,0,68,0,-68
9636,1,0,1,0,-1
9637,0,0,31,0,-31
9638,0,0,113,0,-113
9639,1,0,120,0,-120
9640,0,0,21,0,-21
9641,0,0,29,0,-29
9642,1,0,0,0,0
9643,1,1,89,1376,1287
9644,0,0,163,0,-163
9645,0,0,34,0,-34
9646,1,0,39,0,-39
9647,0,0,17,0,-17
9648,0,0,95,0,-95
9649,1,1,492,2075,1583
9650,1,0,6,0,-6
9651,1,1,1128,1739,611
9652,1,0,50,0,-50
9653,0,0,27,0,-27
9654,1,0,74,0,-74
9655,0,0,2,0,-2
9656,1,1,877,1337,460
9657,0,0,18,0,-18
9658,1,1,895,1212,317
9659,0,0,19,0,-19
9660,0,0,113,0,-113
9661,1,1,1686,1449,-237
9662,0,0,6,0,-6
9663,1,0,10,0,-10
9664,0,0,65,0,-65
9665,0,0,10,0,-10
9666,0,0,45,0,-45
9667,1,1,461,1383,922
9668,0,0,8,0,-8
9669,0,0,47,0,-47
9670,1,1,728,1701,973
9671,1,1,2975,1721,-1254
9672,0,0,44,0,-44
9673,1,0,32,0,-32
9674,1,0,1,0,-1
9675,1,1,148,1296,1148
9676,0,0,77,0,-77
9677,1,1,554,1956,1402
9678,0,0,6,0,-6
9679,0,0,21,0,-21
9680,1,1,664,2046,1382
9681,1,1,722,2357,1635
9682,1,1,861,2570,1709
9683,1,1,332,1245,913
9684,1,1,240,1326,1086
9685,1,0,2,0,-2
9686,1,0,29,0,-29
9687,0,0,35,0,-35
9688,0,0,110,0,-110
9689,1,1,110,2326,2216
9690,1,1,127,1257,1130
9691,0,0,60,0,-60
9692,0,0,5,0,-5
9693,0,0,19,0,-19
9694,0,0,12,0,-12
9695,1,0,119,0,-119
9696,1,0,10,0,-10
9697,1,0,27,0,-27
9698,1,0,86,0,-86
9699,1,0,3,0,-3
9700,0,0,8,0,-8
9701,1,1,879,2110,1231
9702,1,0,61,0,-61
9703,1,1,1134,1290,156
9704,1,1,314,1378,1064
9705,1,0,15,0,-15
9706,1,1,95,1258,1163
9707,1,0,110,0,-110
9708,1,0,8,0,-8
9709,1,1,1088,1219,131
9710,1,0,16,0,-16
9711,1,0,111,0,-111
9712,1,1,285,2078,1793
9713,0,0,19,0,-19
9714,1,0,16,0,-16
9715,1,0,98,0,-98
9716,0,0,4,0,-4
9717,1,0,56,0,-56
9718,1,0,13,0,-13
9719,1,1,1711,1348,-363
9720,1,1,682,1361,679
9721,0,0,91,0,-91
9722,0,0,26,0,-26
9723,0,0,115,0,-115
9724,1,0,1,0,-1
9725,0,0,64,0,-64
9726,1,1,269,1637,1368
9727,0,0,138,0,-138
9728,1,0,56,0,-56
9729,0,0,22,0,-22
9730,1,0,32,0,-32
9731,1,1,116,1315,1199
9732,1,0,25,0,-25
9733,0,0,70,0,-70
9734,0,0,0,0,0
9735,1,1,254,2503,2249
9736,1,1,264,1242,978
9737,1,1,325,1468,1143
9738,0,0,2,0,-2
9739,1,1,866,1324,458
9740,1,0,36,0,-36
9741,0,0,60,0,-60
9742,0,0,13,0,-13
9743,1,1,523,1733,1210
9744,1,1,337,1283,946
9745,0,0,49,0,-49
9746,1,0,76,0,-76
9747,1,1,377,1840,1463
9748,0,0,21,0,-21
9749,1,1,127,1236,1109
9750,0,0,50,0,-50
9751,1,1,1086,1393,307
9752,1,1,302,1753,1451
9753,0,0,175,0,-175
9754,0,0,18,0,-18
9755,0,0,27,0,-27
9756,1,1,259,1729,1470
9757,1,0,10,0,-10
9758,1,1,1450,1346,-104
9759,0,0,16,0,-16
9760,1,0,60,0,-60
9761,1,0,59,0,-59
9762,1,0,10,0,-10
9763,0,0,45,0,-45
9764,0,0,265,0,-265
9765,1,0,188,0,-188
9766,1,1,813,1285,472
9767,0,0,1,0,-1
9768,1,0,54,0,-54
9769,0,0,70,0,-70
9770,0,0,40,0,-40
9771,1,1,744,1874,1130
9772,1,0,3,0,-3
9773,0,0,0,0,0
9774,1,1,840,1671,831
9775,1,0,27,0,-27
9776,1,0,220,0,-220
9777,1,1,510,1986,1476
9778,1,1,104,1253,1149
9779,1,0,18,0,-18
9780,0,0,32,0,-32
9781,1,0,25,0,-25
9782,1,0,21,0,-21
9783,1,0,48,0,-48
9784,1,0,99,0,-99
9785,0,0,4,0,-4
9786,1,0,7,0,-7
9787,1,0,97,0,-97
9788,1,1,1039,1240,201
9789,0,0,23,0,-23
9790,1,1,166,1294,1128
9791,0,0,57,0,-57
9792,0,0,2,0,-2
9793,1,1,830,1410,580
9794,0,0,46,0,-46
9795,0,0,75,0,-75
9796,0,0,14,0,-14
9797,0,0,35,0,-35
9798,1,0,175,0,-175
9799,0,0,31,0,-31
9800,0,0,92,0,-92
9801,1,0,47,0,-47
9802,1,1,1774,1913,139
9803,0,0,53,0,-53
9804,1,0,46,0,-46
9805,0,0,2,0,-2
9806,1,1,258,1421,1163
9807,1,0,26,0,-26
9808,1,1,118,2578,2460
9809,0,0,32,0,-32
9810,1,1,504,1277,773
9811,1,1,399,1368,969
9812,0,0,259,0,-259
9813,0,0,21,0,-21
9814,0,0,25,0,-25
9815,0,0,6,0,-6
9816,1,0,128,0,-128
9817,0,0,56,0,-56
9818,1,1,683,2178,1495
9819,1,1,172,1561,1389
9820,1,0,52,0,-52
9821,0,0,121,0,-121
9822,0,0,103,0,-103
9823,1,1,267,1220,953
9824,1,1,80,1709,1629
9825,1,1,81,1318,1237
9826,0,0,44,0,-44
9827,0,0,84,0,-84
9828,0,0,6,0,-6
9829,1,0,51,0,-51
9830,1,1,726,1604,878
9831,0,0,125,0,-125
9832,1,0,59,0,-59
9833,1,0,74,0,-74
9834,1,0,66,0,-66
9835,1,1,701,1454,753
9836,0,0,9,0,-9
9837,0,0,37,0,-37
9838,1,0,80,0,-80
9839,1,1,1328,1317,-11
9840,0,0,89,0,-89
9841,1,0,1,0,-1
9842,0,0,44,0,-44
9843,1,1,785,1974,1189
9844,0,0,16,0,-16
9845,1,1,138,1570,1432
9846,0,0,67,0,-67
9847,1,1,1522,1356,-166
9848,1,0,31,0,-31
9849,1,0,15,0,-15
9850,1,0,43,0,-43
9851,1,1,1623,1402,-221
9852,1,0,30,0,-30
9853,1,1,498,1310,812
9854,0,0,30,0,-30
9855,1,1,212,1204,992
9856,0,0,8,0,-8
9857,1,1,289,1236,947
9858,1,0,45,0,-45
9859,0,0,0,0,0
9860,1,1,487,1315,828
9861,0,0,51,0,-51
9862,1,0,93,0,-93
9863,1,0,10,0,-10
9864,1,1,785,1608,823
9865,0,0,35,0,-35
9866,0,0,274,0,-274
9867,1,0,15,0,-15
9868,0,0,10,0,-10
9869,1,1,316,1284,968
9870,1,0,35,0,-35
9871,1,0,36,0,-36
9872,1,0,3,0,-3
9873,0,0,9,0,-9
9874,1,0,50,0,-50
9875,0,0,13,0,-13
9876,0,0,54,0,-54
9877,0,0,50,0,-50
9878,0,0,82,0,-82
9879,1,1,642,2403,1761
9880,1,1,733,1391,658
9881,1,1,671,1212,541
9882,0,0,97,0,-97
9883,1,0,27,0,-27
9884,0,0,0,0,0
9885,1,0,9,0,-9
9886,0,0,126,0,-126
9887,1,1,231,2234,2003
9888,0,0,10,0,-10
9889,1,1,622,1550,928
9890,1,0,22,0,-22
9891,1,1,540,2238,1698
9892,1,0,9,0,-9
9893,1,0,39,0,-39
9894,1,0,16,0,-16
9895,1,0,61,0,-61
9896,1,0,59,0,-59
9897,0,0,244,0,-244
9898,1,0,22,0,-22
9899,1,0,68,0,-68
9900,1,1,226,1513,1287
9901,0,0,33,0,-33
9902,0,0,5,0,-5
9903,0,0,4,0,-4
9904,0,0,125,0,-125
9905,1,0,5,0,-5
9906,0,0,21,0,-21
9907,1,1,1324,2506,1182
9908,0,0,91,0,-91
9909,1,0,92,0,-92
9910,1,0,66,0,-66
9911,1,1,837,1540,703
9912,0,0,6,0,-6
9913,1,1,1002,1290,288
9914,0,0,21,0,-21
9915,0,0,28,0,-28
9916,0,0,196,0,-196
9917,0,0,50,0,-50
9918,1,1,376,1394,1018
9919,0,0,178,0,-178
9920,0,0,90,0,-90
9921,0,0,49,0,-49
9922,0,0,47,0,-47
9923,0,0,2,0,-2
9924,1,0,52,0,-52
9925,1,0,3,0,-3
9926,0,0,12,0,-12
9927,0,0,63,0,-63
9928,0,0,32,0,-32
9929,1,1,74,1227,1153
9930,1,1,488,2002,1514
9931,1,1,127,3027,2900
9932,1,1,118,1395,1277
9933,0,0,113,0,-113
9934,0,0,59,0,-59
9935,1,1,351,1633,1282
9936,0,0,0,0,0
9937,1,1,77,1487,1410
9938,1,1,419,1841,1422
9939,0,0,4,0,-4
9940,0,0,16,0,-16
9941,1,0,48,0,-48
9942,1,0,42,0,-42
9943,1,1,211,1533,1322
9944,0,0,39,0,-39
9945,1,0,0,0,0
9946,0,0,170,0,-170
9947,0,0,66,0,-66
9948,1,0,59,0,-59
9949,0,0,35,0,-35
9950,0,0,30,0,-30
9951,1,1,726,2543,1817
9952,1,0,47,0,-47
9953,1,0,36,0,-36
9954,0,0,65,0,-65
9955,1,0,12,0,-12
9956,1,1,340,1222,882
9957,1,0,27,0,-27
9958,1,0,15,0,-15
9959,1,1,96,1245,1149
9960,0,0,51,0,-51
9961,1,0,0,0,0
9962,1,1,1016,1439,423
9963,0,0,31,0,-31
9964,1,0,32,0,-32
9965,1,1,547,1482,935
9966,0,0,0,0,0
9967,0,0,17,0,-17
9968,0,0,29,0,-29
9969,0,0,55,0,-55
9970,1,1,1570,1295,-275
9971,0,0,12,0,-12
9972,0,0,2,0,-2
9973,0,0,77,0,-77
9974,1,0,12,0,-12
9975,1,1,1659,1284,-375
9976,1,0,71,0,-71
9977,1,0,10,0,-10
9978,0,0,83,0,-83
9979,0,0,10,0,-10
9980,1,1,114,2949,2835
9981,1,0,15,0,-15
9982,0,0,6,0,-6
9983,1,0,35,0,-35
9984,1,1,120,1617,1497
9985,1,1,690,1479,789
9986,1,1,204,1377,1173
9987,1,1,40,1249,1209
9988,1,0,71,0,-71
9989,1,0,7,0,-7
9990,0,0,24,0,-24
9991,1,1,1435,1200,-235
9992,0,0,33,0,-33
9993,0,0,177,0,-177
9994,1,0,172,0,-172
9995,0,0,47,0,-47
9996,1,0,77,0,-77
9997,1,1,37,1404,1367
9998,0,0,2,0,-2
9999,1,0,64,0,-64
10000,1,1,390,1621,1231
10001,1,0,67,0,-67
10002,0,0,51,0,-51
10003,1,0,19,0,-19
10004,1,1,108,2063,1955
10005,0,0,20,0,-20
10006,0,0,38,0,-38
10007,0,0,147,0,-147
10008,1,1,528,1670,1142
10009,1,0,22,0,-22
10010,0,0,9,0,-9
10011,1,0,167,0,-167
10012,0,0,44,0,-44
10013,0,0,14,0,-14
10014,0,0,14,0,-14
10015,1,0,54,0,-54
10016,1,0,4,0,-4
10017,1,1,476,2999,2523
10018,1,1,2249,1226,-1023
10019,1,1,1627,1361,-266
10020,1,0,26,0,-26
10021,1,1,257,1476,1219
10022,0,0,171,0,-171
10023,1,1,210,2155,1945
10024,1,1,335,1545,1210
10025,1,1,1128,1855,727
10026,1,1,1140,2516,1376
10027,1,1,215,1566,1351
10028,1,1,76,2075,1999
10029,1,1,53,1845,1792
10030,1,0,32,0,-32
10031,1,0,90,0,-90
10032,1,1,743,1255,512
10033,1,1,1084,1825,741
10034,0,0,32,0,-32
10035,1,1,1469,1307,-162
10036,0,0,39,0,-39
10037,0,0,23,0,-23
10038,1,0,53,0,-53
10039,1,0,19,0,-19
10040,1,0,6,0,-6
10041,0,0,10,0,-10
10042,1,1,545,1246,701
10043,0,0,40,0,-40
10044,1,1,333,1283,950
10045,0,0,74,0,-74
10046,0,0,83,0,-83
10047,1,1,147,1214,1067
10048,1,1,481,1602,1121
10049,0,0,13,0,-13
10050,0,0,22,0,-22
10051,1,0,70,0,-70
10052,0,0,100,0,-100
10053,1,1,811,1382,571
10054,0,0,77,0,-77
10055,1,0,173,0,-173
10056,0,0,20,0,-20
10057,1,0,30,0,-30
10058,1,1,829,1315,486
10059,0,0,28,0,-28
10060,1,0,165,0,-165
10061,0,0,0,0,0
10062,1,0,32,0,-32
10063,1,1,1440,1207,-233
10064,0,0,57,0,-57
10065,1,0,72,0,-72
10066,0,0,27,0,-27
10067,0,0,53,0,-53
10068,0,0,145,0,-145
10069,0,0,102,0,-102
10070,1,1,112,2761,2649
10071,0,0,77,0,-77
10072,0,0,72,0,-72
10073,1,0,1,0,-1
10074,1,0,15,0,-15
10075,0,0,20,0,-20
10076,0,0,32,0,-32
10077,0,0,2,0,-2
10078,0,0,118,0,-118
10079,1,1,462,1231,769
10080,1,0,28,0,-28
10081,1,1,323,1468,1145
10082,0,0,60,0,-60
10083,1,0,38,0,-38
10084,0,0,14,0,-14
10085,0,0,50,0,-50
10086,1,1,64,1306,1242
10087,1,1,400,1796,1396
10088,0,0,15,0,-15
10089,0,0,78,0,-78
10090,1,1,758,1473,715
10091,0,0,51,0,-51
10092,1,1,1567,2027,460
10093,1,1,64,1568,1504
10094,0,0,9,0,-9
10095,0,0,77,0,-77
10096,0,0,0,0,0
10097,1,1,777,1847,1070
10098,1,0,0,0,0
10099,1,1,162,1600,1438
10100,1,1,49,1615,1566
10101,1,1,436,2003,1567
10102,0,0,32,0,-32
10103,1,0,24,0,-24
10104,1,0,71,0,-71
10105,0,0,32,0,-32
10106,1,0,2,0,-2
10107,1,1,271,1892,1621
10108,1,0,17,0,-17
10109,1,1,67,1206,1139
10110,0,0,81,0,-81
10111,0,0,26,0,-26
10112,0,0,1,0,-1
10113,1,1,2399,1269,-1130
10114,1,0,83,0,-83
10115,0,0,44,0,-44
10116,1,1,1096,1478,382
10117,1,0,3,0,-3
10118,0,0,159,0,-159
10119,1,0,22,0,-22
10120,0,0,103,0,-103
10121,0,0,90,0,-90
10122,1,0,52,0,-52
10123,0,0,113,0,-113
10124,1,0,142,0,-142
10125,1,1,241,1988,1747
10126,0,0,65,0,-65
10127,1,0,105,0,-105
10128,0,0,56,0,-56
10129,1,0,18,0,-18
10130,1,0,28,0,-28
10131,1,1,916,1330,414
10132,1,0,74,0,-74
10133,1,0,27,0,-27
10134,1,1,237,1476,1239
10135,1,1,2157,1599,-558
10136,1,0,13,0,-13
10137,0,0,57,0,-57
10138,1,0,141,0,-141
10139,0,0,69,0,-69
10140,1,0,31,0,-31
10141,1,1,333,1396,1063
10142,1,0,179,0,-179
10143,1,1,141,1640,1499
10144,1,0,23,0,-23
10145,1,1,149,1478,1329
10146,0,0,2,0,-2
10147,1,0,7,0,-7
10148,1,0,69,0,-69
10149,0,0,6,0,-6
10150,1,1,409,1533,1124
10151,1,1,1129,1326,197
10152,0,0,97,0,-97
10153,0,0,67,0,-67
10154,0,0,1,0,-1
10155,0,0,90,0,-90
10156,1,1,486,1377,891
10157,0,0,74,0,-74
10158,1,0,159,0,-159
10159,1,0,24,0,-24
10160,1,1,41,1539,1498
10161,0,0,13,0,-13
10162,1,1,50,1442,1392
10163,0,0,49,0,-49
10164,1,1,359,1741,1382
10165,0,0,1,0,-1
10166,0,0,26,0,-26
10167,1,0,1,0,-1
10168,0,0,1,0,-1
10169,0,0,62,0,-62
10170,0,0,37,0,-37
10171,1,0,125,0,-125
10172,1,0,55,0,-55
10173,1,0,170,0,-170
10174,0,0,48,0,-48
10175,1,1,28,1227,1199
10176,0,0,127,0,-127
10177,1,0,67,0,-67
10178,0,0,188,0,-188
10179,1,0,42,0,-42
10180,0,0,27,0,-27
10181,1,1,329,1204,875
10182,1,1,419,1211,792
10183,1,1,213,1575,1362
10184,1,1,167,1497,1330
10185,1,1,175,1610,1435
10186,0,0,116,0,-116
10187,0,0,158,0,-158
10188,1,0,43,0,-43
10189,0,0,48,0,-48
10190,1,0,139,0,-139
10191,0,0,64,0,-64
10192,1,1,339,1294,955
10193,1,0,9,0,-9
10194,1,1,202,2886,2684
10195,1,0,13,0,-13
10196,1,0,156,0,-156
10197,1,0,45,0,-45
10198,0,0,34,0,-34
10199,1,0,38,0,-38
10200,1,1,66,1514,1448
10201,1,1,1925,1412,-513
10202,1,1,2845,1297,-1548
10203,0,0,2,0,-2
10204,0,0,60,0,-60
10205,1,1,1137,1361,224
10206,0,0,11,0,-11
10207,1,0,15,0,-15
10208,1,1,141,1220,1079
10209,1,0,2,0,-2
10210,0,0,54,0,-54
10211,1,0,23,0,-23
10212,1,0,10,0,-10
10213,1,0,20,0,-20
10214,1,1,315,1895,1580
10215,1,0,68,0,-68
10216,1,1,422,1361,939
10217,1,0,62,0,-62
10218,0,0,8,0,-8
10219,0,0,97,0,-97
10220,1,1,105,1388,1283
10221,1,1,306,1282,976
10222,0,0,6,0,-6
10223,1,0,12,0,-12
10224,0,0,29,0,-29
10225,1,1,592,1298,706
10226,0,0,99,0,-99
10227,1,1,124,1254,1130
10228,1,1,236,1946,1710
10229,1,1,1039,1252,213
10230,0,0,19,0,-19
10231,0,0,11,0,-11
10232,0,0,27,0,-27
10233,1,1,174,1399,1225
10234,0,0,44,0,-44
10235,1,0,153,0,-153
10236,0,0,35,0,-35
10237,1,0,46,0,-46
10238,1,1,550,1280,730
10239,1,0,21,0,-21
10240,0,0,17,0,-17
10241,1,1,148,1613,1465
10242,1,1,131,1774,1643
10243,0,0,22,0,-22
10244,1,0,103,0,-103
10245,1,1,707,1556,849
10246,0,0,25,0,-25
10247,1,0,8,0,-8
10248,0,0,26,0,-26
10249,0,0,10,0,-10
10250,1,1,593,2314,1721
10251,1,1,310,1248,938
10252,0,0,25,0,-25
10253,0,0,66,0,-66
10254,0,0,40,0,-40
10255,1,0,14,0,-14
10256,0,0,62,0,-62
10257,1,0,40,0,-40
10258,1,0,70,0,-70
10259,1,1,1895,1460,-435
10260,1,0,60,0,-60
10261,1,1,299,1500,1201
10262,1,0,92,0,-92
10263,0,0,78,0,-78
10264,1,0,33,0,-33
10265,1,1,264,1262,998
10266,1,0,24,0,-24
10267,1,0,49,0,-49
10268,1,0,105,0,-105
10269,1,1,150,2233,2083
10270,1,0,28,0,-28
10271,1,0,23,0,-23
10272,0,0,60,0,-60
10273,0,0,29,0,-29
10274,1,0,25,0,-25
10275,1,1,491,1923,1432
10276,0,0,91,0,-91
10277,0,0,121,0,-121
10278,0,0,24,0,-24
10279,0,0,0,0,0
10280,1,0,8,0,-8
10281,1,1,167,1735,1568
10282,1,1,179,1384,1205
10283,1,1,460,2037,1577
10284,1,1,188,1205,1017
10285,1,0,40,0,-40
10286,1,0,35,0,-35
10287,0,0,30,0,-30
10288,1,1,919,1304,385
10289,0,0,1,0,-1
10290,0,0,112,0,-112
10291,0,0,12,0,-12
10292,0,0,47,0,-47
10293,1,0,8,0,-8
10294,0,0,157,0,-157
10295,1,0,67,0,-67
10296,1,0,45,0,-45
10297,1,0,97,0,-97
10298,1,0,75,0,-75
10299,0,0,78,0,-78
10300,0,0,60,0,-60
10301,1,0,7,0,-7
10302,0,0,4,0,-4
10303,0,0,38,0,-38
10304,1,0,45,0,-45
10305,1,1,137,1655,1518
10306,0,0,54,0,-54
10307,1,1,487,1487,1000
10308,1,0,34,0,-34
10309,1,0,6,0,-6
10310,1,1,763,2352,1589
10311,1,1,466,1330,864
10312,1,1,164,1428,1264
10313,1,0,60,0,-60
10314,0,0,43,0,-43
10315,0,0,41,0,-41
10316,0,0,20,0,-20
10317,1,0,36,0,-36
10318,1,0,38,0,-38
10319,1,1,604,2185,1581
10320,0,0,17,0,-17
10321,1,0,4,0,-4
10322,1,1,1045,1200,155
10323,1,1,457,1299,842
10324,0,0,146,0,-146
10325,1,1,1389,1905,516
10326,1,0,126,0,-126
10327,1,1,113,1211,1098
10328,1,0,84,0,-84
10329,1,1,479,1419,940
10330,0,0,13,0,-13
10331,0,0,13,0,-13
10332,1,1,614,1351,737
10333,1,0,166,0,-166
10334,0,0,9,0,-9
10335,0,0,39,0,-39
10336,1,0,75,0,-75
10337,1,0,41,0,-41
10338,0,0,51,0,-51
10339,0,0,19,0,-19
10340,0,0,25,0,-25
10341,1,1,266,2069,1803
10342,0,0,178,0,-178
10343,0,0,130,0,-130
10344,1,1,534,1380,846
10345,1,1,157,1625,1468
10346,1,1,163,1203,1040
10347,1,1,992,1750,758
10348,1,0,37,0,-37
10349,1,0,9,0,-9
10350,0,0,110,0,-110
10351,0,0,2,0,-2
10352,1,1,313,1279,966
10353,1,0,118,0,-118
10354,1,1,360,1220,860
10355,1,1,274,1440,1166
10356,0,0,22,0,-22
10357,1,1,793,1478,685
10358,1,1,457,1677,1220
10359,1,0,99,0,-99
10360,1,1,76,1211,1135
10361,0,0,59,0,-59
10362,1,1,201,3016,2815
10363,1,1,2859,1892,-967
10364,1,0,48,0,-48
10365,1,1,608,1694,1086
10366,1,1,1247,1277,30
10367,0,0,22,0,-22
10368,1,1,144,1924,1780
10369,1,0,97,0,-97
10370,1,0,15,0,-15
10371,1,1,90,2894,2804
10372,0,0,106,0,-106
10373,1,0,15,0,-15
10374,1,0,9,0,-9
10375,1,0,102,0,-102
10376,1,1,2655,1297,-1358
10377,0,0,41,0,-41
10378,0,0,17,0,-17
10379,1,1,10,1685,1675
10380,1,1,397,1549,1152
10381,1,0,18,0,-18
10382,1,0,78,0,-78
10383,1,1,787,1494,707
10384,0,0,7,0,-7
10385,1,0,87,0,-87
10386,1,0,7,0,-7
10387,0,0,88,0,-88
10388,1,0,1,0,-1
10389,1,0,33,0,-33
10390,0,0,15,0,-15
10391,0,0,11,0,-11
10392,0,0,15,0,-15
10393,1,0,9,0,-9
10394,0,0,177,0,-177
10395,1,1,1575,1222,-353
10396,0,0,109,0,-109
10397,0,0,1,0,-1
10398,1,1,868,1600,732
10399,1,1,111,1349,1238
10400,1,0,15,0,-15
10401,0,0,29,0,-29
10402,0,0,15,0,-15
10403,1,1,505,1217,712
10404,1,0,13,0,-13
10405,0,0,4,0,-4
10406,1,0,34,0,-34
10407,1,0,82,0,-82
10408,0,0,18,0,-18
10409,0,0,95,0,-95
10410,1,1,932,1225,293
10411,0,0,10,0,-10
10412,1,0,180,0,-180
10413,1,0,51,0,-51
10414,1,1,551,1813,1262
10415,0,0,54,0,-54
10416,0,0,0,0,0
10417,0,0,8,0,-8
10418,0,0,25,0,-25
10419,1,0,29,0,-29
10420,0,0,157,0,-157
10421,0,0,25,0,-25
10422,1,1,993,1265,272
10423,0,0,13,0,-13
10424,0,0,88,0,-88
10425,1,1,89,1304,1215
10426,0,0,63,0,-63
10427,0,0,5,0,-5
10428,1,1,463,1321,858
10429,0,0,62,0,-62
10430,1,1,918,2335,1417
10431,0,0,80,0,-80
10432,1,1,177,1225,1048
10433,0,0,56,0,-56
10434,1,0,48,0,-48
10435,1,1,765,1786,1021
10436,1,0,45,0,-45
10437,1,0,26,0,-26
10438,1,0,66,0,-66
10439,1,0,71,0,-71
10440,1,0,31,0,-31
10441,1,1,1521,1294,-227
10442,1,1,190,1265,1075
10443,1,1,374,1290,916
10444,1,1,309,1433,1124
10445,0,0,11,0,-11
10446,1,0,51,0,-51
10447,1,1,795,1326,531
10448,1,0,37,0,-37
10449,1,0,36,0,-36
10450,1,1,331,1253,922
10451,1,1,375,2249,1874
10452,1,1,595,1249,654
10453,1,1,1398,1519,121
10454,1,0,98,0,-98
10455,1,0,47,0,-47
10456,0,0,37,0,-37
10457,1,1,268,1262,994
10458,1,1,48,1313,1265
10459,0,0,59,0,-59
10460,0,0,14,0,-14
10461,1,1,2371,1250,-1121
10462,1,1,437,1219,782
10463,1,0,47,0,-47
10464,0,0,28,0,-28
10465,0,0,59,0,-59
10466,1,0,48,0,-48
10467,1,0,141,0,-141
10468,0,0,2,0,-2
10469,0,0,46,0,-46
10470,1,0,9,0,-9
10471,1,1,1604,1379,-225
10472,0,0,34,0,-34
10473,0,0,207,0,-207
10474,1,1,269,1359,1090
10475,1,0,25,0,-25
10476,0,0,277,0,-277
10477,0,0,37,0,-37
10478,1,0,23,0,-23
10479,0,0,2,0,-2
10480,1,1,1588,2822,1234
10481,1,1,742,2285,1543
10482,1,1,1357,1285,-72
10483,0,0,63,0,-63
10484,1,0,101,0,-101
10485,1,0,32,0,-32
10486,0,0,32,0,-32
10487,1,1,1493,1445,-48
10488,1,1,113,1231,1118
10489,0,0,16,0,-16
10490,1,0,37,0,-37
10491,1,0,128,0,-128
10492,1,1,728,1299,571
10493,1,1,184,1275,1091
10494,0,0,1,0,-1
10495,1,1,313,1791,1478
10496,1,0,4,0,-4
10497,1,0,56,0,-56
10498,1,0,117,0,-117
10499,0,0,208,0,-208
10500,1,0,76,0,-76
10501,1,0,138,0,-138
10502,0,0,213,0,-213
10503,1,0,59,0,-59
10504,0,0,13,0,-13
10505,1,0,164,0,-164
10506,0,0,31,0,-31
10507,1,0,129,0,-129
10508,1,0,25,0,-25
10509,1,1,600,1346,746
10510,1,0,15,0,-15
10511,1,0,217,0,-217
10512,1,0,28,0,-28
10513,1,0,4,0,-4
10514,0,0,61,0,-61
10515,1,0,67,0,-67
10516,1,1,428,1362,934
10517,0,0,23,0,-23
10518,0,0,219,0,-219
10519,0,0,2,0,-2
10520,0,0,62,0,-62
10521,0,0,59,0,-59
10522,1,1,500,1239,739
10523,1,0,16,0,-16
10524,1,1,289,1648,1359
10525,1,0,9,0,-9
10526,0,0,19,0,-19
10527,1,1,292,1710,1418
10528,1,0,6,0,-6
10529,0,0,17,0,-17
10530,1,0,43,0,-43
10531,1,0,97,0,-97
10532,1,0,158,0,-158
10533,0,0,249,0,-249
10534,0,0,65,0,-65
10535,0,0,176,0,-176
10536,0,0,64,0,-64
10537,0,0,50,0,-50
10538,0,0,76,0,-76
10539,1,1,145,1309,1164
10540,0,0,54,0,-54
10541,1,1,801,1203,402
10542,1,0,102,0,-102
10543,1,1,518,1307,789
10544,0,0,14,0,-14
10545,1,0,4,0,-4
10546,0,0,70,0,-70
10547,1,1,274,1233,959
10548,1,1,363,1593,1230
10549,0,0,77,0,-77
10550,0,0,85,0,-85
10551,1,0,86,0,-86
10552,1,1,404,2515,2111
10553,0,0,98,0,-98
10554,1,0,146,0,-146
10555,0,0,14,0,-14
10556,1,1,126,2670,2544
10557,1,0,30,0,-30
10558,1,1,1097,1229,132
10559,1,1,289,1227,938
10560,0,0,30,0,-30
10561,1,1,133,1206,1073
10562,1,0,166,0,-166
10563,0,0,13,0,-13
10564,0,0,12,0,-12
10565,0,0,23,0,-23
10566,1,0,29,0,-29
10567,1,0,28,0,-28
10568,0,0,116,0,-116
10569,0,0,82,0,-82
10570,1,0,106,0,-106
10571,0,0,31,0,-31
10572,1,1,85,1249,1164
10573,0,0,7,0,-7
10574,1,0,38,0,-38
10575,1,1,404,1478,1074
10576,1,1,677,1227,550
10577,0,0,105,0,-105
10578,1,1,490,1227,737
10579,0,0,60,0,-60
10580,1,1,538,1599,1061
10581,1,1,619,1804,1185
10582,1,1,702,2597,1895
10583,0,0,81,0,-81
10584,1,0,49,0,-49
10585,1,0,5,0,-5
10586,0,0,74,0,-74
10587,0,0,10,0,-10
10588,1,0,2,0,-2
10589,1,1,264,2428,2164
10590,1,0,6,0,-6
10591,1,1,133,1277,1144
10592,1,1,220,1593,1373
10593,0,0,21,0,-21
10594,0,0,1,0,-1
10595,1,0,51,0,-51
10596,1,1,77,1568,1491
10597,1,1,659,1738,1079
10598,0,0,45,0,-45
10599,1,1,482,1552,1070
10600,0,0,29,0,-29
10601,0,0,35,0,-35
10602,1,0,8,0,-8
10603,1,0,48,0,-48
10604,1,0,6,0,-6
10605,1,1,706,1590,884
10606,1,1,200,1433,1233
10607,1,0,7,0,-7
10608,0,0,12,0,-12
10609,1,1,286,1628,1342
10610,1,1,1007,1468,461
10611,1,1,267,1214,947
10612,1,0,42,0,-42
10613,1,1,1010,1244,234
10614,1,0,243,0,-243
10615,0,0,39,0,-39
10616,0,0,38,0,-38
10617,0,0,24,0,-24
10618,0,0,16,0,-16
10619,0,0,56,0,-56
10620,0,0,59,0,-59
10621,1,1,118,1786,1668
10622,1,0,7,0,-7
10623,0,0,156,0,-156
10624,1,0,173,0,-173
10625,0,0,86,0,-86
10626,0,0,101,0,-101
10627,0,0,1,0,-1
10628,1,1,684,1907,1223
10629,1,0,143,0,-143
10630,1,1,210,2005,1795
10631,0,0,75,0,-75
10632,1,0,47,0,-47
10633,0,0,21,0,-21
10634,1,0,92,0,-92
10635,0,0,14,0,-14
10636,1,0,75,0,-75
10637,1,0,73,0,-73
10638,0,0,25,0,-25
10639,0,0,54,0,-54
10640,1,0,14,0,-14
10641,0,0,123,0,-123
10642,0,0,20,0,-20
10643,1,1,147,1221,1074
10644,1,1,317,1758,1441
10645,1,1,1232,2030,798
10646,0,0,18,0,-18
10647,0,0,25,0,-25
10648,0,0,28,0,-28
10649,0,0,21,0,-21
10650,1,1,317,1444,1127
10651,0,0,28,0,-28
10652,0,0,36,0,-36
10653,1,0,42,0,-42
10654,1,0,38,0,-38
10655,0,0,41,0,-41
10656,1,0,144,0,-144
10657,1,1,1237,2110,873
10658,1,1,111,1323,1212
10659,1,0,57,0,-57
10660,1,1,108,1308,1200
10661,1,1,1248,1536,288
10662,0,0,11,0,-11
10663,1,0,12,0,-12
10664,0,0,105,0,-105
10665,0,0,14,0,-14
10666,1,0,8,0,-8
10667,1,0,10,0,-10
10668,0,0,11,0,-11
10669,1,0,54,0,-54
10670,1,0,59,0,-59
10671,1,1,247,2755,2508
10672,0,0,157,0,-157
10673,1,1,600,1214,614
10674,0,0,56,0,-56
10675,0,0,20,0,-20
10676,1,0,23,0,-23
10677,0,0,16,0,-16
10678,0,0,85,0,-85
10679,0,0,60,0,-60
10680,1,0,78,0,-78
10681,0,0,3,0,-3
10682,1,1,807,2014,1207
10683,0,0,42,0,-42
10684,1,1,1491,1289,-202
10685,1,0,91,0,-91
10686,0,0,227,0,-227
10687,1,0,102,0,-102
10688,0,0,9,0,-9
10689,0,0,4,0,-4
10690,1,0,19,0,-19
10691,1,1,320,1260,940
10692,0,0,107,0,-107
10693,0,0,50,0,-50
10694,1,1,2235,1570,-665
10695,0,0,38,0,-38
10696,0,0,76,0,-76
10697,1,0,15,0,-15
10698,0,0,12,0,-12
10699,1,0,2,0,-2
10700,1,1,513,1225,712
10701,1,0,21,0,-21
10702,1,1,118,3017,2899
10703,0,0,50,0,-50
10704,1,0,8,0,-8
10705,1,0,0,0,0
10706,1,1,914,1513,599
10707,1,0,38,0,-38
10708,0,0,12,0,-12
10709,1,1,1067,1248,181
10710,1,0,84,0,-84
10711,1,0,22,0,-22
10712,1,0,18,0,-18
10713,0,0,11,0,-11
10714,0,0,5,0,-5
10715,1,0,87,0,-87
10716,1,0,49,0,-49
10717,0,0,57,0,-57
10718,1,0,66,0,-66
10719,0,0,70,0,-70
10720,0,0,13,0,-13
10721,0,0,161,0,-161
10722,1,0,8,0,-8
10723,0,0,1,0,-1
10724,1,1,376,1313,937
10725,0,0,5,0,-5
10726,0,0,28,0,-28
10727,1,1,836,1680,844
10728,1,0,56,0,-56
10729,0,0,46,0,-46
10730,0,0,24,0,-24
10731,0,0,55,0,-55
10732,0,0,35,0,-35
10733,1,0,125,0,-125
10734,1,1,338,1291,953
10735,1,1,288,1251,963
10736,1,0,30,0,-30
10737,1,1,1359,8102,6743
10738,0,0,255,0,-255
10739,0,0,2,0,-2
10740,1,1,281,2557,2276
10741,1,1,154,1246,1092
10742,1,0,157,0,-157
10743,1,0,2,0,-2
10744,0,0,15,0,-15
10745,0,0,70,0,-70
10746,0,0,38,0,-38
10747,0,0,18,0,-18
10748,1,1,836,1309,473
10749,1,1,368,1402,1034
10750,1,0,22,0,-22
10751,0,0,64,0,-64
10752,0,0,4,0,-4
10753,1,0,51,0,-51
10754,1,0,29,0,-29
10755,0,0,35,0,-35
10756,1,1,499,1307,808
10757,1,1,683,1440,757
10758,1,1,649,1249,600
10759,1,1,734,1261,527
10760,1,1,432,1524,1092
10761,1,1,735,1206,471
10762,0,0,4,0,-4
10763,1,0,61,0,-61
10764,1,0,14,0,-14
10765,0,0,32,0,-32
10766,1,1,587,2522,1935
10767,0,0,62,0,-62
10768,0,0,76,0,-76
10769,0,0,54,0,-54
10770,1,1,54,1494,1440
10771,1,1,466,1279,813
10772,0,0,57,0,-57
10773,0,0,105,0,-105
10774,1,0,36,0,-36
10775,1,1,128,1473,1345
10776,1,1,104,1274,1170
10777,1,1,193,1600,1407
10778,1,1,145,1960,1815
10779,1,1,176,2639,2463
10780,0,0,42,0,-42
10781,1,1,613,1365,752
10782,0,0,46,0,-46
10783,1,1,1184,1306,122
10784,0,0,86,0,-86
10785,1,0,137,0,-137
10786,0,0,54,0,-54
10787,1,1,982,1296,314
10788,0,0,87,0,-87
10789,1,1,439,2091,1652
10790,1,1,808,1230,422
10791,0,0,58,0,-58
10792,1,1,684,2101,1417
10793,1,1,305,1377,1072
10794,1,1,332,1867,1535
10795,0,0,48,0,-48
10796,1,0,33,0,-33
10797,1,0,21,0,-21
10798,0,0,71,0,-71
10799,1,1,804,1320,516
10800,0,0,150,0,-150
10801,1,0,24,0,-24
10802,0,0,6,0,-6
10803,1,0,55,0,-55
10804,0,0,4,0,-4
10805,0,0,12,0,-12
10806,1,1,298,1308,1010
10807,1,1,182,1512,1330
10808,0,0,35,0,-35
10809,0,0,4,0,-4
10810,0,0,14,0,-14
10811,1,0,26,0,-26
10812,1,0,97,0,-97
10813,1,0,200,0,-200
10814,1,1,70,2280,2210
10815,1,1,846,2853,2007
10816,1,0,36,0,-36
10817,1,0,17,0,-17
10818,1,0,103,0,-103
10819,0,0,89,0,-89
10820,0,0,24,0,-24
10821,0,0,1,0,-1
10822,1,0,24,0,-24
10823,0,0,69,0,-69
10824,0,0,126,0,-126
10825,1,0,67,0,-67
10826,0,0,3,0,-3
10827,1,1,476,1402,926
10828,1,1,182,1618,1436
10829,0,0,8,0,-8
10830,1,1,408,1385,977
10831,0,0,16,0,-16
10832,0,0,48,0,-48
10833,1,0,27,0,-27
10834,1,0,209,0,-209
10835,1,0,6,0,-6
10836,1,0,58,0,-58
10837,1,1,984,1248,264
10838,1,0,66,0,-66
10839,1,1,792,1602,810
10840,0,0,3,0,-3
10841,1,0,17,0,-17
10842,0,0,30,0,-30
10843,0,0,26,0,-26
10844,0,0,35,0,-35
10845,0,0,15,0,-15
10846,1,0,30,0,-30
10847,1,1,304,1249,945
10848,0,0,5,0,-5
10849,1,1,1491,1337,-154
10850,1,1,720,2242,1522
10851,1,0,24,0,-24
10852,0,0,120,0,-120
10853,1,0,19,0,-19
10854,1,1,134,3442,3308
10855,1,1,82,1207,1125
10856,0,0,89,0,-89
10857,1,1,402,1300,898
10858,1,1,1821,1418,-403
10859,1,0,2,0,-2
10860,0,0,59,0,-59
10861,1,0,2,0,-2
10862,0,0,147,0,-147
10863,0,0,15,0,-15
10864,0,0,8,0,-8
10865,0,0,3,0,-3
10866,0,0,52,0,-52
10867,1,0,79,0,-79
10868,1,0,31,0,-31
10869,0,0,17,0,-17
10870,1,0,18,0,-18
10871,1,0,96,0,-96
10872,0,0,42,0,-42
10873,0,0,2,0,-2
10874,0,0,18,0,-18
10875,1,1,92,1235,1143
10876,1,1,693,1739,1046
10877,0,0,21,0,-21
10878,1,1,516,1519,1003
10879,0,0,2,0,-2
10880,0,0,44,0,-44
10881,1,1,1527,1525,-2
10882,0,0,33,0,-33
10883,1,1,178,1234,1056
10884,0,0,14,0,-14
10885,0,0,13,0,-13
10886,0,0,28,0,-28
10887,1,1,580,1209,629
10888,1,1,917,1200,283
10889,1,0,116,0,-116
10890,1,0,86,0,-86
10891,0,0,63,0,-63
10892,1,0,36,0,-36
10893,1,0,136,0,-136
10894,1,1,93,1226,1133
10895,0,0,68,0,-68
10896,0,0,49,0,-49
10897,1,0,94,0,-94
10898,0,0,22,0,-22
10899,0,0,6,0,-6
10900,0,0,90,0,-90
10901,0,0,46,0,-46
10902,0,0,117,0,-117
10903,1,1,509,1874,1365
10904,1,0,97,0,-97
10905,1,1,433,1930,1497
10906,1,1,34,1496,1462
10907,1,1,30,1739,1709
10908,0,0,16,0,-16
10909,1,0,78,0,-78
10910,1,1,184,1285,1101
10911,1,0,16,0,-16
10912,1,0,38,0,-38
10913,1,0,4,0,-4
10914,0,0,9,0,-9
10915,1,0,241,0,-241
10916,1,0,59,0,-59
10917,0,0,49,0,-49
10918,1,1,360,1372,1012
10919,0,0,34,0,-34
10920,1,0,31,0,-31
10921,0,0,50,0,-50
10922,1,1,132,1777,1645
10923,1,0,114,0,-114
10924,1,1,203,1296,1093
10925,0,0,12,0,-12
10926,0,0,41,0,-41
10927,1,1,483,1236,753
10928,0,0,118,0,-118
10929,1,0,18,0,-18
10930,0,0,97,0,-97
10931,0,0,43,0,-43
10932,1,1,163,2053,1890
10933,1,1,90,1291,1201
10934,1,1,971,1408,437
10935,1,0,91,0,-91
10936,1,1,335,1662,1327
10937,1,1,317,1316,999
10938,0,0,122,0,-122
10939,0,0,11,0,-11
10940,1,1,346,1264,918
10941,0,0,120,0,-120
10942,1,0,27,0,-27
10943,0,0,113,0,-113
10944,0,0,22,0,-22
10945,1,1,688,1820,1132
10946,1,0,24,0,-24
10947,1,1,293,1514,1221
10948,1,1,1447,13973,12526
10949,1,1,1028,1345,317
10950,1,1,944,1332,388
10951,0,0,73,0,-73
10952,0,0,46,0,-46
10953,1,1,1655,1423,-232
10954,1,1,351,1764,1413
10955,0,0,62,0,-62
10956,0,0,34,0,-34
10957,1,1,1525,1250,-275
10958,0,0,10,0,-10
10959,0,0,24,0,-24
10960,0,0,43,0,-43
10961,1,0,33,0,-33
10962,0,0,17,0,-17
10963,1,0,59,0,-59
10964,0,0,87,0,-87
10965,1,1,90,1897,1807
10966,1,0,116,0,-116
10967,1,1,481,2425,1944
10968,1,1,356,1310,954
10969,0,0,90,0,-90
10970,1,0,0,0,0
10971,0,0,65,0,-65
10972,0,0,35,0,-35
10973,0,0,56,0,-56
10974,1,1,18,1306,1288
10975,1,0,2,0,-2
10976,1,1,74,1679,1605
10977,1,1,846,2290,1444
10978,0,0,31,0,-31
10979,0,0,78,0,-78
10980,1,0,160,0,-160
10981,0,0,18,0,-18
10982,1,0,26,0,-26
10983,1,0,3,0,-3
10984,0,0,7,0,-7
10985,1,0,57,0,-57
10986,0,0,51,0,-51
10987,0,0,28,0,-28
10988,0,0,96,0,-96
10989,0,0,76,0,-76
10990,1,0,41,0,-41
10991,1,0,127,0,-127
10992,1,0,29,0,-29
10993,1,0,52,0,-52
10994,0,0,43,0,-43
10995,0,0,58,0,-58
10996,1,1,119,1831,1712
10997,1,1,98,1309,1211
10998,0,0,67,0,-67
10999,1,1,454,1469,1015
11000,1,0,64,0,-64
11001,0,0,95,0,-95
11002,1,1,120,1273,1153
11003,0,0,108,0,-108
11004,1,0,37,0,-37
11005,1,1,648,1780,1132
11006,1,0,68,0,-68
11007,0,0,49,0,-49
11008,1,1,476,1487,1011
11009,0,0,54,0,-54
11010,0,0,25,0,-25
11011,1,1,137,1927,1790
11012,1,0,10,0,-10
11013,1,0,21,0,-21
11014,1,1,132,1468,1336
11015,0,0,20,0,-20
11016,0,0,136,0,-136
11017,1,1,136,1209,1073
11018,1,1,159,1540,1381
11019,0,0,77,0,-77
11020,1,1,244,1514,1270
11021,1,1,108,2015,1907
11022,0,0,11,0,-11
11023,1,0,140,0,-140
11024,1,1,444,1476,1032
11025,1,1,790,1314,524
11026,1,0,72,0,-72
11027,1,0,7,0,-7
11028,1,1,1105,1281,176
11029,0,0,32,0,-32
11030,1,0,12,0,-12
11031,1,1,299,1389,1090
11032,1,0,29,0,-29
11033,1,1,192,2638,2446
11034,1,1,629,1782,1153
11035,0,0,133,0,-133
11036,1,1,202,1344,1142
11037,0,0,3,0,-3
11038,1,1,81,1203,1122
11039,1,0,7,0,-7
11040,1,0,30,0,-30
11041,1,0,28,0,-28
11042,0,0,34,0,-34
11043,1,0,7,0,-7
11044,1,0,16,0,-16
11045,1,1,805,1295,490
11046,1,0,76,0,-76
11047,0,0,55,0,-55
11048,1,0,17,0,-17
11049,0,0,48,0,-48
11050,0,0,10,0,-10
11051,1,1,241,1383,1142
11052,0,0,41,0,-41
11053,0,0,82,0,-82
11054,1,0,118,0,-118
11055,0,0,124,0,-124
11056,1,0,121,0,-121
11057,1,0,267,0,-267
11058,1,0,110,0,-110
11059,1,1,2483,1258,-1225
11060,1,1,1175,1469,294
11061,1,0,4,0,-4
11062,1,1,37,1397,1360
11063,1,0,11,0,-11
11064,1,1,1056,1300,244
11065,0,0,67,0,-67
11066,0,0,6,0,-6
11067,1,1,1086,1280,194
11068,1,0,13,0,-13
11069,0,0,52,0,-52
11070,1,1,61,1590,1529
11071,1,0,122,0,-122
11072,0,0,260,0,-260
11073,1,0,21,0,-21
11074,0,0,278,0,-278
11075,0,0,70,0,-70
11076,1,0,35,0,-35
11077,1,1,94,1346,1252
11078,0,0,112,0,-112
11079,1,1,161,1220,1059
11080,0,0,19,0,-19
11081,1,0,21,0,-21
11082,1,0,152,0,-152
11083,1,1,507,1280,773
11084,0,0,3,0,-3
11085,0,0,3,0,-3
11086,1,0,3,0,-3
11087,0,0,43,0,-43
11088,1,0,94,0,-94
11089,1,0,104,0,-104
11090,1,1,439,1283,844
11091,1,0,30,0,-30
11092,0,0,29,0,-29
11093,1,0,10,0,-10
11094,1,1,335,1249,914
11095,0,0,49,0,-49
11096,0,0,56,0,-56
11097,0,0,24,0,-24
11098,1,0,7,0,-7
11099,1,1,829,1346,517
11100,1,1,918,1928,1010
11101,1,1,303,1218,915
11102,0,0,11,0,-11
11103,1,0,25,0,-25
11104,1,1,356,1328,972
11105,0,0,39,0,-39
11106,0,0,13,0,-13
11107,1,0,160,0,-160
11108,0,0,1,0,-1
11109,1,0,19,0,-19
11110,0,0,55,0,-55
11111,1,0,47,0,-47
11112,1,1,411,3064,2653
11113,1,1,1112,1468,356
11114,0,0,16,0,-16
11115,1,0,70,0,-70
11116,0,0,24,0,-24
11117,1,0,40,0,-40
11118,0,0,4,0,-4
11119,1,0,42,0,-42
11120,1,0,1,0,-1
11121,1,1,180,1394,1214
11122,1,1,1590,1287,-303
11123,1,0,36,0,-36
11124,1,0,62,0,-62
11125,0,0,38,0,-38
11126,1,1,439,1231,792
11127,0,0,6,0,-6
11128,1,0,40,0,-40
11129,1,1,117,1275,1158
11130,1,0,49,0,-49
11131,1,0,29,0,-29
11132,1,1,1455,1218,-237
11133,1,0,15,0,-15
11134,1,0,9,0,-9
11135,0,0,32,0,-32
11136,1,1,22,1459,1437
11137,0,0,38,0,-38
11138,1,0,2,0,-2
11139,1,1,1242,1318,76
11140,1,1,443,1221,778
11141,0,0,21,0,-21
11142,1,1,1300,1511,211
11143,1,0,128,0,-128
11144,1,1,1316,2060,744
11145,1,1,753,1362,609
11146,1,1,231,1436,1205
11147,1,0,26,0,-26
11148,1,1,789,1310,521
11149,1,0,88,0,-88
11150,1,0,82,0,-82
11151,1,0,43,0,-43
11152,1,0,48,0,-48
11153,0,0,5,0,-5
11154,1,1,1281,1321,40
11155,0,0,70,0,-70
11156,1,0,26,0,-26
11157,0,0,28,0,-28
11158,1,1,285,1393,1108
11159,0,0,33,0,-33
11160,0,0,35,0,-35
11161,1,1,284,1422,1138
11162,1,1,768,1522,754
11163,1,1,106,1555,1449
11164,0,0,90,0,-90
11165,0,0,76,0,-76
11166,0,0,6,0,-6
11167,0,0,3,0,-3
11168,1,1,803,1314,511
11169,0,0,23,0,-23
11170,1,1,621,1324,703
11171,1,1,354,1226,872
11172,1,0,11,0,-11
11173,1,1,285,1303,1018
11174,0,0,130,0,-130
11175,0,0,13,0,-13
11176,0,0,2,0,-2
11177,0,0,32,0,-32
11178,1,0,26,0,-26
11179,1,0,10,0,-10
11180,1,0,41,0,-41
11181,0,0,70,0,-70
11182,1,1,143,1337,1194
11183,1,1,258,1465,1207
11184,1,0,202,0,-202
11185,1,1,574,1223,649
11186,0,0,84,0,-84
11187,1,0,112,0,-112
11188,1,1,865,1630,765
11189,0,0,2,0,-2
11190,1,1,140,1362,1222
11191,1,1,362,1711,1349
11192,1,0,102,0,-102
11193,1,1,585,1379,794
11194,1,0,22,0,-22
11195,1,0,27,0,-27
11196,1,0,55,0,-55
11197,1,1,557,1457,900
11198,1,0,1,0,-1
11199,0,0,74,0,-74
11200,1,1,387,1439,1052
11201,1,0,3,0,-3
11202,0,0,172,0,-172
11203,1,0,63,0,-63
11204,1,0,73,0,-73
11205,1,1,420,1403,983
11206,1,1,51,1308,1257
11207,0,0,14,0,-14
11208,0,0,15,0,-15
11209,1,0,26,0,-26
11210,1,0,77,0,-77
11211,1,1,299,1212,913
11212,1,1,1426,1320,-106
11213,1,0,111,0,-111
11214,1,1,1826,1323,-503
11215,1,0,85,0,-85
11216,1,1,130,1296,1166
11217,1,0,43,0,-43
11218,0,0,11,0,-11
11219,1,1,1430,1728,298
11220,1,0,6,0,-6
11221,1,1,847,1329,482
11222,1,1,1521,1779,258
11223,0,0,14,0,-14
11224,0,0,10,0,-10
11225,1,1,151,1404,1253
11226,1,0,119,0,-119
11227,1,1,403,1393,990
11228,1,0,23,0,-23
11229,1,0,5,0,-5
11230,0,0,41,0,-41
11231,0,0,111,0,-111
11232,1,1,476,1211,735
11233,1,1,65,1479,1414
11234,1,1,63,3037,2974
11235,1,1,135,1824,1689
11236,1,1,126,2511,2385
11237,1,1,1059,1371,312
11238,0,0,105,0,-105
11239,1,1,206,1379,1173
11240,0,0,21,0,-21
11241,1,1,876,1293,417
11242,1,0,2,0,-2
11243,1,1,1431,1542,111
11244,0,0,134,0,-134
11245,1,1,564,1518,954
11246,1,0,52,0,-52
11247,0,0,26,0,-26
11248,0,0,64,0,-64
11249,1,1,450,1935,1485
11250,1,1,180,1312,1132
11251,1,0,1,0,-1
11252,0,0,71,0,-71
11253,1,0,129,0,-129
11254,0,0,58,0,-58
11255,0,0,12,0,-12
11256,0,0,10,0,-10
11257,1,1,312,1486,1174
11258,1,0,59,0,-59
11259,1,0,77,0,-77
11260,1,0,153,0,-153
11261,1,1,419,1252,833
11262,0,0,2,0,-2
11263,1,0,132,0,-132
11264,1,1,1114,1722,608
11265,1,1,65,1499,1434
11266,1,0,2,0,-2
11267,0,0,55,0,-55
11268,1,1,975,1866,891
11269,1,0,1,0,-1
11270,0,0,24,0,-24
11271,1,0,22,0,-22
11272,1,0,3,0,-3
11273,0,0,61,0,-61
11274,1,0,52,0,-52
11275,1,1,567,2582,2015
11276,0,0,4,0,-4
11277,1,1,675,1393,718
11278,0,0,59,0,-59
11279,1,0,34,0,-34
11280,0,0,36,0,-36
11281,0,0,51,0,-51
11282,1,0,13,0,-13
11283,1,1,142,1309,1167
11284,0,0,164,0,-164
11285,1,1,1851,2044,193
11286,1,0,29,0,-29
11287,0,0,14,0,-14
11288,0,0,27,0,-27
11289,1,0,6,0,-6
11290,1,0,210,0,-210
11291,0,0,8,0,-8
11292,1,1,559,1261,702
11293,1,1,599,1890,1291
11294,1,1,991,1411,420
11295,1,1,1009,1919,910
11296,0,0,12,0,-12
11297,0,0,46,0,-46
11298,1,0,44,0,-44
11299,1,1,2104,1348,-756
11300,1,0,104,0,-104
11301,1,1,334,1911,1577
11302,1,1,525,1909,1384
11303,0,0,38,0,-38
11304,0,0,53,0,-53
11305,1,1,125,1289,1164
11306,0,0,66,0,-66
11307,0,0,18,0,-18
11308,0,0,13,0,-13
11309,0,0,68,0,-68
11310,1,1,2111,1287,-824
11311,0,0,118,0,-118
11312,1,0,37,0,-37
11313,0,0,9,0,-9
11314,1,1,469,1651,1182
11315,0,0,87,0,-87
11316,0,0,28,0,-28
11317,0,0,48,0,-48
11318,1,0,13,0,-13
11319,1,1,987,1294,307
11320,0,0,81,0,-81
11321,1,1,1367,1484,117
11322,1,0,1,0,-1
11323,1,0,8,0,-8
11324,0,0,48,0,-48
11325,0,0,1,0,-1
11326,0,0,3,0,-3
11327,0,0,10,0,-10
11328,1,0,7,0,-7
11329,1,1,225,1276,1051
11330,1,0,37,0,-37
11331,0,0,5,0,-5
11332,1,0,48,0,-48
11333,0,0,33,0,-33
11334,1,0,0,0,0
11335,1,0,50,0,-50
11336,0,0,24,0,-24
11337,0,0,73,0,-73
11338,0,0,3,0,-3
11339,1,1,223,2060,1837
11340,0,0,64,0,-64
11341,0,0,8,0,-8
11342,1,1,535,1977,1442
11343,1,1,371,2419,2048
11344,1,1,192,2020,1828
11345,0,0,70,0,-70
11346,1,1,723,1228,505
11347,1,1,205,1560,1355
11348,0,0,86,0,-86
11349,1,0,6,0,-6
11350,0,0,23,0,-23
11351,1,0,0,0,0
11352,0,0,72,0,-72
11353,0,0,5,0,-5
11354,1,0,125,0,-125
11355,0,0,32,0,-32
11356,1,1,324,1607,1283
11357,1,1,644,2415,1771
11358,1,0,72,0,-72
11359,1,0,31,0,-31
11360,0,0,169,0,-169
11361,1,0,54,0,-54
11362,0,0,9,0,-9
11363,1,0,96,0,-96
11364,0,0,65,0,-65
11365,1,0,5,0,-5
11366,1,0,30,0,-30
11367,0,0,13,0,-13
11368,1,1,191,1269,1078
11369,1,1,244,1330,1086
11370,1,1,470,1393,923
11371,0,0,27,0,-27
11372,1,1,1136,1313,177
11373,1,1,499,1523,1024
11374,0,0,18,0,-18
11375,0,0,32,0,-32
11376,1,1,63,1349,1286
11377,0,0,67,0,-67
11378,1,1,879,1231,352
11379,1,0,25,0,-25
11380,0,0,13,0,-13
11381,1,1,204,1345,1141
11382,1,1,672,1253,581
11383,1,0,50,0,-50
11384,0,0,6,0,-6
11385,1,1,581,1812,1231
11386,0,0,6,0,-6
11387,0,0,20,0,-20
11388,1,1,599,1355,756
11389,1,1,125,1735,1610
11390,1,0,1,0,-1
11391,1,0,83,0,-83
11392,1,1,423,1730,1307
11393,1,0,37,0,-37
11394,1,0,18,0,-18
11395,1,1,696,1374,678
11396,0,0,32,0,-32
11397,1,0,0,0,0
11398,1,0,13,0,-13
11399,0,0,73,0,-73
11400,1,0,39,0,-39
11401,1,1,100,1721,1621
11402,1,1,329,3132,2803
11403,0,0,71,0,-71
11404,1,1,723,2802,2079
11405,0,0,10,0,-10
11406,1,0,93,0,-93
11407,0,0,18,0,-18
11408,0,0,21,0,-21
11409,1,0,2,0,-2
11410,0,0,26,0,-26
11411,0,0,5,0,-5
11412,1,1,835,1625,790
11413,1,0,67,0,-67
11414,0,0,31,0,-31
11415,1,1,102,1444,1342
11416,1,0,59,0,-59
11417,0,0,82,0,-82
11418,0,0,9,0,-9
11419,1,1,65,1329,1264
11420,1,0,96,0,-96
11421,1,0,49,0,-49
11422,1,1,776,1434,658
11423,0,0,23,0,-23
11424,1,1,148,1400,1252
11425,1,0,65,0,-65
11426,1,0,39,0,-39
11427,1,1,628,2019,1391
11428,1,0,19,0,-19
11429,0,0,21,0,-21
11430,1,1,982,1250,268
11431,0,0,21,0,-21
11432,1,0,46,0,-46
11433,1,0,77,0,-77
11434,0,0,19,0,-19
11435,0,0,0,0,0
11436,1,0,61,0,-61
11437,1,0,0,0,0
11438,1,0,38,0,-38
11439,0,0,36,0,-36
11440,1,0,66,0,-66
11441,0,0,0,0,0
11442,0,0,13,0,-13
11443,1,0,60,0,-60
11444,0,0,28,0,-28
11445,1,1,729,1266,537
11446,0,0,13,0,-13
11447,1,1,109,1674,1565
11448,1,0,25,0,-25
11449,1,1,307,1368,1061
11450,1,0,18,0,-18
11451,1,0,43,0,-43
11452,1,0,8,0,-8
11453,1,0,4,0,-4
11454,1,0,6,0,-6
11455,1,0,24,0,-24
11456,1,1,328,4781,4453
11457,0,0,5,0,-5
11458,1,0,58,0,-58
11459,1,1,27,1520,1493
11460,1,0,7,0,-7
11461,1,1,366,1620,1254
11462,1,1,438,1336,898
11463,0,0,126,0,-126
11464,0,0,68,0,-68
11465,1,1,376,1204,828
11466,1,0,64,0,-64
11467,1,1,422,1264,842
11468,1,0,34,0,-34
11469,0,0,51,0,-51
11470,0,0,25,0,-25
11471,0,0,18,0,-18
11472,1,0,90,0,-90
11473,0,0,12,0,-12
11474,1,1,117,1774,1657
11475,0,0,27,0,-27
11476,0,0,17,0,-17
11477,1,0,27,0,-27
11478,1,1,1085,1499,414
11479,0,0,3,0,-3
11480,1,1,1555,1460,-95
11481,0,0,44,0,-44
11482,1,1,131,1731,1600
11483,0,0,5,0,-5
11484,0,0,212,0,-212
11485,1,1,233,1301,1068
11486,1,0,48,0,-48
11487,1,0,44,0,-44
11488,1,1,152,1542,1390
11489,0,0,46,0,-46
11490,0,0,17,0,-17
11491,1,0,89,0,-89
11492,1,0,82,0,-82
11493,1,1,436,1338,902
11494,0,0,16,0,-16
11495,1,0,28,0,-28
11496,0,0,64,0,-64
11497,0,0,151,0,-151
11498,1,0,16,0,-16
11499,1,0,163,0,-163
11500,1,0,39,0,-39
11501,0,0,13,0,-13
11502,1,0,8,0,-8
11503,0,0,91,0,-91
11504,0,0,195,0,-195
11505,1,0,8,0,-8
11506,1,0,51,0,-51
11507,1,1,411,1260,849
11508,0,0,88,0,-88
11509,0,0,93,0,-93
11510,1,0,81,0,-81
11511,0,0,17,0,-17
11512,0,0,33,0,-33
11513,0,0,9,0,-9
11514,0,0,50,0,-50
11515,0,0,84,0,-84
11516,0,0,15,0,-15
11517,1,1,15,1293,1278
11518,1,0,29,0,-29
11519,1,1,415,1396,981
11520,0,0,24,0,-24
11521,1,1,127,1306,1179
11522,0,0,25,0,-25
11523,1,0,129,0,-129
11524,1,1,264,1259,995
11525,0,0,45,0,-45
11526,0,0,46,0,-46
11527,1,1,524,1502,978
11528,1,1,2481,1377,-1104
11529,0,0,7,0,-7
11530,1,0,119,0,-119
11531,0,0,52,0,-52
11532,1,0,37,0,-37
11533,0,0,21,0,-21
11534,0,0,2,0,-2
11535,0,0,54,0,-54
11536,0,0,20,0,-20
11537,1,0,23,0,-23
11538,1,1,828,1505,677
11539,0,0,137,0,-137
11540,0,0,2,0,-2
11541,1,1,156,2290,2134
11542,0,0,4,0,-4
11543,1,0,1,0,-1
11544,1,1,78,1454,1376
11545,0,0,53,0,-53
11546,0,0,50,0,-50
11547,0,0,13,0,-13
11548,1,1,179,1658,1479
11549,1,0,19,0,-19
11550,0,0,138,0,-138
11551,1,0,64,0,-64
11552,1,0,99,0,-99
11553,0,0,121,0,-121
11554,1,0,4,0,-4
11555,1,1,1057,1970,913
11556,1,0,27,0,-27
11557,1,0,43,0,-43
11558,1,1,126,1951,1825
11559,1,0,64,0,-64
11560,0,0,98,0,-98
11561,0,0,45,0,-45
11562,0,0,40,0,-40
11563,1,0,50,0,-50
11564,0,0,51,0,-51
11565,1,0,38,0,-38
11566,1,1,230,1259,1029
11567,0,0,33,0,-33
11568,1,0,107,0,-107
11569,0,0,280,0,-280
11570,1,0,13,0,-13
11571,0,0,2,0,-2
11572,1,0,28,0,-28
11573,1,0,10,0,-10
11574,0,0,81,0,-81
11575,0,0,35,0,-35
11576,0,0,56,0,-56
11577,0,0,51,0,-51
11578,1,0,98,0,-98
11579,1,0,9,0,-9
11580,1,1,517,1674,1157
11581,1,0,27,0,-27
11582,0,0,178,0,-178
11583,1,1,335,1908,1573
11584,0,0,72,0,-72
11585,0,0,53,0,-53
11586,1,1,1660,1246,-414
11587,0,0,66,0,-66
11588,1,0,86,0,-86
11589,1,1,246,1302,1056
11590,1,0,39,0,-39
11591,0,0,26,0,-26
11592,0,0,22,0,-22
11593,1,0,65,0,-65
11594,1,0,1,0,-1
11595,0,0,43,0,-43
11596,1,0,2,0,-2
11597,0,0,3,0,-3
11598,1,1,106,1238,1132
11599,1,1,273,1423,1150
11600,0,0,25,0,-25
11601,1,1,175,1401,1226
11602,0,0,7,0,-7
11603,0,0,3,0,-3
11604,1,1,1645,1427,-218
11605,0,0,11,0,-11
11606,1,0,1,0,-1
11607,0,0,4,0,-4
11608,1,0,2,0,-2
11609,1,0,3,0,-3
11610,1,0,53,0,-53
11611,1,1,170,1275,1105
11612,1,1,149,1248,1099
11613,1,1,162,1630,1468
11614,1,1,433,1494,1061
11615,0,0,15,0,-15
11616,0,0,50,0,-50
11617,1,0,28,0,-28
11618,0,0,36,0,-36
11619,0,0,125,0,-125
11620,1,0,9,0,-9
11621,1,0,56,0,-56
11622,1,1,244,1501,1257
11623,1,1,454,1292,838
11624,1,0,54,0,-54
11625,1,0,63,0,-63
11626,1,0,30,0,-30
11627,1,0,27,0,-27
11628,1,0,4,0,-4
11629,0,0,29,0,-29
11630,1,1,157,1398,1241
11631,1,0,81,0,-81
11632,0,0,90,0,-90
11633,1,0,59,0,-59
11634,1,1,191,1374,1183
11635,0,0,7,0,-7
11636,1,0,4,0,-4
11637,1,1,221,1381,1160
11638,0,0,24,0,-24
11639,0,0,8,0,-8
11640,1,0,44,0,-44
11641,1,0,7,0,-7
11642,0,0,38,0,-38
11643,0,0,13,0,-13
11644,1,0,40,0,-40
11645,0,0,30,0,-30
11646,1,1,255,2051,1796
11647,1,1,415,1699,1284
11648,1,1,532,1425,893
11649,1,0,9,0,-9
11650,0,0,0,0,0
11651,1,1,360,1277,917
11652,1,0,25,0,-25
11653,1,1,40,1254,1214
11654,1,1,718,1213,495
11655,1,1,156,2964,2808
11656,0,0,5,0,-5
11657,1,0,27,0,-27
11658,1,0,17,0,-17
11659,0,0,21,0,-21
11660,0,0,66,0,-66
11661,0,0,65,0,-65
11662,1,1,630,1393,763
11663,1,0,21,0,-21
11664,1,1,1005,1319,314
11665,0,0,17,0,-17
11666,0,0,44,0,-44
11667,1,0,92,0,-92
11668,1,1,1957,1372,-585
11669,1,1,1120,1355,235
11670,0,0,80,0,-80
11671,0,0,14,0,-14
11672,1,0,12,0,-12
11673,1,1,398,1572,1174
11674,1,1,127,1251,1124
11675,1,1,673,1490,817
11676,0,0,9,0,-9
11677,1,0,157,0,-157
11678,0,0,22,0,-22
11679,1,0,18,0,-18
11680,1,1,454,1228,774
11681,1,1,1475,1291,-184
11682,0,0,7,0,-7
11683,1,1,657,1517,860
11684,0,0,33,0,-33
11685,1,1,1310,1735,425
11686,1,1,466,1704,1238
11687,1,1,1233,1311,78
11688,1,0,213,0,-213
11689,1,0,49,0,-49
11690,1,1,579,1300,721
11691,1,0,145,0,-145
11692,1,0,119,0,-119
11693,0,0,15,0,-15
11694,1,1,204,1969,1765
11695,0,0,11,0,-11
11696,1,0,2,0,-2
11697,1,0,4,0,-4
11698,1,0,383,0,-383
11699,0,0,20,0,-20
11700,1,1,169,1383,1214
11701,1,0,18,0,-18
11702,1,0,40,0,-40
11703,0,0,42,0,-42
11704,0,0,50,0,-50
11705,0,0,4,0,-4
11706,1,1,508,1353,845
11707,0,0,58,0,-58
11708,1,1,557,1426,869
11709,0,0,36,0,-36
11710,1,1,885,1248,363
11711,1,0,12,0,-12
11712,1,0,75,0,-75
11713,1,1,185,1307,1122
11714,0,0,60,0,-60
11715,0,0,42,0,-42
11716,1,1,365,2470,2105
11717,1,0,28,0,-28
11718,1,1,275,1312,1037
11719,0,0,28,0,-28
11720,1,0,45,0,-45
11721,1,0,32,0,-32
11722,1,1,115,1593,1478
11723,0,0,29,0,-29
11724,1,1,782,1235,453
11725,1,0,21,0,-21
11726,0,0,34,0,-34
11727,0,0,52,0,-52
11728,0,0,26,0,-26
11729,1,0,5,0,-5
11730,0,0,25,0,-25
11731,0,0,20,0,-20
11732,0,0,135,0,-135
11733,1,1,103,1529,1426
11734,0,0,9,0,-9
11735,1,0,86,0,-86
11736,1,1,125,1491,1366
11737,0,0,147,0,-147
11738,1,1,11,2276,2265
11739,0,0,170,0,-170
11740,0,0,16,0,-16
11741,1,0,6,0,-6
11742,1,0,9,0,-9
11743,1,0,75,0,-75
11744,0,0,35,0,-35
11745,0,0,25,0,-25
11746,0,0,11,0,-11
11747,1,1,54,1350,1296
11748,1,1,428,1285,857
11749,1,0,6,0,-6
11750,1,1,368,2207,1839
11751,0,0,87,0,-87
11752,1,1,1532,1203,-329
11753,0,0,14,0,-14
11754,1,1,644,1228,584
11755,0,0,46,0,-46
11756,1,0,12,0,-12
11757,0,0,77,0,-77
11758,1,1,1057,2591,1534
11759,1,1,522,1354,832
11760,1,1,270,1821,1551
11761,1,0,19,0,-19
11762,1,0,15,0,-15
11763,1,0,49,0,-49
11764,0,0,13,0,-13
11765,1,1,726,1300,574
11766,0,0,26,0,-26
11767,1,1,902,1263,361
11768,0,0,6,0,-6
11769,1,0,125,0,-125
11770,0,0,71,0,-71
11771,1,0,0,0,0
11772,1,0,26,0,-26
11773,1,0,7,0,-7
11774,0,0,23,0,-23
11775,0,0,73,0,-73
11776,0,0,169,0,-169
11777,1,1,234,2002,1768
11778,1,1,305,1277,972
11779,1,1,64,1288,1224
11780,0,0,97,0,-97
11781,0,0,110,0,-110
11782,0,0,115,0,-115
11783,0,0,105,0,-105
11784,1,1,145,1297,1152
11785,0,0,1,0,-1
11786,1,1,385,1314,929
11787,1,1,1206,1511,305
11788,0,0,35,0,-35
11789,0,0,19,0,-19
11790,1,1,963,1265,302
11791,1,1,72,1309,1237
11792,0,0,76,0,-76
11793,1,0,8,0,-8
11794,0,0,20,0,-20
11795,1,1,64,1631,1567
11796,0,0,87,0,-87
11797,1,1,807,1355,548
11798,1,0,150,0,-150
11799,1,1,34,1243,1209
11800,1,0,69,0,-69
11801,0,0,3,0,-3
11802,1,0,55,0,-55
11803,1,0,37,0,-37
11804,0,0,55,0,-55
11805,1,1,597,1535,938
11806,1,0,65,0,-65
11807,1,1,543,1270,727
11808,1,0,82,0,-82
11809,1,0,73,0,-73
11810,0,0,37,0,-37
11811,1,0,12,0,-12
11812,1,0,35,0,-35
11813,1,1,293,1789,1496
11814,1,0,19,0,-19
11815,1,0,6,0,-6
11816,0,0,111,0,-111
11817,0,0,38,0,-38
11818,1,1,800,1336,536
11819,0,0,42,0,-42
11820,1,1,400,1810,1410
11821,0,0,1,0,-1
11822,0,0,2,0,-2
11823,1,1,576,1252,676
11824,1,0,23,0,-23
11825,1,0,35,0,-35
11826,0,0,35,0,-35
11827,0,0,50,0,-50
11828,0,0,0,0,0
11829,1,0,50,0,-50
11830,0,0,63,0,-63
11831,1,0,28,0,-28
11832,0,0,103,0,-103
11833,0,0,72,0,-72
11834,0,0,116,0,-116
11835,1,1,154,1989,1835
11836,0,0,7,0,-7
11837,0,0,32,0,-32
11838,1,1,148,1305,1157
11839,1,0,35,0,-35
11840,1,0,159,0,-159
11841,1,1,520,1502,982
11842,0,0,3,0,-3
11843,1,1,76,1493,1417
11844,0,0,30,0,-30
11845,0,0,2,0,-2
11846,1,0,21,0,-21
11847,1,1,533,1780,1247
11848,1,1,437,1505,1068
11849,0,0,50,0,-50
11850,1,1,1192,1498,306
11851,0,0,15,0,-15
11852,0,0,7,0,-7
11853,1,0,64,0,-64
11854,0,0,26,0,-26
11855,1,0,21,0,-21
11856,1,0,53,0,-53
11857,1,1,257,2094,1837
11858,0,0,45,0,-45
11859,1,0,24,0,-24
11860,0,0,31,0,-31
11861,0,0,17,0,-17
11862,1,0,68,0,-68
11863,0,0,10,0,-10
11864,0,0,31,0,-31
11865,0,0,43,0,-43
11866,1,1,124,1695,1571
11867,0,0,50,0,-50
11868,1,1,282,1200,918
11869,1,1,227,2479,2252
11870,0,0,2,0,-2
11871,1,0,20,0,-20
11872,0,0,55,0,-55
11873,1,0,188,0,-188
11874,1,1,287,1463,1176
11875,0,0,84,0,-84
11876,1,0,6,0,-6
11877,1,1,881,1688,807
11878,1,1,622,1466,844
11879,1,0,36,0,-36
11880,0,0,154,0,-154
11881,1,0,35,0,-35
11882,1,0,1,0,-1
11883,1,0,21,0,-21
11884,0,0,40,0,-40
11885,1,0,1,0,-1
11886,0,0,33,0,-33
11887,1,1,610,1621,1011
11888,0,0,18,0,-18
11889,1,0,6,0,-6
11890,0,0,23,0,-23
11891,1,0,10,0,-10
11892,0,0,18,0,-18
11893,1,1,560,1477,917
11894,0,0,18,0,-18
11895,1,1,211,1319,1108
11896,0,0,17,0,-17
11897,1,1,1172,1444,272
11898,0,0,48,0,-48
11899,1,0,26,0,-26
11900,1,0,73,0,-73
11901,1,1,975,1688,713
11902,1,0,19,0,-19
11903,0,0,78,0,-78
11904,1,0,37,0,-37
11905,1,0,90,0,-90
11906,0,0,142,0,-142
11907,0,0,21,0,-21
11908,0,0,12,0,-12
11909,1,0,39,0,-39
11910,1,0,7,0,-7
11911,1,1,694,1309,615
11912,1,0,10,0,-10
11913,0,0,33,0,-33
11914,0,0,11,0,-11
11915,0,0,91,0,-91
11916,1,0,88,0,-88
11917,1,0,23,0,-23
11918,0,0,48,0,-48
11919,1,0,5,0,-5
11920,0,0,6,0,-6
11921,1,0,55,0,-55
11922,1,1,208,1337,1129
11923,1,1,196,1309,1113
11924,1,0,59,0,-59
11925,1,1,239,1288,1049
11926,1,1,942,3714,2772
11927,0,0,16,0,-16
11928,1,1,72,1468,1396
11929,0,0,95,0,-95
11930,1,1,2149,1792,-357
11931,0,0,13,0,-13
11932,0,0,28,0,-28
11933,1,0,0,0,0
11934,1,1,81,1444,1363
11935,1,1,109,1453,1344
11936,1,0,302,0,-302
11937,1,1,191,1329,1138
11938,1,0,15,0,-15
11939,0,0,24,0,-24
11940,1,1,125,1468,1343
11941,1,1,630,1273,643
11942,1,0,13,0,-13
11943,1,1,84,1519,1435
11944,0,0,101,0,-101
11945,0,0,41,0,-41
11946,0,0,19,0,-19
11947,0,0,17,0,-17
11948,1,0,151,0,-151
11949,1,1,228,1354,1126
11950,1,1,86,1407,1321
11951,0,0,91,0,-91
11952,0,0,8,0,-8
11953,1,0,139,0,-139
11954,1,1,241,1427,1186
11955,1,1,157,1465,1308
11956,0,0,11,0,-11
11957,1,1,117,2135,2018
11958,1,0,11,0,-11
11959,0,0,37,0,-37
11960,0,0,105,0,-105
11961,0,0,2,0,-2
11962,0,0,56,0,-56
11963,0,0,4,0,-4
11964,1,1,546,1219,673
11965,0,0,73,0,-73
11966,1,0,6,0,-6
11967,1,1,65,1465,1400
11968,0,0,233,0,-233
11969,0,0,49,0,-49
11970,0,0,165,0,-165
11971,1,0,22,0,-22
11972,1,1,340,1230,890
11973,1,1,174,1534,1360
11974,1,0,57,0,-57
11975,1,1,434,1784,1350
11976,1,1,76,4906,4830
11977,0,0,179,0,-179
11978,1,0,23,0,-23
11979,1,0,15,0,-15
11980,1,1,162,1398,1236
11981,1,0,1,0,-1
11982,1,1,453,1310,857
11983,0,0,114,0,-114
11984,1,0,28,0,-28
11985,0,0,236,0,-236
11986,0,0,32,0,-32
11987,0,0,13,0,-13
11988,1,1,526,1571,1045
11989,0,0,26,0,-26
11990,1,1,1130,1490,360
11991,1,1,416,1424,1008
11992,1,1,325,1416,1091
11993,1,1,270,1817,1547
11994,0,0,15,0,-15
11995,0,0,112,0,-112
11996,0,0,15,0,-15
11997,1,1,3166,3338,172
11998,1,0,26,0,-26
11999,0,0,22,0,-22
12000,0,0,20,0,-20
12001,0,0,6,0,-6
12002,1,1,288,1540,1252
12003,0,0,10,0,-10
12004,0,0,181,0,-181
12005,0,0,66,0,-66
12006,1,0,5,0,-5
12007,1,1,1545,1874,329
12008,0,0,16,0,-16
12009,0,0,0,0,0
12010,0,0,2,0,-2
12011,0,0,12,0,-12
12012,1,1,740,2085,1345
12013,1,0,206,0,-206
12014,1,1,146,1232,1086
12015,0,0,127,0,-127
12016,1,1,121,1219,1098
12017,1,1,193,1597,1404
12018,0,0,35,0,-35
12019,1,0,96,0,-96
12020,1,0,11,0,-11
12021,0,0,11,0,-11
12022,1,1,1109,1304,195
12023,0,0,11,0,-11
12024,1,0,29,0,-29
12025,1,0,51,0,-51
12026,1,1,462,1236,774
12027,0,0,18,0,-18
12028,1,1,1299,1225,-74
12029,0,0,91,0,-91
12030,1,0,61,0,-61
12031,0,0,42,0,-42
12032,0,0,31,0,-31
12033,1,0,24,0,-24
12034,0,0,9,0,-9
12035,1,0,24,0,-24
12036,1,1,182,1397,1215
12037,0,0,38,0,-38
12038,0,0,18,0,-18
12039,1,0,58,0,-58
12040,1,1,805,1246,441
12041,0,0,14,0,-14
12042,0,0,158,0,-158
12043,1,1,101,1241,1140
12044,0,0,40,0,-40
12045,1,1,656,1243,587
12046,1,0,34,0,-34
12047,0,0,78,0,-78
12048,1,1,629,1323,694
12049,0,0,44,0,-44
12050,1,1,1019,1220,201
12051,0,0,28,0,-28
12052,1,0,27,0,-27
12053,1,0,5,0,-5
12054,1,0,29,0,-29
12055,1,1,165,1217,1052
12056,0,0,37,0,-37
12057,1,1,925,1365,440
12058,0,0,100,0,-100
12059,1,0,49,0,-49
12060,1,1,270,1224,954
12061,0,0,7,0,-7
12062,1,0,10,0,-10
12063,0,0,11,0,-11
12064,1,0,119,0,-119
12065,1,0,49,0,-49
12066,0,0,5,0,-5
12067,0,0,16,0,-16
12068,1,0,107,0,-107
12069,0,0,4,0,-4
12070,0,0,73,0,-73
12071,0,0,22,0,-22
12072,1,0,30,0,-30
12073,1,0,22,0,-22
12074,1,0,22,0,-22
12075,1,0,26,0,-26
12076,1,0,4,0,-4
12077,0,0,1,0,-1
12078,0,0,40,0,-40
12079,1,0,55,0,-55
12080,0,0,42,0,-42
12081,1,1,448,1326,878
12082,1,1,338,1578,1240
12083,1,1,677,1352,675
12084,0,0,15,0,-15
12085,1,1,198,2911,2713
12086,1,1,158,1388,1230
12087,0,0,27,0,-27
12088,1,1,185,1204,1019
12089,1,0,23,0,-23
12090,1,0,69,0,-69
12091,1,0,17,0,-17
12092,1,1,802,1309,507
12093,1,1,709,1200,491
12094,0,0,55,0,-55
12095,1,0,235,0,-235
12096,0,0,30,0,-30
12097,1,0,104,0,-104
12098,0,0,16,0,-16
12099,1,0,35,0,-35
12100,1,1,240,1778,1538
12101,1,0,122,0,-122
12102,0,0,31,0,-31
12103,1,1,791,1310,519
12104,0,0,42,0,-42
12105,1,1,200,1738,1538
12106,0,0,14,0,-14
12107,1,1,123,1694,1571
12108,0,0,63,0,-63
12109,1,0,206,0,-206
12110,1,1,229,1992,1763
12111,1,1,313,1916,1603
12112,1,1,264,1255,991
12113,1,1,102,1564,1462
12114,0,0,12,0,-12
12115,1,1,1538,1793,255
12116,1,0,23,0,-23
12117,0,0,85,0,-85
12118,0,0,7,0,-7
12119,1,1,123,1434,1311
12120,1,0,36,0,-36
12121,0,0,29,0,-29
12122,0,0,101,0,-101
12123,0,0,9,0,-9
12124,1,0,29,0,-29
12125,1,0,2,0,-2
12126,1,0,31,0,-31
12127,1,1,37,1377,1340
12128,1,1,1008,1314,306
12129,0,0,71,0,-71
12130,1,0,26,0,-26
12131,0,0,269,0,-269
12132,1,1,266,1721,1455
12133,0,0,10,0,-10
12134,0,0,14,0,-14
12135,0,0,24,0,-24
12136,1,1,846,1375,529
12137,0,0,64,0,-64
12138,1,0,17,0,-17
12139,1,1,561,1469,908
12140,0,0,25,0,-25
12141,1,0,130,0,-130
12142,1,0,16,0,-16
12143,1,1,578,1294,716
12144,1,1,605,1246,641
12145,0,0,7,0,-7
12146,0,0,0,0,0
12147,0,0,71,0,-71
12148,1,1,139,1772,1633
12149,0,0,67,0,-67
12150,1,1,1328,1234,-94
12151,0,0,36,0,-36
12152,1,0,136,0,-136
12153,0,0,241,0,-241
12154,1,1,413,1547,1134
12155,1,0,96,0,-96
12156,0,0,16,0,-16
12157,1,1,51,1374,1323
12158,0,0,8,0,-8
12159,0,0,38,0,-38
12160,0,0,14,0,-14
12161,0,0,60,0,-60
12162,1,1,1713,1219,-494
12163,1,1,54,1584,1530
12164,0,0,58,0,-58
12165,1,1,978,1277,299
12166,1,1,899,1238,339
12167,1,0,345,0,-345
12168,1,1,873,1291,418
12169,1,0,25,0,-25
12170,1,1,663,1585,922
12171,1,1,56,2423,2367
12172,1,0,23,0,-23
12173,1,1,504,1455,951
12174,1,0,37,0,-37
12175,0,0,65,0,-65
12176,0,0,11,0,-11
12177,1,1,45,1550,1505
12178,0,0,5,0,-5
12179,1,0,20,0,-20
12180,1,0,2,0,-2
12181,0,0,108,0,-108
12182,1,0,13,0,-13
12183,1,1,1393,1304,-89
12184,0,0,13,0,-13
12185,1,0,108,0,-108
12186,0,0,14,0,-14
12187,0,0,92,0,-92
12188,0,0,11,0,-11
12189,1,0,18,0,-18
12190,0,0,33,0,-33
12191,0,0,23,0,-23
12192,0,0,7,0,-7
12193,1,1,871,1374,503
12194,0,0,67,0,-67
12195,1,0,13,0,-13
12196,1,0,285,0,-285
12197,1,0,88,0,-88
12198,0,0,35,0,-35
12199,1,0,4,0,-4
12200,0,0,88,0,-88
12201,1,0,23,0,-23
12202,1,1,573,1239,666
12203,1,1,11,1527,1516
12204,1,0,26,0,-26
12205,1,0,28,0,-28
12206,0,0,103,0,-103
12207,0,0,121,0,-121
12208,1,0,1,0,-1
12209,1,0,17,0,-17
12210,1,0,11,0,-11
12211,1,1,17,1976,1959
12212,0,0,267,0,-267
12213,1,1,281,1443,1162
12214,0,0,9,0,-9
12215,0,0,55,0,-55
12216,1,0,59,0,-59
12217,0,0,13,0,-13
12218,0,0,31,0,-31
12219,0,0,1,0,-1
12220,1,0,32,0,-32
12221,1,0,71,0,-71
12222,1,1,298,1737,1439
12223,1,0,9,0,-9
12224,1,0,3,0,-3
12225,1,1,397,1670,1273
12226,1,0,41,0,-41
12227,1,0,107,0,-107
12228,0,0,67,0,-67
12229,0,0,17,0,-17
12230,1,1,883,1599,716
12231,1,1,1568,2071,503
12232,1,0,57,0,-57
12233,1,1,255,1368,1113
12234,1,0,27,0,-27
12235,0,0,23,0,-23
12236,0,0,27,0,-27
12237,0,0,132,0,-132
12238,0,0,63,0,-63
12239,0,0,11,0,-11
12240,0,0,1,0,-1
12241,1,1,570,1395,825
12242,1,1,694,1980,1286
12243,1,0,86,0,-86
12244,1,0,43,0,-43
12245,1,0,0,0,0
12246,1,1,285,1202,917
12247,0,0,33,0,-33
12248,0,0,5,0,-5
12249,1,0,4,0,-4
12250,1,1,232,1649,1417
12251,0,0,64,0,-64
12252,1,0,161,0,-161
12253,1,1,591,1235,644
12254,0,0,77,0,-77
12255,1,1,1110,1466,356
12256,0,0,196,0,-196
12257,0,0,24,0,-24
12258,1,1,949,1256,307
12259,0,0,102,0,-102
12260,1,1,50,1458,1408
12261,1,0,74,0,-74
12262,0,0,44,0,-44
12263,0,0,12,0,-12
12264,0,0,15,0,-15
12265,1,1,256,1231,975
12266,0,0,10,0,-10
12267,0,0,1,0,-1
12268,0,0,84,0,-84
12269,1,1,475,1754,1279
12270,1,0,31,0,-31
12271,1,1,134,1659,1525
12272,1,1,449,1366,917
12273,1,0,7,0,-7
12274,1,1,145,1271,1126
12275,0,0,8,0,-8
12276,0,0,1,0,-1
12277,1,1,190,1976,1786
12278,0,0,11,0,-11
12279,0,0,14,0,-14
12280,0,0,27,0,-27
12281,0,0,100,0,-100
12282,1,0,51,0,-51
12283,1,1,126,1743,1617
12284,1,0,63,0,-63
12285,0,0,20,0,-20
12286,1,0,21,0,-21
12287,0,0,11,0,-11
12288,1,1,398,1727,1329
12289,0,0,40,0,-40
12290,0,0,19,0,-19
12291,0,0,68,0,-68
12292,0,0,156,0,-156
12293,1,1,161,1263,1102
12294,1,1,254,1216,962
12295,1,0,62,0,-62
12296,1,1,704,1442,738
12297,1,0,59,0,-59
12298,1,1,481,1472,991
12299,0,0,64,0,-64
12300,1,1,619,1249,630
12301,1,0,27,0,-27
12302,1,1,812,1898,1086
12303,1,1,556,1337,781
12304,1,1,1148,1809,661
12305,1,0,44,0,-44
12306,0,0,21,0,-21
12307,0,0,42,0,-42
12308,1,0,15,0,-15
12309,1,0,40,0,-40
12310,0,0,34,0,-34
12311,1,0,2,0,-2
12312,1,0,14,0,-14
12313,0,0,47,0,-47
12314,1,0,26,0,-26
12315,1,1,864,1502,638
12316,0,0,93,0,-93
12317,1,1,410,1471,1061
12318,1,1,125,1230,1105
12319,0,0,61,0,-61
12320,1,0,2,0,-2
12321,0,0,2,0,-2
12322,1,0,26,0,-26
12323,0,0,15,0,-15
12324,0,0,20,0,-20
12325,0,0,9,0,-9
12326,1,0,14,0,-14
12327,0,0,39,0,-39
12328,0,0,52,0,-52
12329,1,0,25,0,-25
12330,1,0,4,0,-4
12331,1,1,482,1263,781
12332,0,0,93,0,-93
12333,0,0,9,0,-9
12334,1,1,445,1534,1089
12335,1,0,5,0,-5
12336,1,1,188,1411,1223
12337,1,1,632,1394,762
12338,1,1,236,1970,1734
12339,1,1,819,1541,722
12340,1,1,1267,1212,-55
12341,1,0,46,0,-46
12342,0,0,9,0,-9
12343,0,0,74,0,-74
12344,0,0,138,0,-138
12345,1,1,871,1330,459
12346,0,0,32,0,-32
12347,1,1,551,1201,650
12348,1,0,7,0,-7
12349,1,1,575,1309,734
12350,1,1,54,4151,4097
12351,1,0,29,0,-29
12352,1,1,946,1709,763
12353,1,0,112,0,-112
12354,1,0,75,0,-75
12355,1,1,103,1343,1240
12356,1,0,5,0,-5
12357,0,0,54,0,-54
12358,1,1,1302,1256,-46
12359,0,0,104,0,-104
12360,1,1,146,1213,1067
12361,1,1,913,1291,378
12362,0,0,364,0,-364
12363,1,1,617,1510,893
12364,1,1,117,1397,1280
12365,0,0,148,0,-148
12366,1,1,1239,1232,-7
12367,0,0,204,0,-204
12368,0,0,160,0,-160
12369,1,1,969,1336,367
12370,0,0,2,0,-2
12371,1,1,302,1312,1010
12372,1,1,1663,1273,-390
12373,1,0,22,0,-22
12374,1,0,3,0,-3
12375,1,1,841,1306,465
12376,1,1,575,1515,940
12377,1,1,754,1576,822
12378,1,0,30,0,-30
12379,1,0,105,0,-105
12380,1,1,22,1356,1334
12381,0,0,12,0,-12
12382,0,0,11,0,-11
12383,0,0,58,0,-58
12384,0,0,29,0,-29
12385,0,0,3,0,-3
12386,1,1,624,1288,664
12387,1,0,45,0,-45
12388,1,0,25,0,-25
12389,1,1,520,1304,784
12390,0,0,19,0,-19
12391,1,0,58,0,-58
12392,0,0,8,0,-8
12393,1,1,169,1416,1247
12394,0,0,80,0,-80
12395,0,0,7,0,-7
12396,1,1,351,1224,873
12397,1,0,61,0,-61
12398,0,0,23,0,-23
12399,0,0,109,0,-109
12400,1,0,36,0,-36
12401,1,0,25,0,-25
12402,1,0,31,0,-31
12403,1,0,125,0,-125
12404,0,0,41,0,-41
12405,1,0,30,0,-30
12406,1,1,1540,1910,370
12407,1,0,41,0,-41
12408,1,1,175,1217,1042
12409,1,0,136,0,-136
12410,0,0,50,0,-50
12411,1,0,173,0,-173
12412,0,0,20,0,-20
12413,0,0,160,0,-160
12414,0,0,17,0,-17
12415,1,1,1948,1666,-282
12416,1,1,48,1321,1273
12417,0,0,35,0,-35
12418,1,0,356,0,-356
12419,0,0,23,0,-23
12420,0,0,29,0,-29
12421,1,0,103,0,-103
12422,1,0,10,0,-10
12423,1,1,349,2706,2357
12424,1,1,1313,1334,21
12425,1,0,56,0,-56
12426,1,0,5,0,-5
12427,1,0,21,0,-21
12428,1,1,209,2319,2110
12429,1,0,22,0,-22
12430,1,0,24,0,-24
12431,1,1,127,1323,1196
12432,1,0,27,0,-27
12433,0,0,33,0,-33
12434,0,0,67,0,-67
12435,0,0,5,0,-5
12436,1,1,434,1273,839
12437,1,0,10,0,-10
12438,0,0,53,0,-53
12439,0,0,4,0,-4
12440,0,0,186,0,-186
12441,0,0,14,0,-14
12442,1,1,696,1230,534
12443,1,0,20,0,-20
12444,0,0,15,0,-15
12445,1,1,550,1412,862
12446,1,0,4,0,-4
12447,0,0,16,0,-16
12448,1,1,801,2009,1208
12449,1,1,1097,1211,114
12450,1,1,540,1264,724
12451,0,0,127,0,-127
12452,1,1,800,1442,642
12453,0,0,34,0,-34
12454,1,1,973,1231,258
12455,0,0,21,0,-21
12456,1,0,1,0,-1
12457,0,0,21,0,-21
12458,0,0,157,0,-157
12459,1,0,21,0,-21
12460,0,0,22,0,-22
12461,0,0,5,0,-5
12462,1,1,125,1372,1247
12463,0,0,17,0,-17
12464,1,0,158,0,-158
12465,0,0,24,0,-24
12466,0,0,65,0,-65
12467,0,0,26,0,-26
12468,1,0,85,0,-85
12469,1,0,27,0,-27
12470,0,0,59,0,-59
12471,0,0,16,0,-16
12472,1,0,8,0,-8
12473,0,0,8,0,-8
12474,0,0,128,0,-128
12475,0,0,28,0,-28
12476,1,0,4,0,-4
12477,1,0,8,0,-8
12478,0,0,33,0,-33
12479,1,0,82,0,-82
12480,0,0,5,0,-5
12481,1,0,27,0,-27
12482,1,1,570,1254,684
12483,0,0,22,0,-22
12484,1,1,715,1386,671
12485,0,0,289,0,-289
12486,1,1,495,1210,715
12487,0,0,25,0,-25
12488,0,0,44,0,-44
12489,1,0,90,0,-90
12490,1,1,174,2192,2018
12491,1,0,35,0,-35
12492,0,0,16,0,-16
12493,1,0,0,0,0
12494,1,1,760,1376,616
12495,1,0,105,0,-105
12496,1,0,72,0,-72
12497,0,0,35,0,-35
12498,1,0,37,0,-37
12499,1,1,1208,1367,159
12500,1,0,69,0,-69
12501,0,0,125,0,-125
12502,1,1,113,1437,1324
12503,1,0,65,0,-65
12504,1,1,483,2707,2224
12505,0,0,37,0,-37
12506,1,0,68,0,-68
12507,0,0,46,0,-46
12508,1,0,0,0,0
12509,0,0,97,0,-97
12510,0,0,82,0,-82
12511,0,0,28,0,-28
12512,1,0,28,0,-28
12513,1,1,464,1223,759
12514,1,0,108,0,-108
12515,1,1,156,2293,2137
12516,0,0,39,0,-39
12517,0,0,43,0,-43
12518,0,0,5,0,-5
12519,0,0,18,0,-18
12520,0,0,72,0,-72
12521,1,1,160,1237,1077
12522,0,0,110,0,-110
12523,1,0,50,0,-50
12524,1,0,115,0,-115
12525,0,0,13,0,-13
12526,0,0,26,0,-26
12527,0,0,36,0,-36
12528,1,0,53,0,-53
12529,1,1,278,1211,933
12530,0,0,36,0,-36
12531,0,0,43,0,-43
12532,0,0,29,0,-29
12533,1,0,0,0,0
12534,0,0,2,0,-2
12535,1,0,60,0,-60
12536,1,0,81,0,-81
12537,1,0,35,0,-35
12538,0,0,15,0,-15
12539,1,1,542,1247,705
12540,0,0,41,0,-41
12541,0,0,1,0,-1
12542,1,0,75,0,-75
12543,0,0,104,0,-104
12544,1,0,0,0,0
12545,1,1,207,1581,1374
12546,0,0,43,0,-43
12547,0,0,83,0,-83
12548,0,0,27,0,-27
12549,1,1,1094,1279,185
12550,1,0,35,0,-35
12551,1,1,703,1758,1055
12552,1,1,117,2745,2628
12553,0,0,22,0,-22
12554,0,0,12,0,-12
12555,0,0,3,0,-3
12556,1,1,488,1672,1184
12557,1,0,45,0,-45
12558,0,0,123,0,-123
12559,1,1,324,1421,1097
12560,1,1,273,1582,1309
12561,1,0,2,0,-2
12562,1,0,29,0,-29
12563,1,0,1,0,-1
12564,0,0,27,0,-27
12565,0,0,109,0,-109
12566,0,0,3,0,-3
12567,0,0,22,0,-22
12568,1,0,82,0,-82
12569,0,0,43,0,-43
12570,1,0,60,0,-60
12571,0,0,30,0,-30
12572,1,0,26,0,-26
12573,0,0,89,0,-89
12574,1,1,666,1294,628
12575,1,0,32,0,-32
12576,1,0,239,0,-239
12577,1,1,666,1357,691
12578,1,1,334,1445,1111
12579,0,0,30,0,-30
12580,1,1,590,1648,1058
12581,1,0,20,0,-20
12582,1,1,318,1672,1354
12583,0,0,18,0,-18
12584,1,0,4,0,-4
12585,0,0,5,0,-5
12586,1,1,265,2342,2077
12587,0,0,69,0,-69
12588,1,1,310,1406,1096
12589,0,0,24,0,-24
12590,1,1,458,1698,1240
12591,1,0,49,0,-49
12592,0,0,28,0,-28
12593,0,0,11,0,-11
12594,1,0,1,0,-1
12595,1,1,504,1923,1419
12596,0,0,30,0,-30
12597,1,1,683,1283,600
12598,1,0,42,0,-42
12599,1,1,1175,1267,92
12600,1,0,123,0,-123
12601,0,0,9,0,-9
12602,1,0,43,0,-43
12603,0,0,53,0,-53
12604,0,0,89,0,-89
12605,0,0,6,0,-6
12606,1,0,6,0,-6
12607,0,0,79,0,-79
12608,1,1,204,2185,1981
12609,0,0,152,0,-152
12610,0,0,60,0,-60
12611,1,0,24,0,-24
12612,0,0,54,0,-54
12613,0,0,17,0,-17
12614,1,0,53,0,-53
12615,1,0,27,0,-27
12616,1,0,25,0,-25
12617,1,1,65,1227,1162
12618,1,0,16,0,-16
12619,1,1,640,1339,699
12620,0,0,22,0,-22
12621,0,0,53,0,-53
12622,1,1,331,2193,1862
12623,1,1,147,1406,1259
12624,1,1,508,1320,812
12625,1,0,10,0,-10
12626,0,0,153,0,-153
12627,0,0,41,0,-41
12628,1,1,241,1539,1298
12629,1,0,11,0,-11
12630,1,1,245,2559,2314
12631,1,0,47,0,-47
12632,0,0,92,0,-92
12633,1,0,49,0,-49
12634,1,1,1119,1666,547
12635,1,0,53,0,-53
12636,1,0,63,0,-63
12637,1,0,91,0,-91
12638,1,0,5,0,-5
12639,0,0,1,0,-1
12640,0,0,27,0,-27
12641,0,0,15,0,-15
12642,1,1,965,1378,413
12643,1,0,4,0,-4
12644,1,0,34,0,-34
12645,0,0,26,0,-26
12646,0,0,16,0,-16
12647,0,0,46,0,-46
12648,1,1,234,1255,1021
12649,0,0,235,0,-235
12650,1,0,72,0,-72
12651,1,1,219,1538,1319
12652,1,1,815,2773,1958
12653,1,0,42,0,-42
12654,1,1,455,1222,767
12655,1,0,30,0,-30
12656,1,0,102,0,-102
12657,1,1,1507,1377,-130
12658,1,1,419,1215,796
12659,1,1,505,1610,1105
12660,1,1,628,1237,609
12661,0,0,66,0,-66
12662,1,1,463,1382,919
12663,0,0,48,0,-48
12664,1,0,131,0,-131
12665,1,1,109,1468,1359
12666,0,0,1,0,-1
12667,0,0,39,0,-39
12668,0,0,100,0,-100
12669,1,0,70,0,-70
12670,0,0,17,0,-17
12671,0,0,129,0,-129
12672,0,0,105,0,-105
12673,0,0,63,0,-63
12674,1,0,392,0,-392
12675,1,0,1,0,-1
12676,0,0,46,0,-46
12677,0,0,121,0,-121
12678,1,1,37,1625,1588
12679,0,0,10,0,-10
12680,1,0,155,0,-155
12681,1,1,461,1360,899
12682,1,1,1013,1457,444
12683,0,0,45,0,-45
12684,1,0,5,0,-5
12685,0,0,13,0,-13
12686,0,0,73,0,-73
12687,0,0,0,0,0
12688,1,0,13,0,-13
12689,1,1,1475,1611,136
12690,0,0,48,0,-48
12691,0,0,19,0,-19
12692,1,0,21,0,-21
12693,1,1,1338,1296,-42
12694,1,0,95,0,-95
12695,1,1,907,1258,351
12696,0,0,84,0,-84
12697,1,1,770,1289,519
12698,1,0,0,0,0
12699,1,1,125,2806,2681
12700,1,0,7,0,-7
12701,0,0,0,0,0
12702,1,0,31,0,-31
12703,1,0,15,0,-15
12704,1,1,326,1383,1057
12705,1,1,660,1367,707
12706,0,0,54,0,-54
12707,1,1,979,1675,696
12708,1,0,23,0,-23
12709,1,0,64,0,-64
12710,0,0,14,0,-14
12711,0,0,103,0,-103
12712,1,1,530,1308,778
12713,1,0,18,0,-18
12714,1,1,107,1692,1585
12715,1,1,169,1713,1544
12716,1,0,87,0,-87
12717,0,0,0,0,0
12718,1,0,70,0,-70
12719,1,1,500,1321,821
12720,1,0,4,0,-4
12721,1,1,220,1316,1096
12722,0,0,195,0,-195
12723,0,0,37,0,-37
12724,1,1,2196,1228,-968
12725,0,0,5,0,-5
12726,1,1,905,1570,665
12727,0,0,46,0,-46
12728,1,0,119,0,-119
12729,1,0,4,0,-4
12730,1,0,7,0,-7
12731,0,0,22,0,-22
12732,0,0,81,0,-81
12733,0,0,76,0,-76
12734,1,0,28,0,-28
12735,1,1,1069,1260,191
12736,1,0,89,0,-89
12737,0,0,100,0,-100
12738,1,0,35,0,-35
12739,1,1,682,2647,1965
12740,1,1,961,1351,390
12741,1,0,36,0,-36
12742,1,0,14,0,-14
12743,0,0,119,0,-119
12744,0,0,28,0,-28
12745,0,0,45,0,-45
12746,0,0,23,0,-23
12747,1,1,529,1309,780
12748,1,0,10,0,-10
12749,1,1,1624,3721,2097
12750,1,1,1181,1704,523
12751,1,0,66,0,-66
12752,1,1,66,3172,3106
12753,1,0,13,0,-13
12754,1,1,940,1268,328
12755,1,0,40,0,-40
12756,1,0,52,0,-52
12757,0,0,8,0,-8
12758,1,1,485,2049,1564
12759,0,0,19,0,-19
12760,1,1,1731,1337,-394
12761,0,0,23,0,-23
12762,0,0,1,0,-1
12763,0,0,36,0,-36
12764,1,1,57,1443,1386
12765,1,1,269,1398,1129
12766,0,0,29,0,-29
12767,1,0,46,0,-46
12768,1,0,10,0,-10
12769,0,0,47,0,-47
12770,0,0,13,0,-13
12771,1,0,8,0,-8
12772,0,0,60,0,-60
12773,1,1,21,1232,1211
12774,1,1,469,1386,917
12775,1,1,88,1631,1543
12776,1,0,67,0,-67
12777,1,1,958,1209,251
12778,1,1,78,1221,1143
12779,1,0,35,0,-35
12780,0,0,40,0,-40
12781,1,1,659,1585,926
12782,0,0,11,0,-11
12783,1,1,89,2363,2274
12784,1,1,211,1260,1049
12785,0,0,1,0,-1
12786,1,1,1007,1449,442
12787,1,0,12,0,-12
12788,0,0,73,0,-73
12789,0,0,63,0,-63
12790,1,0,30,0,-30
12791,0,0,56,0,-56
12792,1,0,213,0,-213
12793,0,0,46,0,-46
12794,1,1,128,1384,1256
12795,0,0,48,0,-48
12796,1,1,697,1486,789
12797,1,1,1903,1695,-208
12798,1,1,283,2254,1971
12799,0,0,131,0,-131
12800,1,0,35,0,-35
12801,1,1,466,1252,786
12802,1,0,45,0,-45
12803,1,0,18,0,-18
12804,0,0,14,0,-14
12805,1,0,1,0,-1
12806,0,0,15,0,-15
12807,0,0,23,0,-23
12808,0,0,12,0,-12
12809,0,0,89,0,-89
12810,1,1,479,1228,749
12811,0,0,11,0,-11
12812,1,1,891,1270,379
12813,0,0,70,0,-70
12814,1,0,24,0,-24
12815,1,1,121,1312,1191
12816,1,1,259,1345,1086
12817,1,1,123,2900,2777
12818,0,0,58,0,-58
12819,0,0,65,0,-65
12820,0,0,106,0,-106
12821,0,0,8,0,-8
12822,0,0,42,0,-42
12823,1,0,128,0,-128
12824,1,1,667,1293,626
12825,1,0,22,0,-22
12826,1,0,9,0,-9
12827,1,1,445,1473,1028
12828,1,1,942,1297,355
12829,1,0,63,0,-63
12830,1,0,27,0,-27
12831,0,0,27,0,-27
12832,0,0,138,0,-138
12833,1,0,48,0,-48
12834,1,1,1249,2476,1227
12835,1,1,670,1612,942
12836,1,0,9,0,-9
12837,1,1,192,1215,1023
12838,0,0,21,0,-21
12839,0,0,74,0,-74
12840,0,0,6,0,-6
12841,0,0,79,0,-79
12842,0,0,1,0,-1
12843,1,0,25,0,-25
12844,1,1,459,1584,1125
12845,1,1,347,1314,967
12846,0,0,29,0,-29
12847,1,0,110,0,-110
12848,1,0,48,0,-48
12849,1,0,15,0,-15
12850,0,0,100,0,-100
12851,1,0,18,0,-18
12852,1,1,1877,1465,-412
12853,1,0,52,0,-52
12854,1,1,294,1270,976
12855,1,1,423,1287,864
12856,1,1,757,1654,897
12857,0,0,48,0,-48
12858,1,0,12,0,-12
12859,1,1,1071,1323,252
12860,1,0,74,0,-74
12861,0,0,14,0,-14
12862,0,0,145,0,-145
12863,0,0,70,0,-70
12864,1,0,22,0,-22
12865,1,1,298,1260,962
12866,1,1,769,1488,719
12867,1,1,30,1292,1262
12868,0,0,27,0,-27
12869,1,1,199,1477,1278
12870,0,0,13,0,-13
12871,0,0,16,0,-16
12872,1,0,48,0,-48
12873,0,0,16,0,-16
12874,0,0,77,0,-77
12875,1,1,350,2447,2097
12876,1,0,14,0,-14
12877,1,1,379,1720,1341
12878,1,1,364,1293,929
12879,0,0,42,0,-42
12880,1,1,1116,1979,863
12881,1,1,631,1934,1303
12882,1,1,296,1213,917
12883,1,0,59,0,-59
12884,0,0,55,0,-55
12885,0,0,39,0,-39
12886,1,0,60,0,-60
12887,0,0,36,0,-36
12888,1,0,40,0,-40
12889,1,0,74,0,-74
12890,1,1,1515,1408,-107
12891,0,0,60,0,-60
12892,0,0,121,0,-121
12893,0,0,114,0,-114
12894,1,0,2,0,-2
12895,1,0,13,0,-13
12896,1,1,160,1497,1337
12897,0,0,64,0,-64
12898,1,1,861,2262,1401
12899,1,1,656,1522,866
12900,1,1,358,1516,1158
12901,1,1,270,1692,1422
12902,1,0,116,0,-116
12903,1,1,341,1250,909
12904,0,0,12,0,-12
12905,1,1,1471,1432,-39
12906,1,0,25,0,-25
12907,0,0,10,0,-10
12908,0,0,25,0,-25
12909,1,0,25,0,-25
12910,0,0,66,0,-66
12911,1,1,520,1868,1348
12912,1,0,8,0,-8
12913,1,1,192,1212,1020
12914,1,0,16,0,-16
12915,0,0,111,0,-111
12916,1,0,59,0,-59
12917,1,0,131,0,-131
12918,0,0,18,0,-18
12919,0,0,63,0,-63
12920,1,0,29,0,-29
12921,1,0,22,0,-22
12922,1,1,1597,1218,-379
12923,0,0,92,0,-92
12924,1,1,173,1218,1045
12925,1,1,405,1465,1060
12926,1,0,14,0,-14
12927,1,1,170,1202,1032
12928,1,1,413,1304,891
12929,1,1,602,1211,609
12930,1,1,634,1328,694
12931,1,1,842,1213,371
12932,0,0,14,0,-14
12933,0,0,36,0,-36
12934,1,0,19,0,-19
12935,1,1,232,2069,1837
12936,0,0,10,0,-10
12937,0,0,181,0,-181
12938,1,1,1178,1343,165
12939,1,0,70,0,-70
12940,1,0,7,0,-7
12941,1,0,67,0,-67
12942,0,0,70,0,-70
12943,1,1,154,2910,2756
12944,1,1,724,1495,771
12945,0,0,47,0,-47
12946,1,1,49,1574,1525
12947,1,1,292,1644,1352
12948,0,0,101,0,-101
12949,1,0,13,0,-13
12950,1,1,68,2374,2306
12951,0,0,11,0,-11
12952,1,1,65,3510,3445
12953,0,0,18,0,-18
12954,0,0,22,0,-22
12955,0,0,20,0,-20
12956,0,0,14,0,-14
12957,0,0,123,0,-123
12958,0,0,89,0,-89
12959,1,1,1696,1343,-353
12960,0,0,21,0,-21
12961,0,0,74,0,-74
12962,0,0,106,0,-106
12963,0,0,41,0,-41
12964,0,0,74,0,-74
12965,0,0,28,0,-28
12966,1,1,198,1236,1038
12967,0,0,58,0,-58
12968,0,0,60,0,-60
12969,1,0,193,0,-193
12970,1,0,134,0,-134
12971,1,1,273,1429,1156
12972,1,1,116,1339,1223
12973,0,0,22,0,-22
12974,1,0,69,0,-69
12975,1,1,468,1687,1219
12976,1,0,94,0,-94
12977,0,0,18,0,-18
12978,1,0,6,0,-6
12979,1,0,46,0,-46
12980,1,1,477,1220,743
12981,0,0,41,0,-41
12982,0,0,6,0,-6
12983,1,0,40,0,-40
12984,0,0,22,0,-22
12985,1,0,114,0,-114
12986,0,0,41,0,-41
12987,1,0,29,0,-29
12988,1,0,72,0,-72
12989,1,0,35,0,-35
12990,0,0,31,0,-31
12991,0,0,76,0,-76
12992,1,1,585,1626,1041
12993,0,0,7,0,-7
12994,1,0,38,0,-38
12995,1,0,16,0,-16
12996,0,0,1,0,-1
12997,0,0,17,0,-17
12998,1,0,203,0,-203
12999,1,1,1029,1792,763
13000,0,0,13,0,-13
13001,1,0,1,0,-1
13002,0,0,280,0,-280
13003,0,0,39,0,-39
13004,0,0,19,0,-19
13005,0,0,89,0,-89
13006,1,0,69,0,-69
13007,1,1,220,1270,1050
13008,0,0,50,0,-50
13009,1,0,18,0,-18
13010,0,0,9,0,-9
13011,0,0,50,0,-50
13012,0,0,23,0,-23
13013,1,1,216,1783,1567
13014,1,0,3,0,-3
13015,1,0,37,0,-37
13016,1,1,445,1601,1156
13017,1,1,259,1451,1192
13018,1,1,895,1433,538
13019,1,0,185,0,-185
13020,0,0,17,0,-17
13021,0,0,159,0,-159
13022,1,0,6,0,-6
13023,1,1,268,2139,1871
13024,1,0,28,0,-28
13025,1,0,46,0,-46
13026,1,1,396,1238,842
13027,1,1,295,1216,921
13028,0,0,5,0,-5
13029,1,0,1,0,-1
13030,1,1,1179,1342,163
13031,1,1,222,1472,1250
13032,1,1,335,1336,1001
13033,1,1,173,1216,1043
13034,1,1,377,2249,1872
13035,0,0,85,0,-85
13036,1,0,76,0,-76
13037,0,0,19,0,-19
13038,1,1,717,1993,1276
13039,1,1,991,1655,664
13040,1,0,84,0,-84
13041,1,0,29,0,-29
13042,1,1,399,1250,851
13043,1,1,164,1472,1308
13044,0,0,85,0,-85
13045,0,0,16,0,-16
13046,1,0,134,0,-134
13047,0,0,12,0,-12
13048,1,1,305,1300,995
13049,0,0,59,0,-59
13050,1,0,41,0,-41
13051,1,0,16,0,-16
13052,0,0,73,0,-73
13053,1,0,172,0,-172
13054,0,0,3,0,-3
13055,0,0,101,0,-101
13056,1,1,606,1336,730
13057,1,1,1331,2271,940
13058,1,0,25,0,-25
13059,0,0,17,0,-17
13060,1,1,413,1211,798
13061,0,0,27,0,-27
13062,1,1,246,1231,985
13063,1,1,473,1800,1327
13064,1,0,7,0,-7
13065,0,0,75,0,-75
13066,0,0,19,0,-19
13067,1,0,65,0,-65
13068,0,0,29,0,-29
13069,0,0,39,0,-39
13070,0,0,188,0,-188
13071,1,1,636,1526,890
13072,1,1,462,1481,1019
13073,0,0,54,0,-54
13074,0,0,90,0,-90
13075,1,1,30,1741,1711
13076,1,0,9,0,-9
13077,0,0,52,0,-52
13078,1,1,112,3136,3024
13079,0,0,67,0,-67
13080,0,0,9,0,-9
13081,1,1,934,1619,685
13082,0,0,96,0,-96
13083,1,0,28,0,-28
13084,0,0,184,0,-184
13085,1,1,45,1387,1342
13086,0,0,5,0,-5
13087,1,0,27,0,-27
13088,1,0,93,0,-93
13089,0,0,65,0,-65
13090,1,1,283,2072,1789
13091,1,0,40,0,-40
13092,0,0,138,0,-138
13093,0,0,19,0,-19
13094,0,0,1,0,-1
13095,0,0,0,0,0
13096,0,0,8,0,-8
13097,1,0,5,0,-5
13098,1,0,22,0,-22
13099,1,0,20,0,-20
13100,1,1,43,1891,1848
13101,1,0,7,0,-7
13102,0,0,8,0,-8
13103,0,0,159,0,-159
13104,0,0,106,0,-106
13105,0,0,34,0,-34
13106,0,0,33,0,-33
13107,1,0,45,0,-45
13108,1,1,477,1206,729
13109,0,0,50,0,-50
13110,0,0,28,0,-28
13111,0,0,22,0,-22
13112,0,0,36,0,-36
13113,0,0,3,0,-3
13114,1,0,30,0,-30
13115,0,0,10,0,-10
13116,1,1,695,1843,1148
13117,0,0,10,0,-10
13118,1,0,122,0,-122
13119,0,0,76,0,-76
13120,0,0,65,0,-65
13121,1,0,8,0,-8
13122,0,0,33,0,-33
13123,1,1,699,2255,1556
13124,1,0,73,0,-73
13125,1,1,225,1289,1064
13126,1,0,39,0,-39
13127,0,0,140,0,-140
13128,1,1,1023,1217,194
13129,0,0,34,0,-34
13130,1,1,280,1807,1527
13131,1,1,482,1244,762
13132,0,0,51,0,-51
13133,0,0,3,0,-3
13134,0,0,27,0,-27
13135,1,0,85,0,-85
13136,0,0,61,0,-61
13137,1,1,114,2291,2177
13138,1,0,7,0,-7
13139,1,1,883,1759,876
13140,1,1,57,1825,1768
13141,1,0,61,0,-61
13142,0,0,43,0,-43
13143,0,0,20,0,-20
13144,1,0,130,0,-130
13145,0,0,4,0,-4
13146,1,1,140,2806,2666
13147,0,0,111,0,-111
13148,1,1,74,1359,1285
13149,0,0,6,0,-6
13150,0,0,83,0,-83
13151,1,0,49,0,-49
13152,1,1,3014,1320,-1694
13153,1,0,21,0,-21
13154,1,1,270,1237,967
13155,0,0,135,0,-135
13156,0,0,17,0,-17
13157,1,1,816,1338,522
13158,1,0,0,0,0
13159,1,1,457,1367,910
13160,1,0,4,0,-4
13161,0,0,4,0,-4
13162,1,1,61,1589,1528
13163,1,0,30,0,-30
13164,1,0,133,0,-133
13165,1,1,1012,1274,262
13166,1,0,93,0,-93
13167,1,0,2,0,-2
13168,0,0,24,0,-24
13169,0,0,17,0,-17
13170,1,1,439,2019,1580
13171,0,0,78,0,-78
13172,0,0,31,0,-31
13173,1,1,871,1295,424
13174,0,0,83,0,-83
13175,0,0,15,0,-15
13176,1,1,436,1268,832
13177,1,1,455,1453,998
13178,1,1,188,1310,1122
13179,1,0,71,0,-71
13180,0,0,4,0,-4
13181,1,0,13,0,-13
13182,1,0,19,0,-19
13183,1,0,61,0,-61
13184,0,0,7,0,-7
13185,1,1,426,1637,1211
13186,0,0,99,0,-99
13187,1,0,112,0,-112
13188,1,0,2,0,-2
13189,1,1,995,1572,577
13190,1,1,839,2401,1562
13191,0,0,231,0,-231
13192,1,0,184,0,-184
13193,1,0,24,0,-24
13194,1,0,90,0,-90
13195,0,0,95,0,-95
13196,0,0,100,0,-100
13197,0,0,111,0,-111
13198,1,0,54,0,-54
13199,1,0,1,0,-1
13200,0,0,82,0,-82
13201,1,1,1286,1311,25
13202,0,0,7,0,-7
13203,1,0,70,0,-70
13204,1,0,64,0,-64
13205,0,0,6,0,-6
13206,1,1,102,1261,1159
13207,0,0,71,0,-71
13208,0,0,69,0,-69
13209,1,0,42,0,-42
13210,1,0,26,0,-26
13211,0,0,3,0,-3
13212,1,0,85,0,-85
13213,1,0,15,0,-15
13214,1,0,41,0,-41
13215,0,0,85,0,-85
13216,1,0,6,0,-6
13217,1,0,26,0,-26
13218,1,0,39,0,-39
13219,0,0,121,0,-121
13220,1,1,345,1447,1102
13221,0,0,2,0,-2
13222,0,0,46,0,-46
13223,0,0,194,0,-194
13224,0,0,12,0,-12
13225,1,1,858,1778,920
13226,0,0,94,0,-94
13227,1,0,70,0,-70
13228,1,0,21,0,-21
13229,0,0,0,0,0
13230,1,0,61,0,-61
13231,0,0,36,0,-36
13232,1,1,801,1241,440
13233,1,1,1100,1651,551
13234,1,0,11,0,-11
13235,1,1,1506,1509,3
13236,0,0,40,0,-40
13237,1,1,566,1417,851
13238,0,0,23,0,-23
13239,0,0,138,0,-138
13240,0,0,40,0,-40
13241,0,0,100,0,-100
13242,0,0,87,0,-87
13243,1,1,210,1287,1077
13244,1,1,438,2043,1605
13245,1,1,262,1814,1552
13246,0,0,42,0,-42
13247,1,0,83,0,-83
13248,1,1,95,1595,1500
13249,1,1,264,1275,1011
13250,1,0,50,0,-50
13251,1,0,3,0,-3
13252,1,1,100,1401,1301
13253,1,0,47,0,-47
13254,0,0,47,0,-47
13255,1,1,1219,1667,448
13256,1,1,1098,2226,1128
13257,0,0,39,0,-39
13258,1,1,1538,1475,-63
13259,0,0,27,0,-27
13260,0,0,84,0,-84
13261,1,1,53,1516,1463
13262,0,0,102,0,-102
13263,1,1,527,1429,902
13264,1,0,238,0,-238
13265,0,0,43,0,-43
13266,0,0,24,0,-24
13267,1,0,11,0,-11
13268,0,0,42,0,-42
13269,1,1,152,1263,1111
13270,0,0,35,0,-35
13271,1,1,465,1262,797
13272,0,0,33,0,-33
13273,1,1,577,1373,796
13274,1,1,153,1465,1312
13275,1,0,19,0,-19
13276,1,1,396,1396,1000
13277,1,1,183,4430,4247
13278,0,0,28,0,-28
13279,0,0,5,0,-5
13280,0,0,76,0,-76
13281,0,0,67,0,-67
13282,1,1,757,1641,884
13283,1,0,23,0,-23
13284,1,1,132,1527,1395
13285,0,0,26,0,-26
13286,1,1,3815,1669,-2146
13287,1,1,730,2243,1513
13288,1,0,109,0,-109
13289,1,1,1067,1838,771
13290,1,0,13,0,-13
13291,1,0,51,0,-51
13292,1,1,317,1249,932
13293,1,1,853,1367,514
13294,1,1,696,1498,802
13295,1,1,515,1403,888
13296,1,1,597,2427,1830
13297,0,0,19,0,-19
13298,1,0,62,0,-62
13299,1,0,2,0,-2
13300,0,0,0,0,0
13301,0,0,130,0,-130
13302,1,1,575,1427,852
13303,1,1,659,2255,1596
13304,0,0,26,0,-26
13305,1,0,49,0,-49
13306,0,0,216,0,-216
13307,1,1,1224,1436,212
13308,1,0,24,0,-24
13309,1,1,582,1373,791
13310,0,0,74,0,-74
13311,0,0,27,0,-27
13312,1,1,389,1812,1423
13313,0,0,3,0,-3
13314,0,0,17,0,-17
13315,0,0,238,0,-238
13316,0,0,57,0,-57
13317,1,1,163,1414,1251
13318,1,1,1424,1540,116
13319,0,0,25,0,-25
13320,0,0,4,0,-4
13321,1,1,1278,1422,144
13322,0,0,141,0,-141
13323,1,1,965,1464,499
13324,0,0,0,0,0
13325,1,0,101,0,-101
13326,0,0,39,0,-39
13327,0,0,55,0,-55
13328,1,1,1288,1234,-54
13329,1,0,101,0,-101
13330,0,0,11,0,-11
13331,1,1,508,1304,796
13332,0,0,12,0,-12
13333,1,1,58,1375,1317
13334,1,0,3,0,-3
13335,0,0,41,0,-41
13336,1,1,782,1252,470
13337,0,0,103,0,-103
13338,1,1,207,1373,1166
13339,1,0,14,0,-14
13340,0,0,203,0,-203
13341,1,1,261,1464,1203
13342,1,0,107,0,-107
13343,0,0,6,0,-6
13344,0,0,11,0,-11
13345,1,0,138,0,-138
13346,0,0,27,0,-27
13347,0,0,32,0,-32
13348,1,1,249,1514,1265
13349,0,0,17,0,-17
13350,1,0,9,0,-9
13351,1,0,206,0,-206
13352,0,0,53,0,-53
13353,1,1,1627,1932,305
13354,0,0,107,0,-107
13355,1,1,319,2281,1962
13356,0,0,38,0,-38
13357,1,1,323,1277,954
13358,1,1,335,1240,905
13359,0,0,31,0,-31
13360,0,0,76,0,-76
13361,0,0,62,0,-62
13362,0,0,7,0,-7
13363,1,1,279,1319,1040
13364,1,1,82,1237,1155
13365,1,1,626,5266,4640
13366,0,0,123,0,-123
13367,1,1,373,1271,898
13368,1,1,376,1252,876
13369,1,0,82,0,-82
13370,1,1,77,1305,1228
13371,1,1,104,1413,1309
13372,0,0,0,0,0
13373,1,0,60,0,-60
13374,0,0,69,0,-69
13375,0,0,53,0,-53
13376,1,1,426,1653,1227
13377,0,0,20,0,-20
13378,0,0,7,0,-7
13379,0,0,98,0,-98
13380,1,0,52,0,-52
13381,1,1,60,1338,1278
13382,1,1,224,2116,1892
13383,0,0,2,0,-2
13384,0,0,16,0,-16
13385,1,0,20,0,-20
13386,1,0,49,0,-49
13387,0,0,22,0,-22
13388,1,0,60,0,-60
13389,1,1,211,1293,1082
13390,1,1,1088,1835,747
13391,0,0,11,0,-11
13392,0,0,82,0,-82
13393,0,0,49,0,-49
13394,1,1,2763,1220,-1543
13395,1,1,910,1380,470
13396,0,0,121,0,-121
13397,1,0,45,0,-45
13398,0,0,93,0,-93
13399,0,0,8,0,-8
13400,1,0,27,0,-27
13401,0,0,69,0,-69
13402,1,1,243,1216,973
13403,1,0,20,0,-20
13404,1,1,378,1556,1178
13405,0,0,38,0,-38
13406,0,0,10,0,-10
13407,1,1,404,1200,796
13408,1,0,9,0,-9
13409,0,0,55,0,-55
13410,0,0,49,0,-49
13411,0,0,8,0,-8
13412,0,0,62,0,-62
13413,1,1,798,1289,491
13414,1,0,7,0,-7
13415,1,0,64,0,-64
13416,0,0,34,0,-34
13417,1,1,593,1377,784
13418,1,0,20,0,-20
13419,0,0,42,0,-42
13420,0,0,17,0,-17
13421,0,0,3,0,-3
13422,0,0,12,0,-12
13423,1,1,101,2735,2634
13424,1,0,1,0,-1
13425,0,0,67,0,-67
13426,1,1,90,3084,2994
13427,0,0,24,0,-24
13428,0,0,7,0,-7
13429,1,1,155,1469,1314
13430,1,0,6,0,-6
13431,1,1,77,1285,1208
13432,1,1,92,1277,1185
13433,0,0,54,0,-54
13434,1,0,88,0,-88
13435,0,0,55,0,-55
13436,0,0,0,0,0
13437,1,1,491,1491,1000
13438,1,0,6,0,-6
13439,1,0,84,0,-84
13440,0,0,32,0,-32
13441,0,0,140,0,-140
13442,0,0,12,0,-12
13443,1,1,895,1251,356
13444,0,0,75,0,-75
13445,1,1,2151,2513,362
13446,0,0,9,0,-9
13447,1,0,56,0,-56
13448,0,0,97,0,-97
13449,1,0,8,0,-8
13450,1,0,11,0,-11
13451,0,0,103,0,-103
13452,0,0,139,0,-139
13453,1,0,0,0,0
13454,0,0,43,0,-43
13455,1,1,462,1331,869
13456,0,0,33,0,-33
13457,0,0,122,0,-122
13458,0,0,27,0,-27
13459,1,1,2202,1247,-955
13460,1,0,13,0,-13
13461,1,0,25,0,-25
13462,0,0,26,0,-26
13463,0,0,60,0,-60
13464,0,0,104,0,-104
13465,1,1,937,1432,495
13466,1,1,931,1282,351
13467,1,0,22,0,-22
13468,0,0,0,0,0
13469,1,1,137,1683,1546
13470,0,0,187,0,-187
13471,0,0,8,0,-8
13472,0,0,37,0,-37
13473,1,1,1365,1251,-114
13474,1,1,218,1290,1072
13475,1,0,27,0,-27
13476,1,1,525,1581,1056
13477,0,0,14,0,-14
13478,1,1,124,1522,1398
13479,1,0,111,0,-111
13480,1,1,922,1464,542
13481,0,0,3,0,-3
13482,0,0,4,0,-4
13483,0,0,84,0,-84
13484,1,0,51,0,-51
13485,0,0,38,0,-38
13486,0,0,24,0,-24
13487,1,1,441,1526,1085
13488,1,0,25,0,-25
13489,1,0,15,0,-15
13490,0,0,11,0,-11
13491,0,0,74,0,-74
13492,0,0,8,0,-8
13493,1,1,700,1818,1118
13494,1,1,1143,1300,157
13495,0,0,55,0,-55
13496,1,1,207,1357,1150
13497,1,0,16,0,-16
13498,0,0,46,0,-46
13499,1,1,56,1816,1760
13500,0,0,11,0,-11
13501,1,1,517,1872,1355
13502,1,0,6,0,-6
13503,0,0,65,0,-65
13504,0,0,12,0,-12
13505,1,0,37,0,-37
13506,1,0,63,0,-63
13507,1,1,98,1573,1475
13508,0,0,202,0,-202
13509,1,1,781,2755,1974
13510,1,1,563,1829,1266
13511,1,1,297,1707,1410
13512,0,0,53,0,-53
13513,0,0,4,0,-4
13514,1,1,1243,1591,348
13515,0,0,18,0,-18
13516,1,1,1197,1541,344
13517,0,0,50,0,-50
13518,1,0,69,0,-69
13519,1,0,150,0,-150
13520,0,0,16,0,-16
13521,1,1,497,1233,736
13522,1,1,631,1444,813
13523,0,0,93,0,-93
13524,1,1,321,1381,1060
13525,1,1,648,1209,561
13526,1,0,30,0,-30
13527,0,0,15,0,-15
13528,0,0,38,0,-38
13529,0,0,16,0,-16
13530,1,0,24,0,-24
13531,1,0,78,0,-78
13532,1,0,220,0,-220
13533,0,0,24,0,-24
13534,0,0,101,0,-101
13535,1,0,106,0,-106
13536,1,0,26,0,-26
13537,1,1,145,1215,1070
13538,1,1,2113,1530,-583
13539,1,0,12,0,-12
13540,1,1,315,2402,2087
13541,0,0,62,0,-62
13542,1,0,4,0,-4
13543,0,0,102,0,-102
13544,1,1,33,1275,1242
13545,1,1,189,1240,1051
13546,1,1,450,1211,761
13547,1,1,159,1513,1354
13548,0,0,125,0,-125
13549,1,1,178,1497,1319
13550,1,1,1169,1448,279
13551,1,0,4,0,-4
13552,0,0,21,0,-21
13553,0,0,71,0,-71
13554,1,0,48,0,-48
13555,0,0,3,0,-3
13556,1,1,568,1330,762
13557,1,1,400,1328,928
13558,0,0,23,0,-23
13559,1,0,4,0,-4
13560,1,1,384,1624,1240
13561,1,1,439,1369,930
13562,0,0,107,0,-107
13563,1,1,1587,1668,81
13564,1,0,101,0,-101
13565,0,0,24,0,-24
13566,0,0,65,0,-65
13567,0,0,30,0,-30
13568,0,0,15,0,-15
13569,0,0,7,0,-7
13570,1,1,128,1742,1614
13571,0,0,135,0,-135
13572,0,0,45,0,-45
13573,1,0,24,0,-24
13574,1,0,46,0,-46
13575,1,0,145,0,-145
13576,1,1,265,1496,1231
13577,0,0,15,0,-15
13578,0,0,1,0,-1
13579,1,1,414,1605,1191
13580,1,0,119,0,-119
13581,0,0,45,0,-45
13582,1,0,101,0,-101
13583,0,0,88,0,-88
13584,1,1,59,1425,1366
13585,0,0,50,0,-50
13586,0,0,34,0,-34
13587,0,0,43,0,-43
13588,1,1,1200,2228,1028
13589,1,0,57,0,-57
13590,0,0,17,0,-17
13591,0,0,171,0,-171
13592,1,0,68,0,-68
13593,1,1,200,1474,1274
13594,1,0,8,0,-8
13595,1,0,24,0,-24
13596,1,1,94,1360,1266
13597,0,0,22,0,-22
13598,0,0,47,0,-47
13599,1,1,1394,2320,926
13600,0,0,32,0,-32
13601,1,1,38,2296,2258
13602,1,0,56,0,-56
13603,1,0,2,0,-2
13604,1,1,854,1248,394
13605,0,0,28,0,-28
13606,1,0,115,0,-115
13607,1,0,34,0,-34
13608,1,1,22,1453,1431
13609,1,0,74,0,-74
13610,1,1,1351,1317,-34
13611,1,1,498,1687,1189
13612,1,1,851,1225,374
13613,0,0,184,0,-184
13614,0,0,30,0,-30
13615,1,0,104,0,-104
13616,1,1,1933,1495,-438
13617,1,0,39,0,-39
13618,1,0,42,0,-42
13619,0,0,11,0,-11
13620,1,0,40,0,-40
13621,1,0,95,0,-95
13622,0,0,25,0,-25
13623,1,0,3,0,-3
13624,1,0,52,0,-52
13625,0,0,8,0,-8
13626,0,0,30,0,-30
13627,1,0,13,0,-13
13628,0,0,110,0,-110
13629,1,0,2,0,-2
13630,0,0,91,0,-91
13631,0,0,6,0,-6
13632,0,0,45,0,-45
13633,1,0,44,0,-44
13634,0,0,66,0,-66
13635,1,1,1683,1323,-360
13636,0,0,120,0,-120
13637,1,0,42,0,-42
13638,0,0,44,0,-44
13639,1,0,42,0,-42
13640,0,0,22,0,-22
13641,1,1,2455,1264,-1191
13642,1,1,2184,1321,-863
13643,0,0,116,0,-116
13644,1,1,749,1427,678
13645,1,1,394,1470,1076
13646,0,0,6,0,-6
13647,1,0,1,0,-1
13648,0,0,76,0,-76
13649,1,1,594,1311,717
13650,1,0,62,0,-62
13651,0,0,7,0,-7
13652,0,0,63,0,-63
13653,1,1,308,1291,983
13654,1,0,87,0,-87
13655,0,0,11,0,-11
13656,0,0,24,0,-24
13657,0,0,174,0,-174
13658,0,0,194,0,-194
13659,0,0,110,0,-110
13660,1,0,172,0,-172
13661,1,1,652,1340,688
13662,1,0,43,0,-43
13663,1,1,526,1811,1285
13664,1,0,2,0,-2
13665,0,0,4,0,-4
13666,0,0,27,0,-27
13667,0,0,44,0,-44
13668,0,0,17,0,-17
13669,1,0,47,0,-47
13670,0,0,19,0,-19
13671,1,0,1,0,-1
13672,1,1,498,1376,878
13673,1,1,223,1726,1503
13674,1,0,50,0,-50
13675,1,0,12,0,-12
13676,1,1,549,1680,1131
13677,0,0,13,0,-13
13678,1,1,1213,1607,394
13679,1,1,363,1294,931
13680,1,0,95,0,-95
13681,1,0,23,0,-23
13682,0,0,59,0,-59
13683,1,0,8,0,-8
13684,1,1,286,1220,934
13685,1,1,284,1365,1081
13686,0,0,23,0,-23
13687,0,0,10,0,-10
13688,1,1,863,1314,451
13689,0,0,38,0,-38
13690,1,0,3,0,-3
13691,1,0,183,0,-183
13692,0,0,39,0,-39
13693,0,0,4,0,-4
13694,1,1,103,1497,1394
13695,1,1,446,1884,1438
13696,1,1,543,1627,1084
13697,0,0,9,0,-9
13698,1,0,19,0,-19
13699,1,0,25,0,-25
13700,1,1,361,1513,1152
13701,0,0,20,0,-20
13702,1,0,1,0,-1
13703,0,0,85,0,-85
13704,1,1,210,1969,1759
13705,0,0,52,0,-52
13706,0,0,3,0,-3
13707,1,0,74,0,-74
13708,1,0,41,0,-41
13709,0,0,11,0,-11
13710,1,0,33,0,-33
13711,0,0,14,0,-14
13712,0,0,11,0,-11
13713,1,1,169,4593,4424
13714,0,0,95,0,-95
13715,0,0,91,0,-91
13716,1,1,209,1604,1395
13717,1,1,376,1225,849
13718,1,0,70,0,-70
13719,1,1,628,1340,712
13720,0,0,1,0,-1
13721,0,0,3,0,-3
13722,1,1,466,1259,793
13723,1,0,74,0,-74
13724,1,1,233,1825,1592
13725,0,0,61,0,-61
13726,1,0,19,0,-19
13727,1,1,368,1383,1015
13728,1,1,610,2001,1391
13729,1,1,204,2649,2445
13730,0,0,27,0,-27
13731,1,0,13,0,-13
13732,0,0,42,0,-42
13733,0,0,31,0,-31
13734,1,1,1232,1337,105
13735,1,1,358,1538,1180
13736,1,1,924,1230,306
13737,1,0,30,0,-30
13738,1,1,2275,1430,-845
13739,1,1,232,1221,989
13740,1,1,160,1894,1734
13741,1,0,37,0,-37
13742,0,0,39,0,-39
13743,1,0,16,0,-16
13744,1,1,1355,2482,1127
13745,1,0,10,0,-10
13746,0,0,76,0,-76
13747,0,0,11,0,-11
13748,1,1,134,1957,1823
13749,1,1,389,2170,1781
13750,0,0,19,0,-19
13751,0,0,71,0,-71
13752,1,0,70,0,-70
13753,1,1,195,1476,1281
13754,0,0,12,0,-12
13755,0,0,48,0,-48
13756,0,0,45,0,-45
13757,1,1,725,1268,543
13758,0,0,13,0,-13
13759,1,1,528,1430,902
13760,1,1,343,1214,871
13761,1,1,2094,1541,-553
13762,0,0,37,0,-37
13763,0,0,61,0,-61
13764,1,1,177,1531,1354
13765,1,1,1346,1756,410
13766,1,1,363,2251,1888
13767,1,1,2011,1204,-807
13768,1,1,272,1643,1371
13769,1,0,10,0,-10
13770,1,1,127,1226,1099
13771,0,0,63,0,-63
13772,0,0,0,0,0
13773,1,0,2,0,-2
13774,1,1,32,1528,1496
13775,1,0,18,0,-18
13776,1,0,46,0,-46
13777,0,0,32,0,-32
13778,1,1,1471,1716,245
13779,1,0,14,0,-14
13780,0,0,110,0,-110
13781,0,0,99,0,-99
13782,1,0,146,0,-146
13783,1,1,222,1341,1119
13784,1,1,218,2350,2132
13785,1,1,890,1541,651
13786,1,0,59,0,-59
13787,1,0,68,0,-68
13788,1,1,659,1690,1031
13789,0,0,8,0,-8
13790,1,0,12,0,-12
13791,1,1,634,1467,833
13792,0,0,5,0,-5
13793,1,0,40,0,-40
13794,0,0,5,0,-5
13795,0,0,27,0,-27
13796,1,1,664,2358,1694
13797,1,1,39,2018,1979
13798,0,0,36,0,-36
13799,1,1,90,1217,1127
13800,1,1,622,1296,674
13801,1,0,42,0,-42
13802,1,0,40,0,-40
13803,1,0,261,0,-261
13804,0,0,63,0,-63
13805,1,1,510,1317,807
13806,1,1,98,1525,1427
13807,1,1,966,1401,435
13808,1,1,123,1471,1348
13809,1,0,128,0,-128
13810,0,0,2,0,-2
13811,0,0,3,0,-3
13812,1,0,57,0,-57
13813,0,0,30,0,-30
13814,1,0,52,0,-52
13815,1,1,98,1370,1272
13816,1,1,246,1661,1415
13817,1,1,271,1417,1146
13818,1,0,73,0,-73
13819,1,1,159,1286,1127
13820,0,0,7,0,-7
13821,0,0,8,0,-8
13822,0,0,128,0,-128
13823,1,0,26,0,-26
13824,0,0,48,0,-48
13825,1,1,406,1991,1585
13826,1,1,1049,1930,881
13827,1,0,8,0,-8
13828,1,0,76,0,-76
13829,0,0,65,0,-65
13830,0,0,7,0,-7
13831,1,0,18,0,-18
13832,0,0,1,0,-1
13833,1,0,5,0,-5
13834,1,1,144,1249,1105
13835,1,1,2232,1370,-862
13836,1,0,63,0,-63
13837,0,0,6,0,-6
13838,0,0,41,0,-41
13839,1,0,10,0,-10
13840,1,1,330,1349,1019
13841,1,1,1284,2026,742
13842,1,1,1534,1241,-293
13843,0,0,121,0,-121
13844,0,0,6,0,-6
13845,1,0,65,0,-65
13846,1,1,482,1223,741
13847,1,0,1,0,-1
13848,0,0,76,0,-76
13849,0,0,83,0,-83
13850,1,1,1185,1570,385
13851,1,0,29,0,-29
13852,1,1,46,1702,1656
13853,1,1,995,1225,230
13854,0,0,37,0,-37
13855,1,0,21,0,-21
13856,0,0,13,0,-13
13857,1,1,292,1585,1293
13858,0,0,45,0,-45
13859,0,0,36,0,-36
13860,1,1,336,1350,1014
13861,1,1,525,1934,1409
13862,1,0,80,0,-80
13863,0,0,55,0,-55
13864,1,1,237,1214,977
13865,1,1,424,1718,1294
13866,1,0,23,0,-23
13867,1,0,72,0,-72
13868,0,0,25,0,-25
13869,1,0,33,0,-33
13870,0,0,19,0,-19
13871,1,1,339,1451,1112
13872,1,1,959,1520,561
13873,1,1,215,1254,1039
13874,1,0,64,0,-64
13875,1,1,1632,1368,-264
13876,0,0,3,0,-3
13877,1,1,127,1649,1522
13878,1,0,27,0,-27
13879,1,0,35,0,-35
13880,1,0,32,0,-32
13881,1,0,340,0,-340
13882,0,0,9,0,-9
13883,1,0,31,0,-31
13884,1,0,219,0,-219
13885,0,0,20,0,-20
13886,1,0,45,0,-45
13887,0,0,80,0,-80
13888,1,0,87,0,-87
13889,1,1,1168,1340,172
13890,1,0,3,0,-3
13891,1,1,1269,1888,619
13892,0,0,26,0,-26
13893,1,0,247,0,-247
13894,0,0,13,0,-13
13895,0,0,4,0,-4
13896,1,1,147,1442,1295
13897,1,1,1336,1306,-30
13898,1,0,188,0,-188
13899,1,1,682,1220,538
13900,1,1,203,1373,1170
13901,1,1,90,1381,1291
13902,0,0,86,0,-86
13903,1,0,15,0,-15
13904,0,0,8,0,-8
13905,1,0,36,0,-36
13906,1,0,56,0,-56
13907,0,0,25,0,-25
13908,1,1,206,1979,1773
13909,0,0,60,0,-60
13910,0,0,0,0,0
13911,0,0,86,0,-86
13912,1,0,27,0,-27
13913,1,0,48,0,-48
13914,1,1,902,1497,595
13915,1,0,12,0,-12
13916,0,0,16,0,-16
13917,1,1,1105,1340,235
13918,0,0,4,0,-4
13919,1,0,13,0,-13
13920,1,1,573,1240,667
13921,1,1,150,1208,1058
13922,1,0,159,0,-159
13923,1,0,10,0,-10
13924,1,1,283,1360,1077
13925,1,0,26,0,-26
13926,1,1,599,1253,654
13927,1,1,305,2287,1982
13928,0,0,16,0,-16
13929,1,0,77,0,-77
13930,0,0,4,0,-4
13931,0,0,8,0,-8
13932,1,1,144,1647,1503
13933,0,0,70,0,-70
13934,0,0,33,0,-33
13935,1,1,192,1360,1168
13936,0,0,114,0,-114
13937,1,0,6,0,-6
13938,1,1,324,1310,986
13939,1,1,553,1316,763
13940,0,0,54,0,-54
13941,0,0,6,0,-6
13942,0,0,53,0,-53
13943,0,0,77,0,-77
13944,0,0,95,0,-95
13945,1,0,20,0,-20
13946,0,0,4,0,-4
13947,0,0,36,0,-36
13948,0,0,46,0,-46
13949,0,0,60,0,-60
13950,0,0,5,0,-5
13951,1,0,8,0,-8
13952,0,0,133,0,-133
13953,1,0,48,0,-48
13954,0,0,37,0,-37
13955,1,0,27,0,-27
13956,0,0,192,0,-192
13957,0,0,97,0,-97
13958,1,1,1890,1298,-592
13959,1,1,2722,1329,-1393
13960,1,1,1475,1653,178
13961,0,0,120,0,-120
13962,1,0,18,0,-18
13963,0,0,23,0,-23
13964,1,0,10,0,-10
13965,0,0,8,0,-8
13966,1,0,13,0,-13
13967,1,1,264,1608,1344
13968,0,0,82,0,-82
13969,1,1,459,1432,973
13970,1,0,74,0,-74
13971,0,0,95,0,-95
13972,0,0,56,0,-56
13973,1,1,728,1515,787
13974,1,1,158,1296,1138
13975,0,0,43,0,-43
13976,1,0,29,0,-29
13977,0,0,127,0,-127
13978,1,1,407,1353,946
13979,0,0,10,0,-10
13980,0,0,67,0,-67
13981,1,0,8,0,-8
13982,1,0,14,0,-14
13983,0,0,100,0,-100
13984,1,1,167,1636,1469
13985,0,0,38,0,-38
13986,1,1,373,3232,2859
13987,1,0,42,0,-42
13988,0,0,25,0,-25
13989,1,1,523,1243,720
13990,0,0,28,0,-28
13991,1,0,55,0,-55
13992,1,0,20,0,-20
13993,0,0,34,0,-34
13994,1,1,86,1715,1629
13995,1,1,624,1312,688
13996,0,0,13,0,-13
13997,1,0,72,0,-72
13998,1,0,23,0,-23
13999,1,1,105,1235,1130
14000,0,0,27,0,-27
14001,0,0,20,0,-20
14002,0,0,9,0,-9
14003,1,1,442,1220,778
14004,1,0,59,0,-59
14005,1,0,112,0,-112
14006,0,0,5,0,-5
14007,0,0,22,0,-22
14008,0,0,120,0,-120
14009,1,0,27,0,-27
14010,0,0,20,0,-20
14011,0,0,70,0,-70
14012,0,0,127,0,-127
14013,1,0,42,0,-42
14014,1,0,2,0,-2
14015,1,1,13,2105,2092
14016,0,0,1,0,-1
14017,0,0,55,0,-55
14018,1,1,91,1409,1318
14019,1,1,1116,1528,412
14020,1,0,70,0,-70
14021,1,0,49,0,-49
14022,1,0,80,0,-80
14023,1,1,1066,1333,267
14024,1,0,12,0,-12
14025,1,0,10,0,-10
14026,1,0,72,0,-72
14027,1,1,366,1279,913
14028,0,0,3,0,-3
14029,0,0,34,0,-34
14030,1,0,66,0,-66
14031,0,0,27,0,-27
14032,1,0,43,0,-43
14033,1,0,12,0,-12
14034,1,0,26,0,-26
14035,0,0,60,0,-60
14036,1,1,95,1228,1133
14037,1,1,763,3449,2686
14038,0,0,10,0,-10
14039,1,0,78,0,-78
14040,0,0,7,0,-7
14041,0,0,52,0,-52
14042,1,1,1287,5269,3982
14043,1,1,523,1309,786
14044,1,1,228,1805,1577
14045,1,0,11,0,-11
14046,1,0,45,0,-45
14047,1,0,14,0,-14
14048,0,0,31,0,-31
14049,0,0,0,0,0
14050,1,1,314,1496,1182
14051,0,0,123,0,-123
14052,0,0,35,0,-35
14053,1,1,304,1533,1229
14054,1,0,29,0,-29
14055,1,0,43,0,-43
14056,0,0,41,0,-41
14057,1,0,21,0,-21
14058,1,1,17,1259,1242
14059,0,0,216,0,-216
14060,0,0,67,0,-67
14061,0,0,46,0,-46
14062,0,0,45,0,-45
14063,1,0,3,0,-3
14064,1,1,421,1285,864
14065,1,1,428,1949,1521
14066,1,1,646,1201,555
14067,1,1,198,1422,1224
14068,0,0,101,0,-101
14069,1,0,72,0,-72
14070,0,0,93,0,-93
14071,0,0,11,0,-11
14072,1,0,72,0,-72
14073,1,0,30,0,-30
14074,1,1,664,1383,719
14075,0,0,27,0,-27
14076,1,0,30,0,-30
14077,1,0,8,0,-8
14078,1,1,293,1440,1147
14079,0,0,8,0,-8
14080,1,0,72,0,-72
14081,1,0,15,0,-15
14082,1,1,1168,1594,426
14083,1,0,88,0,-88
14084,1,1,390,1533,1143
14085,0,0,1,0,-1
14086,1,1,219,1261,1042
14087,0,0,98,0,-98
14088,1,0,6,0,-6
14089,0,0,1,0,-1
14090,1,1,466,1899,1433
14091,1,1,189,1433,1244
14092,1,0,136,0,-136
14093,1,1,1005,1379,374
14094,1,0,10,0,-10
14095,1,1,774,1224,450
14096,0,0,99,0,-99
14097,1,0,28,0,-28
14098,1,0,64,0,-64
14099,0,0,5,0,-5
14100,1,1,132,1936,1804
14101,0,0,92,0,-92
14102,0,0,184,0,-184
14103,0,0,97,0,-97
14104,1,1,426,2787,2361
14105,1,0,40,0,-40
14106,1,1,629,3826,3197
14107,0,0,18,0,-18
14108,1,1,882,1292,410
14109,1,0,55,0,-55
14110,0,0,16,0,-16
14111,0,0,41,0,-41
14112,0,0,69,0,-69
14113,0,0,75,0,-75
14114,1,1,679,1294,615
14115,1,1,756,1353,597
14116,1,1,814,1574,760
14117,0,0,53,0,-53
14118,1,0,35,0,-35
14119,1,0,20,0,-20
14120,1,1,183,1539,1356
14121,1,0,89,0,-89
14122,1,0,100,0,-100
14123,0,0,20,0,-20
14124,1,1,1443,1351,-92
14125,1,0,58,0,-58
14126,0,0,55,0,-55
14127,0,0,13,0,-13
14128,1,1,79,1359,1280
14129,1,0,14,0,-14
14130,0,0,4,0,-4
14131,1,0,71,0,-71
14132,0,0,48,0,-48
14133,1,0,55,0,-55
14134,1,0,44,0,-44
14135,0,0,17,0,-17
14136,1,0,48,0,-48
14137,1,1,748,1291,543
14138,1,1,649,1355,706
14139,1,1,243,1336,1093
14140,1,1,61,1303,1242
14141,0,0,42,0,-42
14142,0,0,68,0,-68
14143,1,0,8,0,-8
14144,1,0,5,0,-5
14145,1,1,1831,1223,-608
14146,1,0,19,0,-19
14147,0,0,200,0,-200
14148,1,1,315,3363,3048
14149,0,0,40,0,-40
14150,1,1,403,1513,1110
14151,1,1,1560,1261,-299
14152,0,0,3,0,-3
14153,1,1,1018,2041,1023
14154,0,0,0,0,0
14155,1,1,458,1576,1118
14156,0,0,47,0,-47
14157,1,1,246,1490,1244
14158,1,1,312,1584,1272
14159,1,1,507,1214,707
14160,1,1,358,1315,957
14161,1,0,3,0,-3
14162,1,1,1488,1314,-174
14163,1,0,24,0,-24
14164,0,0,144,0,-144
14165,1,1,709,1669,960
14166,1,0,3,0,-3
14167,1,0,75,0,-75
14168,1,0,78,0,-78
14169,1,1,136,1374,1238
14170,0,0,69,0,-69
14171,1,1,154,1391,1237
14172,0,0,60,0,-60
14173,0,0,60,0,-60
14174,0,0,2,0,-2
14175,0,0,57,0,-57
14176,1,1,34,2243,2209
14177,1,1,126,1377,1251
14178,0,0,49,0,-49
14179,0,0,1,0,-1
14180,1,0,37,0,-37
14181,0,0,35,0,-35
14182,1,0,6,0,-6
14183,1,0,42,0,-42
14184,0,0,224,0,-224
14185,1,1,140,1274,1134
14186,0,0,24,0,-24
14187,1,1,153,1318,1165
14188,1,1,695,1243,548
14189,1,1,1102,1227,125
14190,0,0,4,0,-4
14191,1,1,1082,1258,176
14192,0,0,67,0,-67
14193,1,0,81,0,-81
14194,1,0,60,0,-60
14195,1,0,7,0,-7
14196,0,0,29,0,-29
14197,0,0,12,0,-12
14198,1,1,231,1302,1071
14199,1,1,2654,1483,-1171
14200,1,1,601,1687,1086
14201,1,1,183,2141,1958
14202,1,1,97,1602,1505
14203,1,0,226,0,-226
14204,0,0,13,0,-13
14205,1,1,218,1235,1017
14206,1,0,100,0,-100
14207,1,1,1080,1227,147
14208,1,1,129,4111,3982
14209,0,0,90,0,-90
14210,1,1,1834,2256,422
14211,0,0,2,0,-2
14212,1,1,133,1407,1274
14213,0,0,73,0,-73
14214,1,1,119,1336,1217
14215,1,0,9,0,-9
14216,1,0,138,0,-138
14217,1,0,47,0,-47
14218,1,0,66,0,-66
14219,1,1,268,1379,1111
14220,1,0,10,0,-10
14221,1,0,20,0,-20
14222,1,0,18,0,-18
14223,1,0,11,0,-11
14224,0,0,8,0,-8
14225,0,0,4,0,-4
14226,0,0,35,0,-35
14227,1,1,367,1303,936
14228,1,1,200,2000,1800
14229,1,0,57,0,-57
14230,1,0,77,0,-77
14231,1,0,40,0,-40
14232,1,1,85,1698,1613
14233,1,1,406,1745,1339
14234,1,0,19,0,-19
14235,1,1,824,1878,1054
14236,0,0,23,0,-23
14237,1,1,239,1200,961
14238,0,0,67,0,-67
14239,1,0,45,0,-45
14240,1,0,11,0,-11
14241,1,1,94,1882,1788
14242,1,0,122,0,-122
14243,0,0,2,0,-2
14244,1,0,63,0,-63
14245,1,1,518,1574,1056
14246,1,0,18,0,-18
14247,0,0,62,0,-62
14248,1,0,18,0,-18
14249,0,0,5,0,-5
14250,1,0,38,0,-38
14251,1,0,189,0,-189
14252,1,1,380,1373,993
14253,1,1,545,1295,750
14254,1,1,289,1260,971
14255,1,1,688,1563,875
14256,1,0,2,0,-2
14257,0,0,61,0,-61
14258,1,0,46,0,-46
14259,0,0,77,0,-77
14260,0,0,115,0,-115
14261,1,0,21,0,-21
14262,0,0,9,0,-9
14263,0,0,82,0,-82
14264,1,1,465,1402,937
14265,1,0,8,0,-8
14266,1,0,15,0,-15
14267,1,0,11,0,-11
14268,0,0,149,0,-149
14269,0,0,57,0,-57
14270,0,0,104,0,-104
14271,0,0,8,0,-8
14272,0,0,33,0,-33
14273,1,1,223,1354,1131
14274,1,1,1109,1956,847
14275,0,0,75,0,-75
14276,0,0,5,0,-5
14277,1,0,54,0,-54
14278,1,1,331,1820,1489
14279,0,0,15,0,-15
14280,0,0,0,0,0
14281,0,0,25,0,-25
14282,0,0,37,0,-37
14283,1,0,8,0,-8
14284,0,0,90,0,-90
14285,0,0,28,0,-28
14286,1,1,1147,1268,121
14287,0,0,8,0,-8
14288,0,0,30,0,-30
14289,1,0,127,0,-127
14290,1,1,73,1631,1558
14291,0,0,2,0,-2
14292,1,1,124,1363,1239
14293,1,0,66,0,-66
14294,1,1,84,10578,10494
14295,1,1,53,3170,3117
14296,0,0,35,0,-35
14297,1,0,48,0,-48
14298,1,1,92,1671,1579
14299,0,0,2,0,-2
14300,1,0,109,0,-109
14301,1,0,8,0,-8
14302,1,0,76,0,-76
14303,0,0,39,0,-39
14304,1,1,585,1311,726
14305,1,1,531,1221,690
14306,1,1,380,1214,834
14307,1,1,931,1361,430
14308,1,0,21,0,-21
14309,1,0,42,0,-42
14310,1,0,19,0,-19
14311,0,0,5,0,-5
14312,0,0,2,0,-2
14313,1,1,123,1365,1242
14314,1,1,175,1458,1283
14315,0,0,99,0,-99
14316,1,0,85,0,-85
14317,0,0,8,0,-8
14318,1,0,159,0,-159
14319,0,0,9,0,-9
14320,1,0,12,0,-12
14321,1,1,516,1261,745
14322,0,0,18,0,-18
14323,0,0,17,0,-17
14324,0,0,98,0,-98
14325,1,0,56,0,-56
14326,1,0,58,0,-58
14327,0,0,60,0,-60
14328,1,1,36,1364,1328
14329,0,0,96,0,-96
14330,1,1,140,1541,1401
14331,0,0,3,0,-3
14332,1,1,860,1827,967
14333,1,0,48,0,-48
14334,1,1,149,2008,1859
14335,0,0,26,0,-26
14336,0,0,33,0,-33
14337,1,1,390,1397,1007
14338,0,0,54,0,-54
14339,1,1,182,1322,1140
14340,1,1,573,1921,1348
14341,0,0,43,0,-43
14342,1,1,340,1340,1000
14343,0,0,24,0,-24
14344,0,0,41,0,-41
14345,0,0,140,0,-140
14346,1,1,548,3465,2917
14347,1,0,110,0,-110
14348,1,1,1451,2120,669
14349,1,1,689,1369,680
14350,0,0,14,0,-14
14351,1,0,15,0,-15
14352,0,0,15,0,-15
14353,1,1,114,1324,1210
14354,0,0,16,0,-16
14355,0,0,88,0,-88
14356,1,1,2404,1765,-639
14357,1,0,77,0,-77
14358,0,0,36,0,-36
14359,0,0,51,0,-51
14360,1,1,1370,1201,-169
14361,1,1,1831,2138,307
14362,0,0,30,0,-30
14363,1,0,5,0,-5
14364,0,0,37,0,-37
14365,1,0,34,0,-34
14366,0,0,27,0,-27
14367,0,0,26,0,-26
14368,1,1,625,1731,1106
14369,0,0,34,0,-34
14370,1,1,2283,1499,-784
14371,1,0,3,0,-3
14372,0,0,80,0,-80
14373,0,0,82,0,-82
14374,1,0,16,0,-16
14375,1,0,31,0,-31
14376,1,1,132,1325,1193
14377,1,0,53,0,-53
14378,1,1,976,1550,574
14379,0,0,56,0,-56
14380,0,0,90,0,-90
14381,0,0,42,0,-42
14382,0,0,11,0,-11
14383,0,0,14,0,-14
14384,0,0,20,0,-20
14385,0,0,76,0,-76
14386,1,1,31,1370,1339
14387,0,0,61,0,-61
14388,0,0,0,0,0
14389,0,0,14,0,-14
14390,0,0,12,0,-12
14391,1,1,96,1766,1670
14392,1,1,1843,2511,668
14393,1,1,593,1287,694
14394,0,0,50,0,-50
14395,0,0,74,0,-74
14396,0,0,113,0,-113
14397,1,1,558,1727,1169
14398,1,1,96,1462,1366
14399,0,0,28,0,-28
14400,1,0,18,0,-18
14401,1,1,1528,3243,1715
14402,1,1,389,2041,1652
14403,1,0,30,0,-30
14404,1,0,22,0,-22
14405,1,1,1659,1334,-325
14406,1,0,39,0,-39
14407,1,1,541,1342,801
14408,0,0,54,0,-54
14409,0,0,14,0,-14
14410,1,1,1163,1472,309
14411,1,1,244,1941,1697
14412,1,0,4,0,-4
14413,1,1,267,1896,1629
14414,0,0,45,0,-45
14415,0,0,210,0,-210
14416,1,0,46,0,-46
14417,0,0,4,0,-4
14418,0,0,8,0,-8
14419,0,0,54,0,-54
14420,0,0,20,0,-20
14421,1,1,780,1218,438
14422,0,0,100,0,-100
14423,0,0,75,0,-75
14424,1,1,1190,1366,176
14425,0,0,38,0,-38
14426,0,0,54,0,-54
14427,1,0,14,0,-14
14428,1,0,141,0,-141
14429,1,0,107,0,-107
14430,1,1,87,1468,1381
14431,0,0,43,0,-43
14432,0,0,16,0,-16
14433,1,1,472,1206,734
14434,0,0,18,0,-18
14435,1,1,186,1667,1481
14436,1,0,12,0,-12
14437,0,0,39,0,-39
14438,0,0,1,0,-1
14439,0,0,48,0,-48
14440,1,1,1105,1214,109
14441,0,0,12,0,-12
14442,1,1,1207,1344,137
14443,1,0,73,0,-73
14444,1,1,894,1442,548
14445,1,0,11,0,-11
14446,0,0,4,0,-4
14447,1,0,43,0,-43
14448,1,0,31,0,-31
14449,1,1,911,1373,462
14450,1,0,56,0,-56
14451,1,1,170,1623,1453
14452,0,0,13,0,-13
14453,1,1,1306,1482,176
14454,0,0,72,0,-72
14455,1,0,6,0,-6
14456,1,0,19,0,-19
14457,0,0,2,0,-2
14458,1,1,172,1313,1141
14459,1,0,145,0,-145
14460,1,0,57,0,-57
14461,0,0,67,0,-67
14462,1,1,187,1706,1519
14463,0,0,19,0,-19
14464,0,0,74,0,-74
14465,1,1,313,1465,1152
14466,1,0,86,0,-86
14467,1,1,324,1305,981
14468,0,0,28,0,-28
14469,1,1,51,1785,1734
14470,1,0,76,0,-76
14471,1,0,36,0,-36
14472,1,1,223,1223,1000
14473,0,0,16,0,-16
14474,1,1,216,1947,1731
14475,0,0,76,0,-76
14476,0,0,148,0,-148
14477,1,0,127,0,-127
14478,0,0,11,0,-11
14479,0,0,4,0,-4
14480,1,0,52,0,-52
14481,1,1,1512,1378,-134
14482,0,0,28,0,-28
14483,1,1,120,1819,1699
14484,0,0,34,0,-34
14485,1,1,126,2650,2524
14486,1,0,57,0,-57
14487,1,1,409,1216,807
14488,1,1,400,1420,1020
14489,0,0,37,0,-37
14490,0,0,6,0,-6
14491,0,0,43,0,-43
14492,0,0,249,0,-249
14493,1,1,644,1569,925
14494,0,0,84,0,-84
14495,1,1,857,1740,883
14496,1,0,13,0,-13
14497,1,1,38,1485,1447
14498,0,0,14,0,-14
14499,1,1,743,1248,505
14500,1,0,9,0,-9
14501,0,0,93,0,-93
14502,0,0,44,0,-44
14503,1,0,4,0,-4
14504,1,1,204,1318,1114
14505,1,0,1,0,-1
14506,1,0,62,0,-62
14507,1,1,184,3153,2969
14508,1,0,18,0,-18
14509,1,1,757,1218,461
14510,1,0,3,0,-3
14511,1,1,404,1270,866
14512,1,0,36,0,-36
14513,1,0,172,0,-172
14514,1,1,140,1944,1804
14515,1,1,1271,1629,358
14516,1,1,1924,1983,59
14517,0,0,123,0,-123
14518,1,1,1652,1347,-305
14519,0,0,198,0,-198
14520,1,0,118,0,-118
14521,0,0,50,0,-50
14522,1,1,55,1310,1255
14523,0,0,109,0,-109
14524,0,0,85,0,-85
14525,1,1,553,3708,3155
14526,0,0,201,0,-201
14527,0,0,72,0,-72
14528,1,0,52,0,-52
14529,0,0,36,0,-36
14530,1,1,214,2410,2196
14531,1,1,182,1619,1437
14532,1,0,30,0,-30
14533,0,0,8,0,-8
14534,0,0,29,0,-29
14535,0,0,113,0,-113
14536,1,1,495,1476,981
14537,0,0,109,0,-109
14538,0,0,82,0,-82
14539,1,1,784,1623,839
14540,0,0,96,0,-96
14541,1,0,46,0,-46
14542,0,0,18,0,-18
14543,1,0,62,0,-62
14544,0,0,63,0,-63
14545,1,0,5,0,-5
14546,1,1,1375,1292,-83
14547,1,1,1055,1420,365
14548,0,0,23,0,-23
14549,1,1,1104,3030,1926
14550,0,0,51,0,-51
14551,0,0,56,0,-56
14552,0,0,4,0,-4
14553,1,1,438,1208,770
14554,1,1,353,1287,934
14555,0,0,66,0,-66
14556,1,1,1211,1370,159
14557,1,0,36,0,-36
14558,0,0,172,0,-172
14559,0,0,12,0,-12
14560,1,1,58,1757,1699
14561,0,0,158,0,-158
14562,1,0,7,0,-7
14563,0,0,28,0,-28
14564,0,0,26,0,-26
14565,0,0,150,0,-150
14566,1,1,1624,1712,88
14567,1,1,1562,1280,-282
14568,1,0,43,0,-43
14569,1,0,7,0,-7
14570,0,0,104,0,-104
14571,1,0,7,0,-7
14572,1,1,275,1469,1194
14573,1,1,1128,1622,494
14574,0,0,6,0,-6
14575,1,0,19,0,-19
14576,1,1,1177,1266,89
14577,0,0,22,0,-22
14578,1,1,158,1292,1134
14579,1,0,6,0,-6
14580,1,1,339,1264,925
14581,0,0,41,0,-41
14582,1,0,25,0,-25
14583,1,0,43,0,-43
14584,0,0,5,0,-5
14585,0,0,41,0,-41
14586,1,0,67,0,-67
14587,1,0,7,0,-7
14588,1,1,1205,1204,-1
14589,1,0,13,0,-13
14590,1,0,46,0,-46
14591,1,0,3,0,-3
14592,1,1,589,1470,881
14593,1,1,345,2098,1753
14594,0,0,53,0,-53
14595,1,1,685,1210,525
14596,0,0,42,0,-42
14597,1,1,119,1284,1165
14598,1,1,99,1570,1471
14599,1,1,475,1203,728
14600,1,0,24,0,-24
14601,1,0,0,0,0
14602,1,0,57,0,-57
14603,0,0,99,0,-99
14604,1,0,2,0,-2
14605,1,1,619,1336,717
14606,0,0,17,0,-17
14607,1,0,34,0,-34
14608,1,1,264,1698,1434
14609,1,0,5,0,-5
14610,1,0,6,0,-6
14611,1,0,37,0,-37
14612,0,0,19,0,-19
14613,0,0,2,0,-2
14614,1,0,129,0,-129
14615,0,0,202,0,-202
14616,1,1,105,1221,1116
14617,0,0,17,0,-17
14618,1,1,505,1549,1044
14619,1,0,28,0,-28
14620,1,1,877,1854,977
14621,0,0,8,0,-8
14622,0,0,43,0,-43
14623,1,1,21,1792,1771
14624,1,0,59,0,-59
14625,0,0,27,0,-27
14626,1,0,154,0,-154
14627,0,0,40,0,-40
14628,0,0,17,0,-17
14629,1,0,16,0,-16
14630,1,1,309,1330,1021
14631,0,0,39,0,-39
14632,1,1,591,1292,701
14633,0,0,4,0,-4
14634,1,0,29,0,-29
14635,1,0,37,0,-37
14636,0,0,31,0,-31
14637,1,1,538,1716,1178
14638,0,0,27,0,-27
14639,1,1,882,1776,894
14640,0,0,6,0,-6
14641,0,0,57,0,-57
14642,1,1,313,1430,1117
14643,0,0,40,0,-40
14644,1,0,94,0,-94
14645,1,0,60,0,-60
14646,0,0,104,0,-104
14647,1,0,46,0,-46
14648,1,0,43,0,-43
14649,0,0,0,0,0
14650,1,1,318,3477,3159
14651,0,0,23,0,-23
14652,0,0,36,0,-36
14653,0,0,71,0,-71
14654,0,0,72,0,-72
14655,0,0,22,0,-22
14656,1,1,2043,1270,-773
14657,0,0,15,0,-15
14658,1,0,90,0,-90
14659,1,1,668,1213,545
14660,1,0,19,0,-19
14661,0,0,12,0,-12
14662,1,0,3,0,-3
14663,1,1,1162,1269,107
14664,1,0,7,0,-7
14665,1,0,125,0,-125
14666,1,0,33,0,-33
14667,1,0,53,0,-53
14668,1,1,93,1342,1249
14669,1,1,330,1541,1211
14670,1,1,718,1216,498
14671,1,0,188,0,-188
14672,1,1,1302,1237,-65
14673,1,1,432,1596,1164
14674,0,0,5,0,-5
14675,1,1,37,1212,1175
14676,1,0,77,0,-77
14677,0,0,17,0,-17
14678,0,0,56,0,-56
14679,1,1,154,2238,2084
14680,1,1,1300,1391,91
14681,0,0,18,0,-18
14682,0,0,2,0,-2
14683,0,0,16,0,-16
14684,0,0,7,0,-7
14685,1,0,44,0,-44
14686,0,0,33,0,-33
14687,0,0,18,0,-18
14688,1,0,15,0,-15
14689,0,0,17,0,-17
14690,1,0,17,0,-17
14691,1,0,35,0,-35
14692,1,0,17,0,-17
14693,1,1,136,1970,1834
14694,0,0,44,0,-44
14695,0,0,9,0,-9
14696,0,0,62,0,-62
14697,1,0,3,0,-3
14698,0,0,77,0,-77
14699,1,1,61,1234,1173
14700,1,1,907,1496,589
14701,1,1,178,1260,1082
14702,1,1,570,1297,727
14703,1,1,264,1319,1055
14704,0,0,128,0,-128
14705,1,0,117,0,-117
14706,1,0,47,0,-47
14707,1,0,37,0,-37
14708,1,0,23,0,-23
14709,1,1,1702,2592,890
14710,0,0,64,0,-64
14711,1,0,6,0,-6
14712,1,1,1527,1711,184
14713,1,0,99,0,-99
14714,1,0,43,0,-43
14715,0,0,20,0,-20
14716,1,0,120,0,-120
14717,1,0,32,0,-32
14718,1,0,3,0,-3
14719,0,0,2,0,-2
14720,0,0,7,0,-7
14721,1,0,35,0,-35
14722,0,0,26,0,-26
14723,0,0,3,0,-3
14724,1,1,812,1351,539
14725,1,0,11,0,-11
14726,0,0,24,0,-24
14727,0,0,103,0,-103
14728,0,0,50,0,-50
14729,0,0,5,0,-5
14730,1,0,36,0,-36
14731,1,1,788,2240,1452
14732,0,0,15,0,-15
14733,1,0,53,0,-53
14734,1,0,30,0,-30
14735,1,0,137,0,-137
14736,1,0,1,0,-1
14737,0,0,152,0,-152
14738,1,0,72,0,-72
14739,0,0,31,0,-31
14740,0,0,19,0,-19
14741,0,0,123,0,-123
14742,1,0,67,0,-67
14743,0,0,108,0,-108
14744,1,1,76,1761,1685
14745,1,1,488,1240,752
14746,1,0,46,0,-46
14747,0,0,29,0,-29
14748,1,0,6,0,-6
14749,1,1,382,2318,1936
14750,1,0,16,0,-16
14751,0,0,125,0,-125
14752,1,1,26,1252,1226
14753,0,0,56,0,-56
14754,1,0,31,0,-31
14755,1,0,175,0,-175
14756,1,0,27,0,-27
14757,1,1,710,1460,750
14758,1,1,40,1459,1419
14759,1,1,667,1431,764
14760,1,1,232,1589,1357
14761,1,1,769,1307,538
14762,0,0,56,0,-56
14763,0,0,2,0,-2
14764,0,0,83,0,-83
14765,0,0,22,0,-22
14766,0,0,0,0,0
14767,0,0,74,0,-74
14768,0,0,32,0,-32
14769,1,0,23,0,-23
14770,1,0,90,0,-90
14771,1,0,35,0,-35
14772,0,0,0,0,0
14773,0,0,112,0,-112
14774,1,1,1157,1592,435
14775,1,1,335,1413,1078
14776,1,0,4,0,-4
14777,1,0,24,0,-24
14778,0,0,1,0,-1
14779,0,0,20,0,-20
14780,0,0,4,0,-4
14781,0,0,150,0,-150
14782,0,0,35,0,-35
14783,1,1,286,1325,1039
14784,1,0,14,0,-14
14785,1,0,173,0,-173
14786,1,1,250,2268,2018
14787,1,1,102,1746,1644
14788,1,1,64,1416,1352
14789,1,1,830,2470,1640
14790,1,1,474,2129,1655
14791,0,0,20,0,-20
14792,1,1,540,1448,908
14793,1,1,1966,1204,-762
14794,1,1,1724,1428,-296
14795,0,0,108,0,-108
14796,1,1,1160,1952,792
14797,0,0,33,0,-33
14798,0,0,12,0,-12
14799,1,0,26,0,-26
14800,1,0,69,0,-69
14801,1,1,571,1518,947
14802,1,0,5,0,-5
14803,1,1,560,2698,2138
14804,1,0,34,0,-34
14805,1,0,0,0,0
14806,1,1,1741,1285,-456
14807,0,0,119,0,-119
14808,1,1,42,2060,2018
14809,0,0,5,0,-5
14810,1,0,26,0,-26
14811,0,0,23,0,-23
14812,1,0,38,0,-38
14813,0,0,117,0,-117
14814,1,1,2125,1297,-828
14815,1,0,82,0,-82
14816,1,0,68,0,-68
14817,1,1,76,2523,2447
14818,1,0,159,0,-159
14819,1,0,49,0,-49
14820,0,0,32,0,-32
14821,0,0,35,0,-35
14822,0,0,54,0,-54
14823,0,0,64,0,-64
14824,1,1,732,2757,2025
14825,1,0,77,0,-77
14826,1,1,929,1810,881
14827,1,0,62,0,-62
14828,1,0,32,0,-32
14829,1,0,65,0,-65
14830,1,1,66,1530,1464
14831,1,1,976,2152,1176
14832,1,0,12,0,-12
14833,0,0,17,0,-17
14834,1,1,136,1414,1278
14835,0,0,61,0,-61
14836,0,0,9,0,-9
14837,0,0,33,0,-33
14838,1,1,131,1364,1233
14839,1,1,282,1780,1498
14840,0,0,17,0,-17
14841,0,0,53,0,-53
14842,1,1,204,1490,1286
14843,1,1,203,1796,1593
14844,0,0,12,0,-12
14845,1,0,16,0,-16
14846,0,0,108,0,-108
14847,0,0,35,0,-35
14848,1,0,15,0,-15
14849,0,0,68,0,-68
14850,1,0,16,0,-16
14851,1,1,831,1891,1060
14852,1,0,90,0,-90
14853,1,1,266,1315,1049
14854,0,0,53,0,-53
14855,1,1,602,1689,1087
14856,1,0,46,0,-46
14857,1,1,1169,1272,103
14858,1,0,6,0,-6
14859,0,0,18,0,-18
14860,0,0,1,0,-1
14861,1,1,151,1536,1385
14862,0,0,11,0,-11
14863,1,1,155,1824,1669
14864,0,0,75,0,-75
14865,1,1,776,2231,1455
14866,1,1,852,1326,474
14867,0,0,15,0,-15
14868,1,0,17,0,-17
14869,0,0,15,0,-15
14870,0,0,0,0,0
14871,0,0,35,0,-35
14872,1,0,23,0,-23
14873,1,0,62,0,-62
14874,0,0,29,0,-29
14875,0,0,10,0,-10
14876,1,0,156,0,-156
14877,0,0,8,0,-8
14878,1,0,14,0,-14
14879,1,1,377,2156,1779
14880,1,1,223,1855,1632
14881,1,0,30,0,-30
14882,1,0,22,0,-22
14883,1,1,988,1351,363
14884,1,1,630,2039,1409
14885,0,0,28,0,-28
14886,1,0,70,0,-70
14887,1,1,551,1209,658
14888,0,0,42,0,-42
14889,1,0,8,0,-8
14890,1,1,2148,1222,-926
14891,0,0,11,0,-11
14892,0,0,6,0,-6
14893,0,0,36,0,-36
14894,0,0,3,0,-3
14895,1,1,328,1328,1000
14896,1,0,2,0,-2
14897,1,0,41,0,-41
14898,0,0,101,0,-101
14899,1,0,29,0,-29
14900,0,0,82,0,-82
14901,0,0,131,0,-131
14902,1,0,22,0,-22
14903,1,0,41,0,-41
14904,0,0,45,0,-45
14905,1,0,76,0,-76
14906,1,0,12,0,-12
14907,0,0,30,0,-30
14908,0,0,11,0,-11
14909,1,1,976,1313,337
14910,1,0,71,0,-71
14911,1,0,30,0,-30
14912,1,0,87,0,-87
14913,1,0,14,0,-14
14914,0,0,109,0,-109
14915,1,0,34,0,-34
14916,0,0,184,0,-184
14917,1,1,131,1405,1274
14918,1,1,85,1979,1894
14919,1,1,472,1501,1029
14920,0,0,123,0,-123
14921,1,0,84,0,-84
14922,1,0,61,0,-61
14923,0,0,68,0,-68
14924,1,0,19,0,-19
14925,0,0,4,0,-4
14926,1,1,307,1440,1133
14927,1,1,389,1211,822
14928,0,0,106,0,-106
14929,1,0,21,0,-21
14930,1,1,83,1276,1193
14931,1,0,4,0,-4
14932,1,1,459,1366,907
14933,0,0,199,0,-199
14934,1,1,1264,1583,319
14935,1,1,742,1224,482
14936,1,0,27,0,-27
14937,0,0,4,0,-4
14938,1,0,14,0,-14
14939,0,0,93,0,-93
14940,0,0,33,0,-33
14941,0,0,139,0,-139
14942,1,1,1242,1218,-24
14943,0,0,9,0,-9
14944,1,1,953,1250,297
14945,1,1,178,1514,1336
14946,1,0,1,0,-1
14947,0,0,68,0,-68
14948,1,1,280,1617,1337
14949,1,1,966,1504,538
14950,1,0,55,0,-55
14951,1,0,529,0,-529
14952,1,0,12,0,-12
14953,1,1,333,1207,874
14954,1,1,591,2411,1820
14955,0,0,212,0,-212
14956,1,0,3,0,-3
14957,0,0,94,0,-94
14958,1,0,62,0,-62
14959,1,0,102,0,-102
14960,0,0,1,0,-1
14961,1,0,65,0,-65
14962,0,0,16,0,-16
14963,1,1,73,1555,1482
14964,1,1,210,3490,3280
14965,1,1,292,1338,1046
14966,1,1,484,1756,1272
14967,1,1,167,1330,1163
14968,1,0,23,0,-23
14969,1,0,31,0,-31
14970,0,0,82,0,-82
14971,1,1,526,1258,732
14972,1,1,776,4220,3444
14973,1,1,294,1252,958
14974,1,1,295,1403,1108
14975,0,0,120,0,-120
14976,1,0,86,0,-86
14977,1,1,41,1270,1229
14978,1,1,964,1471,507
14979,1,0,40,0,-40
14980,0,0,98,0,-98
14981,1,0,6,0,-6
14982,1,1,213,1317,1104
14983,0,0,6,0,-6
14984,0,0,71,0,-71
14985,1,1,613,1399,786
14986,1,0,73,0,-73
14987,1,1,349,1926,1577
14988,0,0,29,0,-29
14989,1,0,12,0,-12
14990,0,0,55,0,-55
14991,0,0,46,0,-46
14992,1,1,312,1651,1339
14993,0,0,42,0,-42
14994,1,0,22,0,-22
14995,1,1,51,1311,1260
14996,1,1,237,1283,1046
14997,0,0,89,0,-89
14998,1,0,50,0,-50
14999,1,0,10,0,-10
15000,1,0,6,0,-6
15001,1,0,50,0,-50
15002,1,0,9,0,-9
15003,1,0,64,0,-64
15004,1,0,61,0,-61
15005,1,1,244,1366,1122
15006,0,0,61,0,-61
15007,0,0,21,0,-21
15008,0,0,24,0,-24
15009,0,0,34,0,-34
15010,1,1,1868,1943,75
15011,1,0,9,0,-9
15012,0,0,0,0,0
15013,1,0,20,0,-20
15014,0,0,46,0,-46
15015,1,1,525,1260,735
15016,0,0,62,0,-62
15017,1,1,17,1440,1423
15018,1,0,38,0,-38
15019,0,0,48,0,-48
15020,0,0,297,0,-297
15021,1,0,27,0,-27
15022,1,0,34,0,-34
15023,0,0,144,0,-144
15024,0,0,13,0,-13
15025,0,0,0,0,0
15026,1,1,185,2336,2151
15027,1,0,0,0,0
15028,0,0,24,0,-24
15029,1,1,736,1332,596
15030,1,0,75,0,-75
15031,1,0,54,0,-54
15032,0,0,30,0,-30
15033,0,0,2,0,-2
15034,0,0,5,0,-5
15035,1,0,45,0,-45
15036,1,0,39,0,-39
15037,1,0,48,0,-48
15038,1,0,17,0,-17
15039,1,0,120,0,-120
15040,0,0,136,0,-136
15041,1,1,844,1575,731
15042,1,0,53,0,-53
15043,0,0,14,0,-14
15044,1,0,37,0,-37
15045,0,0,16,0,-16
15046,1,1,710,2781,2071
15047,0,0,0,0,0
15048,1,1,544,2408,1864
15049,1,1,1571,1418,-153
15050,0,0,38,0,-38
15051,1,0,67,0,-67
15052,0,0,45,0,-45
15053,1,0,34,0,-34
15054,0,0,61,0,-61
15055,0,0,33,0,-33
15056,0,0,7,0,-7
15057,1,0,54,0,-54
15058,1,1,182,1252,1070
15059,1,0,3,0,-3
15060,1,1,422,1233,811
15061,1,0,13,0,-13
15062,1,1,631,1618,987
15063,1,1,1658,2221,563
15064,1,1,785,1525,740
15065,0,0,35,0,-35
15066,0,0,6,0,-6
15067,1,1,238,1241,1003
15068,0,0,105,0,-105
15069,0,0,6,0,-6
15070,0,0,0,0,0
15071,0,0,154,0,-154
15072,0,0,41,0,-41
15073,1,1,2604,1556,-1048
15074,0,0,16,0,-16
15075,1,1,114,1784,1670
15076,0,0,35,0,-35
15077,1,0,14,0,-14
15078,0,0,3,0,-3
15079,1,0,60,0,-60
15080,0,0,29,0,-29
15081,0,0,47,0,-47
15082,1,1,369,2494,2125
15083,1,1,690,1578,888
15084,0,0,7,0,-7
15085,0,0,124,0,-124
15086,0,0,46,0,-46
15087,0,0,34,0,-34
15088,0,0,42,0,-42
15089,0,0,7,0,-7
15090,0,0,97,0,-97
15091,1,0,8,0,-8
15092,0,0,63,0,-63
15093,0,0,33,0,-33
15094,0,0,81,0,-81
15095,0,0,78,0,-78
15096,1,1,156,1930,1774
15097,1,0,93,0,-93
15098,0,0,60,0,-60
15099,1,0,22,0,-22
15100,1,0,94,0,-94
15101,0,0,19,0,-19
15102,1,1,179,1486,1307
15103,1,0,80,0,-80
15104,0,0,36,0,-36
15105,1,0,53,0,-53
15106,0,0,30,0,-30
15107,1,0,10,0,-10
15108,1,1,80,1325,1245
15109,1,1,1151,1670,519
15110,1,1,180,1323,1143
15111,1,1,727,1807,1080
15112,0,0,81,0,-81
15113,1,1,538,2070,1532
15114,0,0,63,0,-63
15115,1,1,511,1794,1283
15116,1,0,74,0,-74
15117,0,0,112,0,-112
15118,0,0,82,0,-82
15119,0,0,16,0,-16
15120,0,0,10,0,-10
15121,1,0,38,0,-38
15122,1,0,12,0,-12
15123,1,0,26,0,-26
15124,0,0,31,0,-31
15125,1,1,31,1668,1637
15126,1,1,178,1404,1226
15127,0,0,13,0,-13
15128,1,0,100,0,-100
15129,1,0,64,0,-64
15130,0,0,140,0,-140
15131,1,0,8,0,-8
15132,1,1,394,1304,910
15133,1,0,119,0,-119
15134,1,1,1015,1330,315
15135,1,1,912,1405,493
15136,1,1,380,1437,1057
15137,0,0,59,0,-59
15138,1,1,728,1207,479
15139,1,0,33,0,-33
15140,0,0,16,0,-16
15141,1,0,54,0,-54
15142,0,0,105,0,-105
15143,0,0,11,0,-11
15144,1,0,7,0,-7
15145,1,0,1,0,-1
15146,1,1,504,1325,821
15147,0,0,84,0,-84
15148,1,1,530,1415,885
15149,0,0,63,0,-63
15150,1,1,612,1279,667
15151,0,0,45,0,-45
15152,0,0,26,0,-26
15153,1,1,1392,1323,-69
15154,1,0,82,0,-82
15155,1,1,422,1658,1236
15156,1,0,6,0,-6
15157,0,0,36,0,-36
15158,0,0,10,0,-10
15159,0,0,54,0,-54
15160,1,0,4,0,-4
15161,1,0,237,0,-237
15162,0,0,82,0,-82
15163,1,1,467,1244,777
15164,1,0,23,0,-23
15165,1,0,58,0,-58
15166,0,0,47,0,-47
15167,1,1,171,1258,1087
15168,1,0,142,0,-142
15169,0,0,20,0,-20
15170,1,1,267,1272,1005
15171,1,0,40,0,-40
15172,0,0,6,0,-6
15173,1,0,66,0,-66
15174,0,0,5,0,-5
15175,1,0,26,0,-26
15176,0,0,28,0,-28
15177,1,1,290,1589,1299
15178,0,0,140,0,-140
15179,1,0,5,0,-5
15180,0,0,14,0,-14
15181,1,1,301,1781,1480
15182,0,0,120,0,-120
15183,1,0,1,0,-1
15184,1,0,49,0,-49
15185,0,0,4,0,-4
15186,1,0,5,0,-5
15187,1,1,146,1542,1396
15188,1,1,1106,1427,321
15189,0,0,127,0,-127
15190,0,0,38,0,-38
15191,0,0,18,0,-18
15192,1,1,1455,1201,-254
15193,0,0,15,0,-15
15194,1,0,81,0,-81
15195,0,0,3,0,-3
15196,1,0,70,0,-70
15197,1,1,362,1396,1034
15198,1,1,838,1501,663
15199,1,0,34,0,-34
15200,1,1,186,1280,1094
15201,0,0,108,0,-108
15202,1,1,1430,1229,-201
15203,1,0,54,0,-54
15204,0,0,33,0,-33
15205,1,1,117,1414,1297
15206,0,0,37,0,-37
15207,0,0,27,0,-27
15208,1,1,342,1255,913
15209,0,0,27,0,-27
15210,1,0,43,0,-43
15211,1,1,309,1308,999
15212,1,1,162,1337,1175
15213,1,0,57,0,-57
15214,0,0,9,0,-9
15215,1,0,20,0,-20
15216,0,0,18,0,-18
15217,0,0,25,0,-25
15218,1,0,29,0,-29
15219,1,1,623,1540,917
15220,1,0,54,0,-54
15221,0,0,7,0,-7
15222,1,1,334,1473,1139
15223,0,0,16,0,-16
15224,0,0,17,0,-17
15225,1,0,262,0,-262
15226,0,0,6,0,-6
15227,0,0,86,0,-86
15228,1,1,876,1435,559
15229,0,0,9,0,-9
15230,0,0,38,0,-38
15231,1,1,34,1364,1330
15232,1,0,26,0,-26
15233,1,0,34,0,-34
15234,1,0,28,0,-28
15235,1,0,23,0,-23
15236,0,0,47,0,-47
15237,1,0,22,0,-22
15238,1,1,392,4004,3612
15239,1,1,978,1334,356
15240,1,0,39,0,-39
15241,1,1,141,1306,1165
15242,0,0,18,0,-18
15243,1,1,149,1313,1164
15244,1,1,522,1578,1056
15245,1,0,31,0,-31
15246,0,0,19,0,-19
15247,1,0,10,0,-10
15248,1,1,328,2521,2193
15249,1,0,39,0,-39
15250,1,1,234,1414,1180
15251,1,0,2,0,-2
15252,1,1,1328,9597,8269
15253,1,0,178,0,-178
15254,1,1,652,3009,2357
15255,1,0,44,0,-44
15256,1,1,485,1380,895
15257,1,1,593,1722,1129
15258,1,0,221,0,-221
15259,0,0,14,0,-14
15260,1,1,715,1582,867
15261,1,0,15,0,-15
15262,0,0,32,0,-32
15263,0,0,282,0,-282
15264,0,0,44,0,-44
15265,0,0,12,0,-12
15266,1,1,176,1353,1177
15267,1,0,119,0,-119
15268,1,0,7,0,-7
15269,0,0,56,0,-56
15270,1,0,74,0,-74
15271,1,1,105,1387,1282
15272,1,0,6,0,-6
15273,0,0,154,0,-154
15274,0,0,63,0,-63
15275,1,0,5,0,-5
15276,0,0,101,0,-101
15277,1,1,270,1275,1005
15278,0,0,29,0,-29
15279,1,0,7,0,-7
15280,1,0,13,0,-13
15281,1,1,109,1740,1631
15282,1,1,387,2634,2247
15283,1,1,266,1273,1007
15284,1,1,790,1366,576
15285,0,0,10,0,-10
15286,1,1,1646,2065,419
15287,1,0,49,0,-49
15288,1,1,1989,1697,-292
15289,1,1,153,3846,3693
15290,1,0,4,0,-4
15291,1,0,54,0,-54
15292,1,1,422,1205,783
15293,0,0,45,0,-45
15294,0,0,17,0,-17
15295,1,0,24,0,-24
15296,1,0,3,0,-3
15297,0,0,1,0,-1
15298,0,0,13,0,-13
15299,1,0,38,0,-38
15300,1,1,484,2715,2231
15301,1,1,435,1737,1302
15302,1,0,53,0,-53
15303,1,0,9,0,-9
15304,0,0,40,0,-40
15305,0,0,63,0,-63
15306,1,1,405,2465,2060
15307,0,0,34,0,-34
15308,0,0,0,0,0
15309,1,0,14,0,-14
15310,0,0,2,0,-2
15311,1,0,106,0,-106
15312,1,0,12,0,-12
15313,0,0,29,0,-29
15314,1,0,30,0,-30
15315,0,0,71,0,-71
15316,0,0,7,0,-7
15317,0,0,7,0,-7
15318,0,0,23,0,-23
15319,0,0,79,0,-79
15320,1,1,87,1735,1648
15321,1,0,109,0,-109
15322,0,0,16,0,-16
15323,1,1,770,1467,697
15324,1,0,108,0,-108
15325,1,1,234,1500,1266
15326,0,0,220,0,-220
15327,0,0,9,0,-9
15328,1,1,535,1327,792
15329,0,0,50,0,-50
15330,1,0,1,0,-1
15331,0,0,68,0,-68
15332,0,0,100,0,-100
15333,1,1,220,1248,1028
15334,1,0,81,0,-81
15335,0,0,52,0,-52
15336,1,0,32,0,-32
15337,0,0,19,0,-19
15338,0,0,48,0,-48
15339,1,1,657,1362,705
15340,0,0,60,0,-60
15341,0,0,125,0,-125
15342,1,0,9,0,-9
15343,1,1,228,1245,1017
15344,0,0,25,0,-25
15345,1,1,931,1914,983
15346,0,0,24,0,-24
15347,0,0,78,0,-78
15348,1,0,14,0,-14
15349,1,1,558,1747,1189
15350,1,1,369,1379,1010
15351,1,0,87,0,-87
15352,1,0,5,0,-5
15353,1,1,167,1703,1536
15354,0,0,19,0,-19
15355,1,1,514,1207,693
15356,1,0,7,0,-7
15357,1,1,270,1268,998
15358,1,0,8,0,-8
15359,0,0,224,0,-224
15360,1,0,11,0,-11
15361,0,0,23,0,-23
15362,0,0,38,0,-38
15363,1,1,217,1226,1009
15364,0,0,5,0,-5
15365,1,0,61,0,-61
15366,0,0,6,0,-6
15367,1,1,273,2040,1767
15368,1,1,1110,1203,93
15369,1,1,605,1417,812
15370,0,0,508,0,-508
15371,1,1,111,1883,1772
15372,1,1,599,1309,710
15373,1,1,471,1485,1014
15374,1,0,38,0,-38
15375,1,1,1098,2219,1121
15376,1,1,391,1997,1606
15377,0,0,83,0,-83
15378,0,0,97,0,-97
15379,0,0,17,0,-17
15380,1,1,198,1250,1052
15381,1,0,48,0,-48
15382,1,0,42,0,-42
15383,1,1,104,1328,1224
15384,0,0,34,0,-34
15385,1,1,455,1391,936
15386,0,0,55,0,-55
15387,1,0,53,0,-53
15388,1,1,164,1220,1056
15389,1,1,1952,1731,-221
15390,0,0,89,0,-89
15391,1,0,40,0,-40
15392,0,0,112,0,-112
15393,0,0,20,0,-20
15394,1,1,292,1423,1131
15395,0,0,7,0,-7
15396,1,0,41,0,-41
15397,0,0,22,0,-22
15398,1,1,189,1793,1604
15399,1,1,83,1836,1753
15400,1,0,59,0,-59
15401,1,1,205,1590,1385
15402,1,1,206,1333,1127
15403,1,1,875,1691,816
15404,1,1,590,1441,851
15405,1,0,13,0,-13
15406,0,0,39,0,-39
15407,1,0,31,0,-31
15408,1,1,586,1893,1307
15409,1,1,779,3299,2520
15410,1,1,81,2011,1930
15411,0,0,23,0,-23
15412,1,0,17,0,-17
15413,1,0,21,0,-21
15414,1,0,78,0,-78
15415,1,0,5,0,-5
15416,1,1,407,1223,816
15417,1,1,383,1413,1030
15418,1,1,118,1343,1225
15419,0,0,74,0,-74
15420,0,0,67,0,-67
15421,1,0,0,0,0
15422,1,0,67,0,-67
15423,0,0,143,0,-143
15424,0,0,51,0,-51
15425,1,1,100,1272,1172
15426,1,0,58,0,-58
15427,0,0,2,0,-2
15428,1,0,86,0,-86
15429,1,1,107,2420,2313
15430,1,0,36,0,-36
15431,1,1,3620,1326,-2294
15432,1,0,38,0,-38
15433,1,0,2,0,-2
15434,0,0,34,0,-34
15435,0,0,25,0,-25
15436,1,1,1184,1240,56
15437,0,0,25,0,-25
15438,1,0,127,0,-127
15439,0,0,53,0,-53
15440,0,0,179,0,-179
15441,1,1,1526,1259,-267
15442,1,0,112,0,-112
15443,1,0,31,0,-31
15444,1,0,117,0,-117
15445,1,0,19,0,-19
15446,0,0,11,0,-11
15447,1,1,239,1721,1482
15448,1,1,25,1588,1563
15449,1,0,33,0,-33
15450,0,0,25,0,-25
15451,1,1,1146,1375,229
15452,1,1,796,1586,790
15453,1,0,49,0,-49
15454,1,0,16,0,-16
15455,0,0,59,0,-59
15456,1,0,54,0,-54
15457,1,0,37,0,-37
15458,1,0,131,0,-131
15459,0,0,117,0,-117
15460,0,0,80,0,-80
15461,1,0,198,0,-198
15462,1,1,398,1538,1140
15463,1,0,46,0,-46
15464,0,0,14,0,-14
15465,1,0,4,0,-4
15466,1,0,3,0,-3
15467,0,0,130,0,-130
15468,0,0,6,0,-6
15469,0,0,19,0,-19
15470,1,1,42,1618,1576
15471,1,1,164,1232,1068
15472,0,0,6,0,-6
15473,1,0,25,0,-25
15474,1,1,207,1547,1340
15475,0,0,16,0,-16
15476,0,0,68,0,-68
15477,1,0,2,0,-2
15478,1,1,802,1478,676
15479,1,0,139,0,-139
15480,1,1,1029,1230,201
15481,1,0,35,0,-35
15482,0,0,27,0,-27
15483,1,0,48,0,-48
15484,1,0,14,0,-14
15485,1,0,17,0,-17
15486,1,0,222,0,-222
15487,0,0,0,0,0
15488,0,0,30,0,-30
15489,0,0,58,0,-58
15490,0,0,1,0,-1
15491,1,0,0,0,0
15492,1,1,464,2207,1743
15493,0,0,24,0,-24
15494,1,0,20,0,-20
15495,1,1,1023,1214,191
15496,0,0,24,0,-24
15497,0,0,125,0,-125
15498,1,0,7,0,-7
15499,1,0,19,0,-19
15500,1,1,130,1324,1194
15501,1,0,81,0,-81
15502,0,0,33,0,-33
15503,0,0,46,0,-46
15504,1,1,104,1381,1277
15505,1,1,95,1701,1606
15506,1,1,77,1682,1605
15507,1,1,3783,1558,-2225
15508,1,1,342,1592,1250
15509,0,0,18,0,-18
15510,1,1,313,1212,899
15511,0,0,65,0,-65
15512,1,0,16,0,-16
15513,1,1,130,1792,1662
15514,0,0,62,0,-62
15515,1,0,5,0,-5
15516,0,0,116,0,-116
15517,0,0,24,0,-24
15518,0,0,96,0,-96
15519,1,1,309,1361,1052
15520,1,1,658,1289,631
15521,0,0,6,0,-6
15522,0,0,3,0,-3
15523,0,0,104,0,-104
15524,0,0,43,0,-43
15525,1,1,402,1931,1529
15526,1,1,106,1516,1410
15527,1,1,26,1604,1578
15528,1,0,12,0,-12
15529,0,0,29,0,-29
15530,1,1,808,1314,506
15531,1,1,824,1248,424
15532,1,0,0,0,0
15533,1,1,441,3365,2924
15534,1,0,23,0,-23
15535,1,0,26,0,-26
15536,1,1,1020,1201,181
15537,0,0,12,0,-12
15538,1,1,109,1798,1689
15539,1,0,157,0,-157
15540,0,0,174,0,-174
15541,0,0,38,0,-38
15542,1,0,295,0,-295
15543,0,0,25,0,-25
15544,1,1,11,1944,1933
15545,0,0,30,0,-30
15546,0,0,1,0,-1
15547,1,0,145,0,-145
15548,1,0,67,0,-67
15549,0,0,37,0,-37
15550,1,1,349,1424,1075
15551,0,0,25,0,-25
15552,0,0,2,0,-2
15553,1,1,55,1286,1231
15554,0,0,105,0,-105
15555,1,1,206,1215,1009
15556,1,0,8,0,-8
15557,1,0,34,0,-34
15558,1,0,39,0,-39
15559,0,0,28,0,-28
15560,0,0,78,0,-78
15561,0,0,18,0,-18
15562,0,0,15,0,-15
15563,0,0,36,0,-36
15564,0,0,19,0,-19
15565,0,0,9,0,-9
15566,1,0,33,0,-33
15567,0,0,18,0,-18
15568,1,1,260,1553,1293
15569,0,0,34,0,-34
15570,1,0,89,0,-89
15571,0,0,17,0,-17
15572,0,0,25,0,-25
15573,0,0,106,0,-106
15574,0,0,124,0,-124
15575,0,0,31,0,-31
15576,0,0,102,0,-102
15577,1,1,968,1395,427
15578,0,0,209,0,-209
15579,0,0,8,0,-8
15580,0,0,16,0,-16
15581,1,1,67,1224,1157
15582,0,0,189,0,-189
15583,1,0,18,0,-18
15584,1,0,22,0,-22
15585,1,0,54,0,-54
15586,0,0,52,0,-52
15587,0,0,62,0,-62
15588,1,1,123,3732,3609
15589,0,0,98,0,-98
15590,0,0,46,0,-46
15591,1,0,135,0,-135
15592,1,1,1356,1341,-15
15593,0,0,25,0,-25
15594,0,0,34,0,-34
15595,1,1,1896,1330,-566
15596,0,0,57,0,-57
15597,0,0,1,0,-1
15598,1,1,192,1237,1045
15599,1,1,105,2100,1995
15600,1,1,643,1304,661
15601,0,0,18,0,-18
15602,1,0,68,0,-68
15603,1,1,89,1655,1566
15604,1,0,76,0,-76
15605,1,0,6,0,-6
15606,1,1,437,1738,1301
15607,1,0,92,0,-92
15608,0,0,49,0,-49
15609,1,1,69,1856,1787
15610,1,0,38,0,-38
15611,1,0,31,0,-31
15612,0,0,4,0,-4
15613,1,0,38,0,-38
15614,0,0,67,0,-67
15615,1,0,3,0,-3
15616,1,0,19,0,-19
15617,1,1,31,1802,1771
15618,0,0,94,0,-94
15619,1,0,8,0,-8
15620,1,1,937,1461,524
15621,1,0,5,0,-5
15622,1,0,64,0,-64
15623,1,1,279,2256,1977
15624,1,1,412,1290,878
15625,0,0,78,0,-78
15626,1,1,749,1459,710
15627,1,0,80,0,-80
15628,1,0,12,0,-12
15629,1,1,100,1364,1264
15630,1,1,522,1209,687
15631,0,0,139,0,-139
15632,0,0,17,0,-17
15633,0,0,1,0,-1
15634,1,0,8,0,-8
15635,1,0,130,0,-130
15636,0,0,19,0,-19
15637,1,0,54,0,-54
15638,1,0,56,0,-56
15639,0,0,3,0,-3
15640,0,0,31,0,-31
15641,1,1,160,2495,2335
15642,1,0,33,0,-33
15643,0,0,163,0,-163
15644,1,1,823,1224,401
15645,0,0,126,0,-126
15646,1,1,211,1202,991
15647,0,0,15,0,-15
15648,1,0,3,0,-3
15649,0,0,2,0,-2
15650,1,1,500,1516,1016
15651,1,0,19,0,-19
15652,1,1,379,1375,996
15653,1,0,100,0,-100
15654,1,0,164,0,-164
15655,1,1,114,1508,1394
15656,1,1,323,1249,926
15657,1,1,10,1218,1208
15658,0,0,76,0,-76
15659,1,0,11,0,-11
15660,1,0,256,0,-256
15661,0,0,50,0,-50
15662,1,1,530,1247,717
15663,1,1,288,1523,1235
15664,0,0,169,0,-169
15665,1,1,198,1264,1066
15666,0,0,5,0,-5
15667,0,0,42,0,-42
15668,1,1,1230,1211,-19
15669,0,0,16,0,-16
15670,1,0,84,0,-84
15671,1,0,118,0,-118
15672,1,0,49,0,-49
15673,1,1,402,1919,1517
15674,1,0,82,0,-82
15675,0,0,11,0,-11
15676,0,0,98,0,-98
15677,1,0,59,0,-59
15678,1,1,1164,1739,575
15679,1,1,269,2814,2545
15680,0,0,6,0,-6
15681,1,1,166,2605,2439
15682,0,0,15,0,-15
15683,1,0,28,0,-28
15684,1,1,181,1626,1445
15685,1,0,59,0,-59
15686,1,1,162,1471,1309
15687,1,0,46,0,-46
15688,1,0,59,0,-59
15689,1,1,318,1388,1070
15690,0,0,36,0,-36
15691,1,1,170,1232,1062
15692,1,0,107,0,-107
15693,1,1,384,1240,856
15694,1,0,0,0,0
15695,1,0,130,0,-130
15696,1,1,119,1983,1864
15697,1,1,514,1703,1189
15698,1,1,786,1334,548
15699,0,0,109,0,-109
15700,1,1,755,1201,446
15701,0,0,39,0,-39
15702,1,1,145,1572,1427
15703,0,0,81,0,-81
15704,1,1,923,3321,2398
15705,0,0,67,0,-67
15706,0,0,76,0,-76
15707,0,0,130,0,-130
15708,1,0,42,0,-42
15709,1,1,951,1665,714
15710,1,0,7,0,-7
15711,1,1,228,1359,1131
15712,1,0,30,0,-30
15713,0,0,49,0,-49
15714,1,0,29,0,-29
15715,0,0,84,0,-84
15716,0,0,33,0,-33
15717,1,1,7,1445,1438
15718,1,0,122,0,-122
15719,0,0,17,0,-17
15720,0,0,24,0,-24
15721,1,0,93,0,-93
15722,0,0,47,0,-47
15723,1,1,208,1303,1095
15724,0,0,64,0,-64
15725,0,0,7,0,-7
15726,1,1,194,2493,2299
15727,0,0,69,0,-69
15728,0,0,31,0,-31
15729,1,0,18,0,-18
15730,0,0,24,0,-24
15731,0,0,88,0,-88
15732,0,0,16,0,-16
15733,0,0,251,0,-251
15734,0,0,57,0,-57
15735,0,0,61,0,-61
15736,0,0,20,0,-20
15737,0,0,9,0,-9
15738,0,0,29,0,-29
15739,1,0,65,0,-65
15740,1,0,319,0,-319
15741,1,0,63,0,-63
15742,1,1,237,1341,1104
15743,0,0,42,0,-42
15744,0,0,35,0,-35
15745,1,1,485,1523,1038
15746,0,0,175,0,-175
15747,1,0,65,0,-65
15748,1,1,458,2397,1939
15749,0,0,7,0,-7
15750,0,0,16,0,-16
15751,1,1,612,1328,716
15752,1,0,65,0,-65
15753,1,1,48,1238,1190
15754,0,0,41,0,-41
15755,1,1,465,1280,815
15756,1,1,61,1363,1302
15757,1,0,2,0,-2
15758,1,1,810,1509,699
15759,1,1,426,1543,1117
15760,1,1,800,1531,731
15761,0,0,12,0,-12
15762,1,1,144,1206,1062
15763,1,0,30,0,-30
15764,1,0,141,0,-141
15765,0,0,158,0,-158
15766,0,0,23,0,-23
15767,1,1,246,1372,1126
15768,1,1,328,1942,1614
15769,1,1,185,1203,1018
15770,1,1,20,1626,1606
15771,0,0,49,0,-49
15772,1,0,64,0,-64
15773,0,0,53,0,-53
15774,0,0,27,0,-27
15775,1,0,50,0,-50
15776,0,0,18,0,-18
15777,0,0,25,0,-25
15778,1,1,330,1414,1084
15779,1,1,261,2640,2379
15780,1,1,399,1216,817
15781,0,0,21,0,-21
15782,1,0,99,0,-99
15783,0,0,24,0,-24
15784,1,0,16,0,-16
15785,1,1,336,1924,1588
15786,1,1,760,1975,1215
15787,0,0,16,0,-16
15788,0,0,2,0,-2
15789,1,0,70,0,-70
15790,0,0,15,0,-15
15791,1,1,513,1296,783
15792,0,0,4,0,-4
15793,1,0,17,0,-17
15794,0,0,74,0,-74
15795,0,0,4,0,-4
15796,1,0,55,0,-55
15797,1,0,79,0,-79
15798,1,0,36,0,-36
15799,1,1,977,1211,234
15800,1,1,221,1259,1038
15801,1,1,429,1720,1291
15802,0,0,129,0,-129
15803,1,0,5,0,-5
15804,0,0,3,0,-3
15805,0,0,8,0,-8
15806,1,1,435,1406,971
15807,1,1,657,2097,1440
15808,1,1,160,1602,1442
15809,1,1,745,1252,507
15810,1,0,74,0,-74
15811,1,0,37,0,-37
15812,1,1,171,1463,1292
15813,0,0,63,0,-63
15814,1,1,195,1230,1035
15815,1,0,123,0,-123
15816,0,0,70,0,-70
15817,1,1,339,1251,912
15818,0,0,2,0,-2
15819,1,1,88,1474,1386
15820,0,0,12,0,-12
15821,0,0,40,0,-40
15822,0,0,105,0,-105
15823,1,1,289,1288,999
15824,0,0,45,0,-45
15825,0,0,16,0,-16
15826,0,0,95,0,-95
15827,0,0,128,0,-128
15828,1,1,123,1467,1344
15829,0,0,67,0,-67
15830,1,0,51,0,-51
15831,0,0,4,0,-4
15832,1,1,217,1883,1666
15833,1,0,86,0,-86
15834,1,0,101,0,-101
15835,1,0,191,0,-191
15836,1,1,1732,1314,-418
15837,1,0,23,0,-23
15838,0,0,72,0,-72
15839,1,0,19,0,-19
15840,0,0,93,0,-93
15841,1,0,3,0,-3
15842,0,0,223,0,-223
15843,0,0,126,0,-126
15844,1,1,237,1230,993
15845,0,0,24,0,-24
15846,1,0,451,0,-451
15847,0,0,27,0,-27
15848,1,1,442,3013,2571
15849,1,0,74,0,-74
15850,1,0,67,0,-67
15851,1,1,496,1806,1310
15852,1,0,3,0,-3
15853,1,1,1434,2037,603
15854,0,0,132,0,-132
15855,1,1,1931,1582,-349
15856,0,0,114,0,-114
15857,1,0,30,0,-30
15858,0,0,116,0,-116
15859,1,0,18,0,-18
15860,1,1,427,1475,1048
15861,1,0,54,0,-54
15862,0,0,5,0,-5
15863,1,0,50,0,-50
15864,1,1,422,1371,949
15865,1,1,394,1570,1176
15866,0,0,19,0,-19
15867,0,0,9,0,-9
15868,0,0,173,0,-173
15869,0,0,1,0,-1
15870,1,0,85,0,-85
15871,1,1,947,1883,936
15872,0,0,98,0,-98
15873,0,0,31,0,-31
15874,1,0,35,0,-35
15875,1,0,33,0,-33
15876,1,0,12,0,-12
15877,0,0,12,0,-12
15878,1,1,1228,1598,370
15879,0,0,7,0,-7
15880,1,0,34,0,-34
15881,1,1,688,1458,770
15882,0,0,113,0,-113
15883,0,0,5,0,-5
15884,0,0,56,0,-56
15885,1,0,36,0,-36
15886,1,0,152,0,-152
15887,0,0,77,0,-77
15888,1,1,760,1221,461
15889,1,1,478,1388,910
15890,1,0,55,0,-55
15891,1,0,38,0,-38
15892,1,0,0,0,0
15893,1,1,383,1314,931
15894,0,0,392,0,-392
15895,0,0,37,0,-37
15896,1,1,135,1360,1225
15897,1,1,126,1727,1601
15898,1,1,66,1251,1185
15899,1,1,501,1545,1044
15900,1,1,81,1370,1289
15901,1,1,277,1648,1371
15902,0,0,15,0,-15
15903,0,0,125,0,-125
15904,0,0,46,0,-46
15905,0,0,62,0,-62
15906,0,0,8,0,-8
15907,0,0,26,0,-26
15908,0,0,101,0,-101
15909,0,0,14,0,-14
15910,1,1,631,1209,578
15911,1,1,70,2638,2568
15912,0,0,56,0,-56
15913,1,1,575,1267,692
15914,0,0,11,0,-11
15915,0,0,8,0,-8
15916,1,1,137,1236,1099
15917,1,0,24,0,-24
15918,1,0,55,0,-55
15919,1,1,480,1498,1018
15920,0,0,63,0,-63
15921,0,0,48,0,-48
15922,1,1,1102,1900,798
15923,0,0,54,0,-54
15924,0,0,31,0,-31
15925,1,1,285,1260,975
15926,1,1,161,1325,1164
15927,1,1,496,1469,973
15928,0,0,23,0,-23
15929,0,0,71,0,-71
15930,0,0,64,0,-64
15931,0,0,68,0,-68
15932,1,0,4,0,-4
15933,1,0,58,0,-58
15934,1,1,221,1610,1389
15935,1,1,233,1571,1338
15936,0,0,24,0,-24
15937,1,1,1817,1312,-505
15938,1,1,938,3038,2100
15939,0,0,12,0,-12
15940,1,1,833,1223,390
15941,0,0,25,0,-25
15942,0,0,49,0,-49
15943,1,1,364,1657,1293
15944,1,1,1720,1578,-142
15945,1,1,609,1600,991
15946,0,0,101,0,-101
15947,1,1,897,1214,317
15948,0,0,73,0,-73
15949,0,0,77,0,-77
15950,1,1,511,1298,787
15951,1,0,28,0,-28
15952,1,0,89,0,-89
15953,0,0,66,0,-66
15954,0,0,0,0,0
15955,0,0,78,0,-78
15956,0,0,22,0,-22
15957,1,0,64,0,-64
15958,1,0,7,0,-7
15959,0,0,33,0,-33
15960,0,0,89,0,-89
15961,1,0,28,0,-28
15962,1,1,100,2654,2554
15963,0,0,58,0,-58
15964,1,1,135,1356,1221
15965,1,1,265,1813,1548
15966,1,0,45,0,-45
15967,0,0,37,0,-37
15968,1,0,48,0,-48
15969,1,1,204,1656,1452
15970,0,0,1,0,-1
15971,1,1,1016,1478,462
15972,1,1,302,2899,2597
15973,0,0,47,0,-47
15974,0,0,18,0,-18
15975,0,0,0,0,0
15976,0,0,26,0,-26
15977,1,0,189,0,-189
15978,1,0,124,0,-124
15979,1,1,509,1271,762
15980,1,1,603,1229,626
15981,1,1,548,1384,836
15982,1,0,228,0,-228
15983,0,0,2,0,-2
15984,0,0,57,0,-57
15985,1,1,1321,1318,-3
15986,1,1,565,1407,842
15987,1,0,14,0,-14
15988,1,1,378,1446,1068
15989,0,0,107,0,-107
15990,1,1,338,1534,1196
15991,1,1,559,2282,1723
15992,0,0,50,0,-50
15993,1,1,29,1350,1321
15994,1,0,11,0,-11
15995,1,0,168,0,-168
15996,0,0,124,0,-124
15997,1,1,40,2138,2098
15998,0,0,83,0,-83
15999,0,0,299,0,-299
16000,1,1,431,2967,2536
16001,0,0,148,0,-148
16002,1,1,593,1297,704
16003,1,0,67,0,-67
16004,1,1,368,1228,860
16005,1,0,2,0,-2
16006,1,0,42,0,-42
16007,0,0,58,0,-58
16008,1,1,829,1207,378
16009,0,0,70,0,-70
16010,0,0,28,0,-28
16011,0,0,96,0,-96
16012,0,0,218,0,-218
16013,0,0,34,0,-34
16014,1,0,224,0,-224
16015,1,1,288,2874,2586
16016,0,0,94,0,-94
16017,1,1,239,1288,1049
16018,0,0,1,0,-1
16019,1,0,4,0,-4
16020,0,0,103,0,-103
16021,1,0,47,0,-47
16022,1,1,191,1288,1097
16023,0,0,13,0,-13
16024,1,0,36,0,-36
16025,1,1,428,1271,843
16026,1,1,234,1211,977
16027,1,1,1576,1325,-251
16028,1,0,32,0,-32
16029,0,0,14,0,-14
16030,1,1,985,2619,1634
16031,0,0,26,0,-26
16032,1,1,175,1286,1111
16033,1,0,98,0,-98
16034,0,0,18,0,-18
16035,1,0,110,0,-110
16036,1,1,1677,1317,-360
16037,1,1,640,1511,871
16038,1,0,45,0,-45
16039,1,1,344,1374,1030
16040,0,0,0,0,0
16041,1,1,1333,1776,443
16042,0,0,58,0,-58
16043,0,0,39,0,-39
16044,0,0,91,0,-91
16045,0,0,8,0,-8
16046,1,1,319,1809,1490
16047,1,0,51,0,-51
16048,0,0,100,0,-100
16049,1,0,137,0,-137
16050,1,0,50,0,-50
16051,0,0,19,0,-19
16052,0,0,2,0,-2
16053,1,1,259,1232,973
16054,0,0,39,0,-39
16055,1,1,223,1285,1062
16056,1,0,25,0,-25
16057,1,1,1138,1269,131
16058,0,0,1,0,-1
16059,1,1,469,1598,1129
16060,1,0,156,0,-156
16061,1,0,87,0,-87
16062,0,0,79,0,-79
16063,1,1,307,1236,929
16064,1,0,142,0,-142
16065,1,0,26,0,-26
16066,0,0,14,0,-14
16067,1,0,33,0,-33
16068,0,0,59,0,-59
16069,1,1,187,1383,1196
16070,0,0,3,0,-3
16071,0,0,8,0,-8
16072,1,0,38,0,-38
16073,1,1,3702,1396,-2306
16074,0,0,104,0,-104
16075,1,0,13,0,-13
16076,0,0,39,0,-39
16077,1,1,1265,1626,361
16078,1,1,467,1608,1141
16079,0,0,20,0,-20
16080,0,0,9,0,-9
16081,0,0,97,0,-97
16082,1,0,1,0,-1
16083,1,1,144,2042,1898
16084,1,0,127,0,-127
16085,1,1,242,1392,1150
16086,0,0,251,0,-251
16087,0,0,62,0,-62
16088,1,1,74,1653,1579
16089,1,0,65,0,-65
16090,1,1,223,1223,1000
16091,0,0,3,0,-3
16092,1,1,1208,1357,149
16093,0,0,29,0,-29
16094,1,0,44,0,-44
16095,0,0,88,0,-88
16096,0,0,40,0,-40
16097,0,0,79,0,-79
16098,1,0,32,0,-32
16099,1,1,339,1717,1378
16100,1,1,170,3501,3331
16101,1,1,1775,2827,1052
16102,0,0,135,0,-135
16103,0,0,35,0,-35
16104,1,0,144,0,-144
16105,1,1,401,1779,1378
16106,0,0,34,0,-34
16107,1,0,48,0,-48
16108,0,0,132,0,-132
16109,1,0,10,0,-10
16110,1,1,428,2266,1838
16111,1,1,424,1313,889
16112,1,0,61,0,-61
16113,1,0,221,0,-221
16114,0,0,35,0,-35
16115,0,0,18,0,-18
16116,1,0,68,0,-68
16117,1,1,246,1278,1032
16118,0,0,10,0,-10
16119,0,0,18,0,-18
16120,0,0,6,0,-6
16121,0,0,3,0,-3
16122,1,1,160,1478,1318
16123,1,1,43,1275,1232
16124,1,1,133,2811,2678
16125,0,0,94,0,-94
16126,1,0,56,0,-56
16127,0,0,15,0,-15
16128,0,0,111,0,-111
16129,0,0,37,0,-37
16130,1,0,57,0,-57
16131,1,1,490,1282,792
16132,1,0,60,0,-60
16133,1,0,89,0,-89
16134,1,0,55,0,-55
16135,1,0,51,0,-51
16136,0,0,75,0,-75
16137,1,1,972,1766,794
16138,1,1,395,4272,3877
16139,1,0,8,0,-8
16140,0,0,63,0,-63
16141,1,0,63,0,-63
16142,0,0,5,0,-5
16143,1,1,293,1245,952
16144,1,1,13,1390,1377
16145,0,0,90,0,-90
16146,1,1,798,2263,1465
16147,1,1,293,1379,1086
16148,0,0,51,0,-51
16149,1,1,342,1654,1312
16150,1,0,149,0,-149
16151,1,0,48,0,-48
16152,1,1,706,1266,560
16153,1,1,803,2512,1709
16154,1,1,174,2581,2407
16155,1,1,805,1266,461
16156,1,1,583,1469,886
16157,0,0,5,0,-5
16158,1,0,31,0,-31
16159,0,0,18,0,-18
16160,1,1,634,2509,1875
16161,0,0,16,0,-16
16162,1,0,88,0,-88
16163,0,0,34,0,-34
16164,0,0,107,0,-107
16165,0,0,25,0,-25
16166,1,1,756,1427,671
16167,1,0,81,0,-81
16168,1,0,4,0,-4
16169,0,0,29,0,-29
16170,0,0,1,0,-1
16171,0,0,36,0,-36
16172,0,0,42,0,-42
16173,0,0,12,0,-12
16174,0,0,114,0,-114
16175,1,0,96,0,-96
16176,0,0,33,0,-33
16177,1,0,27,0,-27
16178,1,0,36,0,-36
16179,1,1,666,4239,3573
16180,0,0,43,0,-43
16181,1,1,696,1217,521
16182,1,0,23,0,-23
16183,0,0,58,0,-58
16184,1,1,940,1393,453
16185,1,1,64,3511,3447
16186,1,1,590,1946,1356
16187,1,0,2,0,-2
16188,1,0,78,0,-78
16189,1,0,16,0,-16
16190,1,1,477,1948,1471
16191,0,0,58,0,-58
16192,0,0,29,0,-29
16193,1,0,17,0,-17
16194,1,1,194,1831,1637
16195,1,1,692,1277,585
16196,1,1,158,1535,1377
16197,1,1,431,1284,853
16198,1,0,13,0,-13
16199,0,0,86,0,-86
16200,1,1,166,1632,1466
16201,1,0,15,0,-15
16202,0,0,56,0,-56
16203,1,0,8,0,-8
16204,0,0,63,0,-63
16205,0,0,33,0,-33
16206,1,1,338,1247,909
16207,1,1,381,1289,908
16208,1,1,69,1324,1255
16209,0,0,2,0,-2
16210,1,0,132,0,-132
16211,1,0,222,0,-222
16212,1,0,24,0,-24
16213,1,0,37,0,-37
16214,0,0,41,0,-41
16215,0,0,2,0,-2
16216,0,0,73,0,-73
16217,0,0,15,0,-15
16218,0,0,0,0,0
16219,1,1,461,1647,1186
16220,1,0,104,0,-104
16221,0,0,11,0,-11
16222,1,1,363,1565,1202
16223,1,0,22,0,-22
16224,1,0,93,0,-93
16225,1,1,381,1267,886
16226,1,0,115,0,-115
16227,1,1,33,1311,1278
16228,0,0,44,0,-44
16229,1,1,399,1651,1252
16230,0,0,113,0,-113
16231,1,1,304,1214,910
16232,0,0,61,0,-61
16233,1,0,7,0,-7
16234,1,1,187,3051,2864
16235,1,1,71,1207,1136
16236,1,1,408,1823,1415
16237,1,1,334,1601,1267
16238,1,1,1173,1442,269
16239,1,1,449,1258,809
16240,0,0,39,0,-39
16241,0,0,160,0,-160
16242,1,0,28,0,-28
16243,0,0,52,0,-52
16244,1,1,977,1320,343
16245,1,1,109,1483,1374
16246,0,0,31,0,-31
16247,0,0,120,0,-120
16248,1,0,105,0,-105
16249,0,0,20,0,-20
16250,0,0,47,0,-47
16251,0,0,21,0,-21
16252,0,0,58,0,-58
16253,0,0,48,0,-48
16254,0,0,101,0,-101
16255,0,0,21,0,-21
16256,1,1,310,1318,1008
16257,1,0,130,0,-130
16258,1,1,286,1431,1145
16259,1,1,31,1254,1223
16260,0,0,1,0,-1
16261,1,0,76,0,-76
16262,0,0,21,0,-21
16263,1,0,4,0,-4
16264,1,0,22,0,-22
16265,1,0,72,0,-72
16266,0,0,185,0,-185
16267,1,0,74,0,-74
16268,1,1,532,1649,1117
16269,1,0,68,0,-68
16270,1,0,149,0,-149
16271,0,0,35,0,-35
16272,1,1,997,1399,402
16273,1,1,523,1728,1205
16274,0,0,4,0,-4
16275,1,1,73,1221,1148
16276,0,0,20,0,-20
16277,0,0,71,0,-71
16278,1,0,16,0,-16
16279,1,0,26,0,-26
16280,1,1,1218,1471,253
16281,0,0,52,0,-52
16282,1,0,56,0,-56
16283,1,0,13,0,-13
16284,0,0,0,0,0
16285,0,0,41,0,-41
16286,0,0,3,0,-3
16287,0,0,10,0,-10
16288,1,0,3,0,-3
16289,0,0,10,0,-10
16290,1,0,72,0,-72
16291,1,0,7,0,-7
16292,1,1,102,2675,2573
16293,1,1,433,1783,1350
16294,0,0,25,0,-25
16295,1,1,115,1207,1092
16296,0,0,23,0,-23
16297,1,1,120,1587,1467
16298,1,0,68,0,-68
16299,0,0,49,0,-49
16300,1,0,15,0,-15
16301,0,0,109,0,-109
16302,1,0,91,0,-91
16303,0,0,16,0,-16
16304,0,0,0,0,0
16305,1,1,828,1631,803
16306,1,0,12,0,-12
16307,1,1,189,2103,1914
16308,0,0,93,0,-93
16309,1,1,2043,1257,-786
16310,1,0,82,0,-82
16311,1,0,50,0,-50
16312,0,0,122,0,-122
16313,1,1,135,1492,1357
16314,0,0,27,0,-27
16315,0,0,67,0,-67
16316,1,1,530,2037,1507
16317,0,0,2,0,-2
16318,0,0,1,0,-1
16319,0,0,40,0,-40
16320,1,0,18,0,-18
16321,1,0,11,0,-11
16322,1,1,2048,2183,135
16323,0,0,89,0,-89
16324,1,1,883,1604,721
16325,0,0,1,0,-1
16326,0,0,21,0,-21
16327,1,1,514,1372,858
16328,1,1,1464,1316,-148
16329,1,0,6,0,-6
16330,0,0,162,0,-162
16331,1,0,199,0,-199
16332,0,0,76,0,-76
16333,1,1,99,1230,1131
16334,1,1,1544,2249,705
16335,1,1,635,2601,1966
16336,1,0,50,0,-50
16337,1,1,525,1655,1130
16338,1,1,232,1495,1263
16339,1,1,361,1517,1156
16340,1,0,25,0,-25
16341,1,1,721,2370,1649
16342,1,1,1985,1292,-693
16343,0,0,120,0,-120
16344,0,0,81,0,-81
16345,1,1,329,1823,1494
16346,0,0,139,0,-139
16347,1,0,8,0,-8
16348,0,0,5,0,-5
16349,1,0,11,0,-11
16350,0,0,41,0,-41
16351,1,1,303,1244,941
16352,1,0,45,0,-45
16353,0,0,58,0,-58
16354,1,0,158,0,-158
16355,0,0,66,0,-66
16356,0,0,15,0,-15
16357,0,0,26,0,-26
16358,1,1,199,1493,1294
16359,1,1,527,1330,803
16360,1,0,28,0,-28
16361,0,0,98,0,-98
16362,0,0,35,0,-35
16363,1,1,565,1569,1004
16364,1,0,11,0,-11
16365,0,0,7,0,-7
16366,1,1,330,1543,1213
16367,0,0,46,0,-46
16368,1,0,5,0,-5
16369,0,0,12,0,-12
16370,0,0,4,0,-4
16371,1,1,706,3187,2481
16372,1,1,1142,2325,1183
16373,0,0,11,0,-11
16374,1,0,23,0,-23
16375,1,1,360,1341,981
16376,1,0,0,0,0
16377,0,0,17,0,-17
16378,0,0,6,0,-6
16379,1,1,393,1331,938
16380,1,0,70,0,-70
16381,0,0,89,0,-89
16382,1,0,3,0,-3
16383,0,0,35,0,-35
16384,0,0,24,0,-24
16385,1,1,760,1558,798
16386,0,0,95,0,-95
16387,0,0,38,0,-38
16388,1,0,23,0,-23
16389,1,1,251,1566,1315
16390,1,0,16,0,-16
16391,1,1,78,2439,2361
16392,1,0,25,0,-25
16393,1,0,4,0,-4
16394,1,0,55,0,-55
16395,0,0,3,0,-3
16396,1,0,22,0,-22
16397,1,0,22,0,-22
16398,1,1,653,1236,583
16399,1,1,1414,1201,-213
16400,0,0,24,0,-24
16401,0,0,1,0,-1
16402,1,1,84,1424,1340
16403,1,0,206,0,-206
16404,1,1,125,2095,1970
16405,0,0,38,0,-38
16406,1,0,54,0,-54
16407,1,0,8,0,-8
16408,1,1,225,1575,1350
16409,0,0,7,0,-7
16410,1,1,523,2200,1677
16411,1,1,414,1294,880
16412,1,1,261,1278,1017
16413,0,0,46,0,-46
16414,1,0,50,0,-50
16415,1,0,14,0,-14
16416,0,0,60,0,-60
16417,1,1,139,1952,1813
16418,1,0,0,0,0
16419,0,0,67,0,-67
16420,1,0,3,0,-3
16421,1,1,750,1271,521
16422,1,1,86,2077,1991
16423,1,1,443,1200,757
16424,0,0,1,0,-1
16425,1,1,1741,1694,-47
16426,0,0,6,0,-6
16427,1,0,11,0,-11
16428,0,0,85,0,-85
16429,0,0,10,0,-10
16430,1,0,68,0,-68
16431,1,1,103,1370,1267
16432,0,0,10,0,-10
16433,0,0,6,0,-6
16434,0,0,49,0,-49
16435,0,0,2,0,-2
16436,0,0,19,0,-19
16437,0,0,189,0,-189
16438,0,0,19,0,-19
16439,0,0,52,0,-52
16440,1,0,33,0,-33
16441,1,1,128,1520,1392
16442,1,0,40,0,-40
16443,1,1,1058,1532,474
16444,0,0,175,0,-175
16445,1,0,6,0,-6
16446,1,0,11,0,-11
16447,0,0,5,0,-5
16448,1,0,4,0,-4
16449,1,0,43,0,-43
16450,1,1,761,1222,461
16451,1,0,79,0,-79
16452,0,0,248,0,-248
16453,1,1,231,1579,1348
16454,1,0,186,0,-186
16455,1,1,750,1275,525
16456,1,0,12,0,-12
16457,1,0,1,0,-1
16458,1,0,76,0,-76
16459,1,1,333,1364,1031
16460,0,0,36,0,-36
16461,1,0,2,0,-2
16462,0,0,23,0,-23
16463,0,0,39,0,-39
16464,0,0,184,0,-184
16465,0,0,82,0,-82
16466,1,0,125,0,-125
16467,0,0,35,0,-35
16468,0,0,68,0,-68
16469,0,0,59,0,-59
16470,0,0,8,0,-8
16471,0,0,1,0,-1
16472,0,0,41,0,-41
16473,1,0,43,0,-43
16474,0,0,101,0,-101
16475,1,0,51,0,-51
16476,0,0,0,0,0
16477,1,0,42,0,-42
16478,1,1,204,1205,1001
16479,1,0,11,0,-11
16480,0,0,2,0,-2
16481,1,1,166,1372,1206
16482,0,0,37,0,-37
16483,0,0,73,0,-73
16484,0,0,112,0,-112
16485,1,0,83,0,-83
16486,1,0,0,0,0
16487,1,0,54,0,-54
16488,1,0,72,0,-72
16489,1,0,24,0,-24
16490,1,1,1105,1684,579
16491,0,0,9,0,-9
16492,0,0,5,0,-5
16493,1,0,31,0,-31
16494,1,1,409,1754,1345
16495,1,1,517,1521,1004
16496,1,1,100,1252,1152
16497,0,0,8,0,-8
16498,1,1,260,1561,1301
16499,0,0,38,0,-38
16500,0,0,100,0,-100
16501,1,0,88,0,-88
16502,1,1,270,1599,1329
16503,0,0,121,0,-121
16504,1,1,100,1683,1583
16505,1,0,94,0,-94
16506,0,0,4,0,-4
16507,1,1,110,1498,1388
16508,1,0,147,0,-147
16509,1,0,34,0,-34
16510,0,0,61,0,-61
16511,1,0,83,0,-83
16512,0,0,73,0,-73
16513,1,1,480,1256,776
16514,1,1,249,1362,1113
16515,0,0,7,0,-7
16516,1,1,355,1566,1211
16517,1,1,170,1293,1123
16518,1,1,854,1991,1137
16519,1,0,17,0,-17
16520,1,0,108,0,-108
16521,1,0,65,0,-65
16522,1,0,30,0,-30
16523,0,0,8,0,-8
16524,0,0,63,0,-63
16525,0,0,24,0,-24
16526,1,0,3,0,-3
16527,1,0,23,0,-23
16528,0,0,43,0,-43
16529,0,0,28,0,-28
16530,0,0,2,0,-2
16531,1,0,2,0,-2
16532,1,0,1,0,-1
16533,1,0,26,0,-26
16534,0,0,34,0,-34
16535,0,0,15,0,-15
16536,1,1,303,1577,1274
16537,0,0,3,0,-3
16538,1,1,754,1506,752
16539,0,0,23,0,-23
16540,1,1,1492,1281,-211
16541,0,0,30,0,-30
16542,1,0,109,0,-109
16543,1,0,24,0,-24
16544,1,0,18,0,-18
16545,1,0,8,0,-8
16546,1,1,897,2473,1576
16547,1,0,8,0,-8
16548,1,0,5,0,-5
16549,1,0,75,0,-75
16550,1,1,966,1304,338
16551,1,0,45,0,-45
16552,0,0,4,0,-4
16553,0,0,79,0,-79
16554,1,0,27,0,-27
16555,1,1,273,1269,996
16556,1,0,205,0,-205
16557,1,0,73,0,-73
16558,1,1,128,1541,1413
16559,0,0,33,0,-33
16560,1,1,704,1360,656
16561,1,1,77,1381,1304
16562,0,0,7,0,-7
16563,1,1,521,1299,778
16564,0,0,42,0,-42
16565,0,0,8,0,-8
16566,1,0,107,0,-107
16567,0,0,36,0,-36
16568,0,0,48,0,-48
16569,1,0,5,0,-5
16570,1,0,52,0,-52
16571,0,0,60,0,-60
16572,0,0,28,0,-28
16573,1,1,854,1286,432
16574,1,1,236,1383,1147
16575,1,0,43,0,-43
16576,1,1,918,1210,292
16577,1,0,206,0,-206
16578,0,0,15,0,-15
16579,1,1,262,1286,1024
16580,0,0,52,0,-52
16581,1,1,69,1477,1408
16582,1,1,136,1516,1380
16583,1,1,89,1282,1193
16584,1,1,113,1261,1148
16585,1,0,13,0,-13
16586,0,0,39,0,-39
16587,1,0,151,0,-151
16588,1,1,230,1357,1127
16589,0,0,2,0,-2
16590,1,0,49,0,-49
16591,1,1,283,1227,944
16592,1,0,120,0,-120
16593,0,0,56,0,-56
16594,0,0,3,0,-3
16595,1,0,146,0,-146
16596,0,0,3,0,-3
16597,0,0,10,0,-10
16598,0,0,6,0,-6
16599,1,1,63,1478,1415
16600,1,1,798,1794,996
16601,1,1,968,1523,555
16602,0,0,133,0,-133
16603,1,0,69,0,-69
16604,0,0,0,0,0
16605,0,0,32,0,-32
16606,0,0,29,0,-29
16607,0,0,8,0,-8
16608,1,1,329,1370,1041
16609,0,0,20,0,-20
16610,1,1,105,1236,1131
16611,1,0,25,0,-25
16612,1,0,23,0,-23
16613,0,0,29,0,-29
16614,1,1,241,1280,1039
16615,1,0,74,0,-74
16616,1,1,256,1461,1205
16617,1,1,1136,1596,460
16618,1,1,1884,1333,-551
16619,0,0,10,0,-10
16620,1,1,645,1662,1017
16621,1,0,30,0,-30
16622,0,0,21,0,-21
16623,1,0,67,0,-67
16624,0,0,59,0,-59
16625,1,1,282,1397,1115
16626,0,0,152,0,-152
16627,1,1,379,1702,1323
16628,0,0,76,0,-76
16629,1,0,64,0,-64
16630,0,0,46,0,-46
16631,0,0,18,0,-18
16632,0,0,36,0,-36
16633,1,1,199,1264,1065
16634,1,1,167,1383,1216
16635,1,0,7,0,-7
16636,1,0,4,0,-4
16637,0,0,2,0,-2
16638,0,0,29,0,-29
16639,1,0,16,0,-16
16640,1,0,32,0,-32
16641,1,0,60,0,-60
16642,1,0,100,0,-100
16643,0,0,27,0,-27
16644,1,0,84,0,-84
16645,1,1,96,1686,1590
16646,1,0,48,0,-48
16647,1,0,29,0,-29
16648,0,0,24,0,-24
16649,0,0,23,0,-23
16650,0,0,1,0,-1
16651,1,1,467,1475,1008
16652,0,0,0,0,0
16653,0,0,72,0,-72
16654,0,0,69,0,-69
16655,0,0,27,0,-27
16656,1,0,65,0,-65
16657,0,0,76,0,-76
16658,1,1,823,1404,581
16659,0,0,136,0,-136
16660,1,1,882,2319,1437
16661,1,1,477,2107,1630
16662,1,1,502,1808,1306
16663,1,1,274,1653,1379
16664,0,0,87,0,-87
16665,0,0,1,0,-1
16666,0,0,60,0,-60
16667,0,0,35,0,-35
16668,1,0,73,0,-73
16669,1,0,54,0,-54
16670,0,0,14,0,-14
16671,0,0,63,0,-63
16672,0,0,18,0,-18
16673,1,0,27,0,-27
16674,0,0,15,0,-15
16675,0,0,69,0,-69
16676,1,0,16,0,-16
16677,1,1,292,1509,1217
16678,1,0,9,0,-9
16679,1,1,5,1498,1493
16680,0,0,26,0,-26
16681,0,0,12,0,-12
16682,1,0,70,0,-70
16683,0,0,36,0,-36
16684,0,0,84,0,-84
16685,0,0,48,0,-48
16686,1,1,206,1641,1435
16687,0,0,57,0,-57
16688,0,0,43,0,-43
16689,0,0,4,0,-4
16690,0,0,166,0,-166
16691,1,0,5,0,-5
16692,1,1,2492,2245,-247
16693,1,0,71,0,-71
16694,1,1,266,1324,1058
16695,1,0,25,0,-25
16696,1,1,259,1333,1074
16697,1,0,27,0,-27
16698,1,0,1,0,-1
16699,0,0,156,0,-156
16700,0,0,4,0,-4
16701,0,0,53,0,-53
16702,0,0,111,0,-111
16703,1,0,43,0,-43
16704,1,0,399,0,-399
16705,0,0,49,0,-49
16706,0,0,33,0,-33
16707,0,0,1,0,-1
16708,0,0,120,0,-120
16709,1,1,2572,1747,-825
16710,1,1,1172,1362,190
16711,0,0,79,0,-79
16712,1,0,96,0,-96
16713,0,0,27,0,-27
16714,1,1,103,1438,1335
16715,1,1,1493,1583,90
16716,1,1,142,1214,1072
16717,1,0,17,0,-17
16718,1,1,186,1291,1105
16719,1,0,117,0,-117
16720,0,0,48,0,-48
16721,1,1,141,3862,3721
16722,0,0,8,0,-8
16723,1,0,142,0,-142
16724,1,1,383,1208,825
16725,1,1,416,1213,797
16726,1,0,41,0,-41
16727,1,1,149,1234,1085
16728,0,0,38,0,-38
16729,0,0,54,0,-54
16730,0,0,208,0,-208
16731,0,0,86,0,-86
16732,1,1,378,2025,1647
16733,1,1,463,3196,2733
16734,1,0,36,0,-36
16735,1,0,5,0,-5
16736,0,0,15,0,-15
16737,0,0,0,0,0
16738,1,0,23,0,-23
16739,1,0,31,0,-31
16740,0,0,25,0,-25
16741,1,0,6,0,-6
16742,1,0,56,0,-56
16743,1,1,146,1325,1179
16744,1,1,748,1524,776
16745,1,1,990,1393,403
16746,1,1,353,1511,1158
16747,1,1,778,1364,586
16748,1,1,1039,1211,172
16749,1,0,59,0,-59
16750,0,0,112,0,-112
16751,1,0,60,0,-60
16752,0,0,3,0,-3
16753,1,0,66,0,-66
16754,0,0,157,0,-157
16755,0,0,32,0,-32
16756,0,0,115,0,-115
16757,1,0,8,0,-8
16758,1,0,6,0,-6
16759,0,0,3,0,-3
16760,0,0,72,0,-72
16761,1,0,4,0,-4
16762,0,0,2,0,-2
16763,0,0,73,0,-73
16764,0,0,24,0,-24
16765,0,0,72,0,-72
16766,1,0,9,0,-9
16767,0,0,26,0,-26
16768,0,0,26,0,-26
16769,1,1,541,1343,802
16770,1,1,510,1867,1357
16771,1,1,74,2563,2489
16772,0,0,9,0,-9
16773,0,0,11,0,-11
16774,0,0,21,0,-21
16775,0,0,28,0,-28
16776,1,1,603,1396,793
16777,1,1,1322,1469,147
16778,0,0,10,0,-10
16779,1,1,1382,1220,-162
16780,0,0,3,0,-3
16781,1,1,2303,1267,-1036
16782,0,0,50,0,-50
16783,0,0,23,0,-23
16784,1,0,2,0,-2
16785,0,0,67,0,-67
16786,1,0,79,0,-79
16787,1,1,513,2475,1962
16788,0,0,43,0,-43
16789,0,0,31,0,-31
16790,1,0,128,0,-128
16791,1,1,494,1657,1163
16792,1,0,0,0,0
16793,1,1,379,1746,1367
16794,1,1,688,1336,648
16795,1,1,395,2473,2078
16796,0,0,27,0,-27
16797,1,0,29,0,-29
16798,1,1,372,4293,3921
16799,1,0,49,0,-49
16800,1,0,164,0,-164
16801,1,0,11,0,-11
16802,0,0,93,0,-93
16803,0,0,153,0,-153
16804,0,0,14,0,-14
16805,1,1,394,1369,975
16806,0,0,36,0,-36
16807,0,0,8,0,-8
16808,0,0,60,0,-60
16809,1,1,268,1268,1000
16810,0,0,58,0,-58
16811,1,1,155,1338,1183
16812,0,0,12,0,-12
16813,1,0,11,0,-11
16814,1,1,478,1317,839
16815,0,0,12,0,-12
16816,1,1,452,1234,782
16817,1,1,176,1434,1258
16818,1,0,42,0,-42
16819,0,0,64,0,-64
16820,1,1,385,2063,1678
16821,1,1,452,1387,935
16822,1,1,1591,1670,79
16823,1,1,421,3328,2907
16824,1,0,74,0,-74
16825,1,1,1074,1637,563
16826,0,0,57,0,-57
16827,1,1,360,1573,1213
16828,1,1,305,1285,980
16829,1,0,305,0,-305
16830,1,0,60,0,-60
16831,0,0,69,0,-69
16832,1,0,12,0,-12
16833,1,0,66,0,-66
16834,0,0,6,0,-6
16835,0,0,149,0,-149
16836,0,0,48,0,-48
16837,1,0,105,0,-105
16838,1,1,411,1456,1045
16839,1,1,419,3680,3261
16840,0,0,32,0,-32
16841,0,0,20,0,-20
16842,1,0,25,0,-25
16843,1,1,30,2997,2967
16844,1,1,362,2501,2139
16845,1,1,415,2222,1807
16846,0,0,0,0,0
16847,1,0,44,0,-44
16848,0,0,141,0,-141
16849,1,1,973,1238,265
16850,1,1,605,1593,988
16851,0,0,114,0,-114
16852,1,1,132,1247,1115
16853,1,1,521,1608,1087
16854,0,0,3,0,-3
16855,1,0,40,0,-40
16856,0,0,4,0,-4
16857,1,1,81,2264,2183
16858,0,0,138,0,-138
16859,1,0,26,0,-26
16860,1,1,808,1222,414
16861,1,1,972,1737,765
16862,1,1,236,1922,1686
16863,1,1,219,1213,994
16864,1,1,769,1203,434
16865,1,0,36,0,-36
16866,1,0,26,0,-26
16867,1,0,38,0,-38
16868,1,0,85,0,-85
16869,1,1,230,1331,1101
16870,1,1,130,1481,1351
16871,0,0,108,0,-108
16872,0,0,22,0,-22
16873,1,0,11,0,-11
16874,0,0,11,0,-11
16875,1,0,21,0,-21
16876,0,0,32,0,-32
16877,1,0,30,0,-30
16878,1,1,131,2335,2204
16879,0,0,9,0,-9
16880,1,0,44,0,-44
16881,0,0,40,0,-40
16882,0,0,53,0,-53
16883,0,0,17,0,-17
16884,0,0,106,0,-106
16885,0,0,81,0,-81
16886,0,0,141,0,-141
16887,1,1,68,1218,1150
16888,0,0,0,0,0
16889,0,0,10,0,-10
16890,1,1,84,1230,1146
16891,0,0,36,0,-36
16892,1,0,66,0,-66
16893,1,1,801,2203,1402
16894,0,0,92,0,-92
16895,1,0,28,0,-28
16896,0,0,49,0,-49
16897,1,1,505,1450,945
16898,1,0,12,0,-12
16899,0,0,84,0,-84
16900,1,0,51,0,-51
16901,1,0,129,0,-129
16902,0,0,334,0,-334
16903,0,0,1,0,-1
16904,1,1,942,1339,397
16905,1,1,278,1212,934
16906,0,0,13,0,-13
16907,0,0,7,0,-7
16908,1,1,283,2066,1783
16909,0,0,88,0,-88
16910,0,0,25,0,-25
16911,0,0,4,0,-4
16912,0,0,12,0,-12
16913,0,0,22,0,-22
16914,1,1,174,1676,1502
16915,1,0,24,0,-24
16916,1,1,147,3793,3646
16917,0,0,36,0,-36
16918,1,0,36,0,-36
16919,1,0,23,0,-23
16920,1,0,127,0,-127
16921,0,0,13,0,-13
16922,0,0,38,0,-38
16923,1,0,54,0,-54
16924,1,0,206,0,-206
16925,0,0,2,0,-2
16926,0,0,13,0,-13
16927,1,1,859,1386,527
16928,0,0,60,0,-60
16929,1,0,48,0,-48
16930,0,0,6,0,-6
16931,1,0,34,0,-34
16932,0,0,84,0,-84
16933,1,0,160,0,-160
16934,1,0,1,0,-1
16935,0,0,9,0,-9
16936,1,1,565,1220,655
16937,0,0,41,0,-41
16938,1,1,519,1413,894
16939,1,0,34,0,-34
16940,0,0,10,0,-10
16941,1,1,102,1395,1293
16942,1,0,3,0,-3
16943,1,0,37,0,-37
16944,0,0,111,0,-111
16945,0,0,9,0,-9
16946,0,0,50,0,-50
16947,1,1,46,2009,1963
16948,1,0,33,0,-33
16949,1,1,420,1804,1384
16950,1,0,4,0,-4
16951,1,0,28,0,-28
16952,0,0,4,0,-4
16953,0,0,63,0,-63
16954,1,1,546,1237,691
16955,1,0,0,0,0
16956,1,1,391,1285,894
16957,1,0,13,0,-13
16958,0,0,88,0,-88
16959,1,1,738,2035,1297
16960,0,0,21,0,-21
16961,0,0,20,0,-20
16962,1,0,0,0,0
16963,0,0,11,0,-11
16964,1,1,379,1216,837
16965,1,1,1249,2299,1050
16966,1,1,1043,1216,173
16967,0,0,37,0,-37
16968,1,0,47,0,-47
16969,0,0,46,0,-46
16970,1,1,117,1251,1134
16971,1,1,1161,2128,967
16972,0,0,1,0,-1
16973,1,1,141,2282,2141
16974,1,0,24,0,-24
16975,1,1,1841,4264,2423
16976,1,1,292,1536,1244
16977,0,0,16,0,-16
16978,1,0,45,0,-45
16979,1,0,15,0,-15
16980,0,0,97,0,-97
16981,1,0,36,0,-36
16982,1,0,53,0,-53
16983,0,0,32,0,-32
16984,0,0,10,0,-10
16985,1,0,178,0,-178
16986,0,0,119,0,-119
16987,1,1,1938,1565,-373
16988,0,0,90,0,-90
16989,1,1,181,1377,1196
16990,1,1,56,1483,1427
16991,0,0,92,0,-92
16992,0,0,30,0,-30
16993,1,1,166,1255,1089
16994,1,0,5,0,-5
16995,0,0,89,0,-89
16996,0,0,5,0,-5
16997,1,1,482,1525,1043
16998,1,0,43,0,-43
16999,1,0,3,0,-3
17000,0,0,27,0,-27
17001,0,0,67,0,-67
17002,1,1,304,1421,1117
17003,1,0,78,0,-78
17004,1,0,64,0,-64
17005,0,0,41,0,-41
17006,1,1,333,1921,1588
17007,0,0,19,0,-19
17008,1,0,36,0,-36
17009,1,0,59,0,-59
17010,1,0,51,0,-51
17011,0,0,153,0,-153
17012,1,1,1237,1561,324
17013,1,0,8,0,-8
17014,1,1,88,1280,1192
17015,0,0,8,0,-8
17016,1,0,78,0,-78
17017,0,0,128,0,-128
17018,1,1,175,1735,1560
17019,1,1,675,1275,600
17020,1,1,182,1238,1056
17021,0,0,23,0,-23
17022,1,1,205,1305,1100
17023,1,1,219,1292,1073
17024,0,0,20,0,-20
17025,0,0,18,0,-18
17026,0,0,0,0,0
17027,0,0,3,0,-3
17028,1,1,273,1243,970
17029,1,1,1466,1618,152
17030,0,0,11,0,-11
17031,1,0,42,0,-42
17032,1,1,687,1577,890
17033,1,0,10,0,-10
17034,1,0,28,0,-28
17035,0,0,31,0,-31
17036,0,0,43,0,-43
17037,1,1,233,1250,1017
17038,1,0,26,0,-26
17039,0,0,9,0,-9
17040,1,0,28,0,-28
17041,0,0,68,0,-68
17042,1,1,289,1445,1156
17043,1,0,78,0,-78
17044,0,0,132,0,-132
17045,1,1,621,1233,612
17046,1,1,2483,1302,-1181
17047,0,0,63,0,-63
17048,1,0,39,0,-39
17049,1,1,226,1284,1058
17050,0,0,59,0,-59
17051,0,0,35,0,-35
17052,1,0,47,0,-47
17053,1,0,11,0,-11
17054,0,0,48,0,-48
17055,1,0,26,0,-26
17056,0,0,19,0,-19
17057,1,0,7,0,-7
17058,1,1,131,1834,1703
17059,0,0,15,0,-15
17060,1,0,30,0,-30
17061,1,1,194,1686,1492
17062,1,1,989,1697,708
17063,1,1,851,1239,388
17064,1,0,16,0,-16
17065,0,0,12,0,-12
17066,1,1,573,1278,705
17067,0,0,122,0,-122
17068,0,0,27,0,-27
17069,1,0,25,0,-25
17070,1,1,420,2097,1677
17071,1,0,113,0,-113
17072,1,1,101,1751,1650
17073,1,1,522,1260,738
17074,1,1,81,1384,1303
17075,1,1,235,2260,2025
17076,1,0,55,0,-55
17077,0,0,103,0,-103
17078,0,0,49,0,-49
17079,1,0,97,0,-97
17080,0,0,16,0,-16
17081,1,1,768,1332,564
17082,1,1,282,1440,1158
17083,1,1,1428,1302,-126
17084,1,0,32,0,-32
17085,0,0,0,0,0
17086,1,0,79,0,-79
17087,0,0,39,0,-39
17088,1,0,13,0,-13
17089,1,0,14,0,-14
17090,1,1,2160,1225,-935
17091,0,0,79,0,-79
17092,0,0,2,0,-2
17093,0,0,19,0,-19
17094,0,0,23,0,-23
17095,0,0,60,0,-60
17096,0,0,45,0,-45
17097,1,0,60,0,-60
17098,0,0,37,0,-37
17099,0,0,161,0,-161
17100,1,0,27,0,-27
17101,1,1,215,1625,1410
17102,0,0,41,0,-41
17103,0,0,11,0,-11
17104,1,0,40,0,-40
17105,1,1,151,1717,1566
17106,1,0,185,0,-185
17107,1,0,128,0,-128
17108,0,0,2,0,-2
17109,1,1,894,1357,463
17110,0,0,31,0,-31
17111,1,0,32,0,-32
17112,1,0,31,0,-31
17113,0,0,133,0,-133
17114,0,0,71,0,-71
17115,0,0,118,0,-118
17116,1,0,105,0,-105
17117,0,0,4,0,-4
17118,0,0,0,0,0
17119,1,0,68,0,-68
17120,0,0,7,0,-7
17121,0,0,14,0,-14
17122,1,0,79,0,-79
17123,1,0,61,0,-61
17124,1,0,18,0,-18
17125,0,0,13,0,-13
17126,0,0,8,0,-8
17127,1,0,34,0,-34
17128,0,0,71,0,-71
17129,1,0,26,0,-26
17130,0,0,16,0,-16
17131,1,0,12,0,-12
17132,0,0,3,0,-3
17133,1,0,74,0,-74
17134,0,0,52,0,-52
17135,1,1,625,1493,868
17136,1,0,10,0,-10
17137,1,1,383,1631,1248
17138,0,0,73,0,-73
17139,0,0,6,0,-6
17140,1,0,89,0,-89
17141,0,0,18,0,-18
17142,1,1,232,1247,1015
17143,0,0,119,0,-119
17144,0,0,16,0,-16
17145,0,0,98,0,-98
17146,1,0,234,0,-234
17147,1,0,175,0,-175
17148,1,0,12,0,-12
17149,0,0,62,0,-62
17150,1,1,622,1505,883
17151,0,0,142,0,-142
17152,1,0,51,0,-51
17153,0,0,27,0,-27
17154,0,0,171,0,-171
17155,0,0,35,0,-35
17156,0,0,9,0,-9
17157,1,1,600,1219,619
17158,1,0,83,0,-83
17159,0,0,30,0,-30
17160,1,0,106,0,-106
17161,0,0,29,0,-29
17162,1,0,60,0,-60
17163,1,1,115,1783,1668
17164,1,0,9,0,-9
17165,1,1,422,2155,1733
17166,1,0,56,0,-56
17167,0,0,42,0,-42
17168,1,1,190,1498,1308
17169,1,1,433,1448,1015
17170,1,0,99,0,-99
17171,1,0,27,0,-27
17172,0,0,128,0,-128
17173,0,0,0,0,0
17174,0,0,20,0,-20
17175,1,1,990,1256,266
17176,0,0,1,0,-1
17177,1,0,15,0,-15
17178,1,1,436,1456,1020
17179,1,0,25,0,-25
17180,1,1,615,1943,1328
17181,1,0,46,0,-46
17182,1,0,39,0,-39
17183,1,0,2,0,-2
17184,1,1,26,1532,1506
17185,0,0,25,0,-25
17186,1,0,55,0,-55
17187,1,0,48,0,-48
17188,1,1,93,1966,1873
17189,0,0,8,0,-8
17190,0,0,11,0,-11
17191,0,0,29,0,-29
17192,1,1,332,1287,955
17193,1,0,72,0,-72
17194,1,0,84,0,-84
17195,1,1,481,2432,1951
17196,1,0,16,0,-16
17197,1,0,68,0,-68
17198,1,0,94,0,-94
17199,0,0,45,0,-45
17200,1,0,40,0,-40
17201,1,0,21,0,-21
17202,1,0,35,0,-35
17203,0,0,5,0,-5
17204,1,0,34,0,-34
17205,0,0,22,0,-22
17206,1,1,368,1330,962
17207,1,0,6,0,-6
17208,1,1,376,1513,1137
17209,1,1,205,1717,1512
17210,1,1,1672,1367,-305
17211,1,1,252,1327,1075
17212,1,0,64,0,-64
17213,0,0,124,0,-124
17214,1,0,20,0,-20
17215,0,0,20,0,-20
17216,1,1,197,2043,1846
17217,1,1,386,4847,4461
17218,1,0,25,0,-25
17219,0,0,13,0,-13
17220,0,0,84,0,-84
17221,1,0,0,0,0
17222,1,1,566,2311,1745
17223,1,0,0,0,0
17224,0,0,16,0,-16
17225,0,0,68,0,-68
17226,1,1,841,1630,789
17227,1,1,153,1244,1091
17228,0,0,81,0,-81
17229,1,1,1012,1797,785
17230,1,0,92,0,-92
17231,0,0,153,0,-153
17232,1,0,19,0,-19
17233,1,1,680,1225,545
17234,0,0,98,0,-98
17235,0,0,121,0,-121
17236,0,0,40,0,-40
17237,0,0,84,0,-84
17238,1,1,921,1274,353
17239,1,0,1,0,-1
17240,1,1,115,1848,1733
17241,0,0,6,0,-6
17242,1,0,52,0,-52
17243,1,0,25,0,-25
17244,0,0,9,0,-9
17245,1,0,15,0,-15
17246,1,1,288,3838,3550
17247,0,0,19,0,-19
17248,1,0,140,0,-140
17249,1,1,472,1390,918
17250,0,0,54,0,-54
17251,0,0,23,0,-23
17252,0,0,8,0,-8
17253,1,1,538,1556,1018
17254,1,1,108,1372,1264
17255,0,0,40,0,-40
17256,1,0,9,0,-9
17257,1,0,14,0,-14
17258,1,0,10,0,-10
17259,1,1,948,1330,382
17260,1,0,61,0,-61
17261,1,0,54,0,-54
17262,1,1,945,1310,365
17263,1,0,23,0,-23
17264,1,1,576,1282,706
17265,1,1,331,1270,939
17266,1,1,648,2359,1711
17267,0,0,159,0,-159
17268,0,0,14,0,-14
17269,0,0,109,0,-109
17270,1,1,223,1842,1619
17271,1,0,1,0,-1
17272,0,0,64,0,-64
17273,1,1,485,2768,2283
17274,1,1,1811,1378,-433
17275,1,1,770,1223,453
17276,1,0,111,0,-111
17277,1,0,19,0,-19
17278,1,1,972,1594,622
17279,1,0,203,0,-203
17280,1,0,42,0,-42
17281,1,0,53,0,-53
17282,1,1,478,1402,924
17283,0,0,69,0,-69
17284,1,1,168,1677,1509
17285,0,0,54,0,-54
17286,0,0,41,0,-41
17287,1,1,86,1202,1116
17288,1,0,22,0,-22
17289,1,1,196,1217,1021
17290,1,1,100,1328,1228
17291,0,0,6,0,-6
17292,1,0,56,0,-56
17293,1,0,4,0,-4
17294,1,0,129,0,-129
17295,1,0,5,0,-5
17296,1,1,126,1220,1094
17297,0,0,20,0,-20
17298,1,0,14,0,-14
17299,0,0,15,0,-15
17300,1,1,156,1366,1210
17301,0,0,7,0,-7
17302,0,0,7,0,-7
17303,1,1,778,1426,648
17304,1,1,482,1475,993
17305,1,1,386,1235,849
17306,1,0,50,0,-50
17307,0,0,24,0,-24
17308,1,0,27,0,-27
17309,0,0,28,0,-28
17310,1,1,326,1223,897
17311,1,0,24,0,-24
17312,1,1,1455,1919,464
17313,1,0,14,0,-14
17314,0,0,4,0,-4
17315,0,0,3,0,-3
17316,1,0,16,0,-16
17317,1,1,956,1624,668
17318,1,0,14,0,-14
17319,1,0,51,0,-51
17320,1,0,16,0,-16
17321,1,1,461,1516,1055
17322,1,0,52,0,-52
17323,1,0,196,0,-196
17324,1,1,1310,1382,72
17325,0,0,5,0,-5
17326,1,0,103,0,-103
17327,1,1,119,1467,1348
17328,0,0,86,0,-86
17329,1,1,75,1603,1528
17330,1,0,84,0,-84
17331,1,0,55,0,-55
17332,0,0,26,0,-26
17333,1,1,348,1442,1094
17334,1,1,198,5231,5033
17335,0,0,29,0,-29
17336,1,1,288,1826,1538
17337,0,0,8,0,-8
17338,0,0,3,0,-3
17339,1,1,1017,1498,481
17340,1,0,71,0,-71
17341,1,0,146,0,-146
17342,0,0,12,0,-12
17343,1,0,28,0,-28
17344,0,0,3,0,-3
17345,1,0,38,0,-38
17346,1,0,98,0,-98
17347,1,1,479,1601,1122
17348,0,0,83,0,-83
17349,1,0,47,0,-47
17350,1,1,547,2376,1829
17351,1,1,6,1595,1589
17352,1,1,776,1230,454
17353,0,0,26,0,-26
17354,1,0,0,0,0
17355,0,0,88,0,-88
17356,1,1,162,2078,1916
17357,1,0,13,0,-13
17358,0,0,43,0,-43
17359,1,0,74,0,-74
17360,1,0,75,0,-75
17361,0,0,54,0,-54
17362,1,0,86,0,-86
17363,0,0,22,0,-22
17364,1,0,28,0,-28
17365,0,0,124,0,-124
17366,1,1,338,1552,1214
17367,0,0,56,0,-56
17368,0,0,180,0,-180
17369,0,0,37,0,-37
17370,0,0,12,0,-12
17371,1,1,184,2440,2256
17372,1,0,13,0,-13
17373,0,0,2,0,-2
17374,1,0,1,0,-1
17375,1,0,119,0,-119
17376,1,0,62,0,-62
17377,1,0,39,0,-39
17378,1,1,1394,1854,460
17379,0,0,9,0,-9
17380,1,1,1675,1491,-184
17381,0,0,15,0,-15
17382,1,1,805,1431,626
17383,1,0,34,0,-34
17384,0,0,65,0,-65
17385,0,0,37,0,-37
17386,1,1,140,1297,1157
17387,0,0,4,0,-4
17388,1,1,294,1585,1291
17389,1,0,127,0,-127
17390,0,0,104,0,-104
17391,0,0,116,0,-116
17392,0,0,16,0,-16
17393,1,0,68,0,-68
17394,1,0,6,0,-6
17395,0,0,83,0,-83
17396,0,0,7,0,-7
17397,1,0,77,0,-77
17398,1,1,573,2221,1648
17399,1,0,23,0,-23
17400,0,0,5,0,-5
17401,1,1,404,1395,991
17402,0,0,2,0,-2
17403,1,1,1220,3685,2465
17404,1,1,861,1296,435
17405,1,0,20,0,-20
17406,1,1,254,1468,1214
17407,1,0,144,0,-144
17408,1,1,1137,1412,275
17409,0,0,11,0,-11
17410,0,0,6,0,-6
17411,0,0,38,0,-38
17412,1,0,19,0,-19
17413,0,0,78,0,-78
17414,1,1,60,1317,1257
17415,1,1,688,1254,566
17416,0,0,92,0,-92
17417,1,0,14,0,-14
17418,0,0,47,0,-47
17419,1,1,149,1338,1189
17420,1,1,488,1312,824
17421,1,1,1097,1952,855
17422,1,0,121,0,-121
17423,0,0,112,0,-112
17424,1,0,0,0,0
17425,1,0,9,0,-9
17426,0,0,69,0,-69
17427,0,0,44,0,-44
17428,1,1,1453,1286,-167
17429,0,0,1,0,-1
17430,1,1,550,1560,1010
17431,1,0,25,0,-25
17432,1,0,3,0,-3
17433,1,0,8,0,-8
17434,1,1,287,1429,1142
17435,1,0,0,0,0
17436,0,0,34,0,-34
17437,0,0,33,0,-33
17438,1,1,1289,1397,108
17439,0,0,14,0,-14
17440,0,0,20,0,-20
17441,1,0,33,0,-33
17442,1,0,3,0,-3
17443,1,0,12,0,-12
17444,1,1,822,1793,971
17445,0,0,39,0,-39
17446,0,0,59,0,-59
17447,1,0,68,0,-68
17448,0,0,21,0,-21
17449,1,1,1286,1464,178
17450,0,0,21,0,-21
17451,1,1,875,1506,631
17452,0,0,21,0,-21
17453,0,0,8,0,-8
17454,1,0,19,0,-19
17455,1,1,312,1628,1316
17456,0,0,41,0,-41
17457,0,0,31,0,-31
17458,1,0,122,0,-122
17459,1,0,27,0,-27
17460,0,0,55,0,-55
17461,0,0,139,0,-139
17462,1,1,1161,1335,174
17463,1,0,12,0,-12
17464,1,0,79,0,-79
17465,1,0,1,0,-1
17466,0,0,10,0,-10
17467,1,0,35,0,-35
17468,1,0,37,0,-37
17469,1,1,887,1478,591
17470,1,0,1,0,-1
17471,1,1,1160,1858,698
17472,1,0,36,0,-36
17473,1,1,253,1698,1445
17474,0,0,7,0,-7
17475,1,0,21,0,-21
17476,1,0,6,0,-6
17477,1,0,36,0,-36
17478,1,1,284,1436,1152
17479,1,1,587,1238,651
17480,1,0,53,0,-53
17481,1,1,495,1265,770
17482,1,0,78,0,-78
17483,0,0,4,0,-4
17484,0,0,40,0,-40
17485,1,1,78,1408,1330
17486,1,1,180,2179,1999
17487,1,0,0,0,0
17488,0,0,74,0,-74
17489,0,0,42,0,-42
17490,1,1,285,1322,1037
17491,1,1,243,1219,976
17492,0,0,52,0,-52
17493,1,1,416,1263,847
17494,1,1,493,1218,725
17495,1,0,74,0,-74
17496,1,0,1,0,-1
17497,1,1,1552,1310,-242
17498,0,0,68,0,-68
17499,1,0,74,0,-74
17500,0,0,36,0,-36
17501,1,0,2,0,-2
17502,1,0,174,0,-174
17503,0,0,29,0,-29
17504,0,0,25,0,-25
17505,0,0,113,0,-113
17506,0,0,33,0,-33
17507,1,1,1503,2505,1002
17508,1,0,8,0,-8
17509,0,0,6,0,-6
17510,1,1,152,1280,1128
17511,0,0,19,0,-19
17512,0,0,54,0,-54
17513,0,0,15,0,-15
17514,1,1,284,1413,1129
17515,1,0,9,0,-9
17516,1,0,100,0,-100
17517,0,0,142,0,-142
17518,1,0,42,0,-42
17519,1,1,272,1224,952
17520,0,0,71,0,-71
17521,1,1,568,1396,828
17522,1,0,65,0,-65
17523,1,0,60,0,-60
17524,0,0,73,0,-73
17525,1,0,1,0,-1
17526,1,1,638,2133,1495
17527,0,0,114,0,-114
17528,1,0,6,0,-6
17529,1,1,170,1588,1418
17530,0,0,10,0,-10
17531,1,1,301,1229,928
17532,0,0,60,0,-60
17533,0,0,141,0,-141
17534,1,0,60,0,-60
17535,0,0,0,0,0
17536,1,1,230,1438,1208
17537,1,0,31,0,-31
17538,1,0,29,0,-29
17539,0,0,38,0,-38
17540,0,0,17,0,-17
17541,0,0,98,0,-98
17542,1,0,23,0,-23
17543,0,0,72,0,-72
17544,1,0,108,0,-108
17545,1,1,1078,1281,203
17546,0,0,17,0,-17
17547,1,0,1,0,-1
17548,1,0,29,0,-29
17549,1,0,163,0,-163
17550,0,0,10,0,-10
17551,0,0,32,0,-32
17552,1,1,452,1521,1069
17553,0,0,9,0,-9
17554,0,0,30,0,-30
17555,0,0,1,0,-1
17556,1,1,591,1648,1057
17557,0,0,52,0,-52
17558,0,0,54,0,-54
17559,1,0,26,0,-26
17560,1,0,10,0,-10
17561,0,0,82,0,-82
17562,1,1,112,1292,1180
17563,0,0,27,0,-27
17564,1,0,23,0,-23
17565,0,0,5,0,-5
17566,0,0,104,0,-104
17567,0,0,40,0,-40
17568,0,0,101,0,-101
17569,0,0,12,0,-12
17570,1,1,604,1272,668
17571,0,0,112,0,-112
17572,1,1,343,1278,935
17573,1,0,5,0,-5
17574,0,0,27,0,-27
17575,1,1,236,3033,2797
17576,1,1,806,1599,793
17577,1,0,4,0,-4
17578,1,1,1492,1478,-14
17579,1,0,7,0,-7
17580,1,1,697,1424,727
17581,1,0,96,0,-96
17582,1,0,36,0,-36
17583,1,1,233,1241,1008
17584,1,1,77,1393,1316
17585,1,1,702,1267,565
17586,0,0,11,0,-11
17587,1,0,35,0,-35
17588,1,1,806,1671,865
17589,0,0,19,0,-19
17590,1,0,37,0,-37
17591,1,1,658,1226,568
17592,0,0,214,0,-214
17593,1,1,393,1966,1573
17594,1,1,207,1328,1121
17595,1,1,211,1240,1029
17596,1,1,275,1412,1137
17597,0,0,172,0,-172
17598,1,0,35,0,-35
17599,1,1,668,1238,570
17600,1,0,62,0,-62
17601,1,1,973,1884,911
17602,1,0,1,0,-1
17603,1,0,50,0,-50
17604,1,0,89,0,-89
17605,0,0,156,0,-156
17606,1,1,645,1532,887
17607,0,0,46,0,-46
17608,0,0,17,0,-17
17609,0,0,197,0,-197
17610,1,0,16,0,-16
17611,0,0,87,0,-87
17612,1,1,240,1315,1075
17613,1,0,135,0,-135
17614,1,1,3155,1344,-1811
17615,1,1,277,2068,1791
17616,1,1,1820,1269,-551
17617,1,1,538,1552,1014
17618,1,0,47,0,-47
17619,1,0,26,0,-26
17620,1,1,156,1585,1429
17621,1,0,108,0,-108
17622,0,0,72,0,-72
17623,0,0,40,0,-40
17624,1,0,138,0,-138
17625,1,0,48,0,-48
17626,0,0,59,0,-59
17627,1,0,6,0,-6
17628,1,1,79,1369,1290
17629,0,0,187,0,-187
17630,1,0,77,0,-77
17631,1,0,46,0,-46
17632,1,0,38,0,-38
17633,0,0,26,0,-26
17634,1,1,70,1563,1493
17635,1,0,11,0,-11
17636,1,1,405,1282,877
17637,0,0,14,0,-14
17638,1,1,83,1203,1120
17639,1,0,44,0,-44
17640,0,0,13,0,-13
17641,0,0,2,0,-2
17642,0,0,35,0,-35
17643,1,0,130,0,-130
17644,1,0,13,0,-13
17645,1,0,78,0,-78
17646,1,0,60,0,-60
17647,1,0,21,0,-21
17648,0,0,23,0,-23
17649,1,1,1104,1251,147
17650,0,0,113,0,-113
17651,1,0,1,0,-1
17652,1,1,894,1267,373
17653,0,0,49,0,-49
17654,1,1,201,1226,1025
17655,1,1,505,1966,1461
17656,0,0,11,0,-11
17657,0,0,13,0,-13
17658,0,0,54,0,-54
17659,0,0,72,0,-72
17660,1,1,629,2067,1438
17661,1,1,450,1954,1504
17662,1,1,405,1591,1186
17663,1,0,104,0,-104
17664,1,0,132,0,-132
17665,1,1,266,1321,1055
17666,1,1,272,1218,946
17667,0,0,21,0,-21
17668,1,0,34,0,-34
17669,1,1,477,1221,744
17670,0,0,3,0,-3
17671,1,0,40,0,-40
17672,0,0,31,0,-31
17673,1,0,13,0,-13
17674,1,1,206,2850,2644
17675,1,0,3,0,-3
17676,0,0,3,0,-3
17677,0,0,32,0,-32
17678,0,0,16,0,-16
17679,1,1,499,1735,1236
17680,1,0,49,0,-49
17681,1,1,1186,1291,105
17682,0,0,62,0,-62
17683,1,0,74,0,-74
17684,1,0,7,0,-7
17685,1,1,296,1639,1343
17686,1,1,493,1389,896
17687,1,0,46,0,-46
17688,1,0,11,0,-11
17689,0,0,57,0,-57
17690,0,0,17,0,-17
17691,0,0,30,0,-30
17692,1,0,4,0,-4
17693,0,0,56,0,-56
17694,0,0,101,0,-101
17695,0,0,20,0,-20
17696,1,0,57,0,-57
17697,1,1,94,1305,1211
17698,0,0,116,0,-116
17699,0,0,0,0,0
17700,0,0,17,0,-17
17701,1,1,448,1511,1063
17702,1,0,151,0,-151
17703,0,0,4,0,-4
17704,0,0,72,0,-72
17705,1,0,16,0,-16
17706,1,1,409,1535,1126
17707,1,0,104,0,-104
17708,0,0,19,0,-19
17709,1,1,342,1726,1384
17710,1,1,159,2171,2012
17711,0,0,30,0,-30
17712,1,1,198,1338,1140
17713,1,0,2,0,-2
17714,1,1,119,1274,1155
17715,1,1,616,1720,1104
17716,1,0,54,0,-54
17717,1,0,4,0,-4
17718,0,0,31,0,-31
17719,1,1,624,1356,732
17720,1,1,479,1594,1115
17721,0,0,114,0,-114
17722,1,0,108,0,-108
17723,1,1,116,1587,1471
17724,1,0,131,0,-131
17725,1,1,773,1597,824
17726,1,1,508,1245,737
17727,1,1,188,1829,1641
17728,1,1,883,1269,386
17729,1,0,111,0,-111
17730,0,0,4,0,-4
17731,1,0,95,0,-95
17732,1,0,237,0,-237
17733,1,0,13,0,-13
17734,0,0,25,0,-25
17735,1,1,203,1476,1273
17736,0,0,140,0,-140
17737,0,0,14,0,-14
17738,0,0,13,0,-13
17739,1,1,294,1332,1038
17740,1,1,863,1201,338
17741,0,0,58,0,-58
17742,1,1,22,1563,1541
17743,1,1,642,1615,973
17744,1,1,1128,1879,751
17745,0,0,45,0,-45
17746,1,0,33,0,-33
17747,0,0,128,0,-128
17748,1,1,478,1287,809
17749,0,0,50,0,-50
17750,1,1,690,1254,564
17751,0,0,16,0,-16
17752,0,0,31,0,-31
17753,0,0,8,0,-8
17754,1,1,1047,1759,712
17755,0,0,85,0,-85
17756,0,0,37,0,-37
17757,1,1,223,1246,1023
17758,0,0,67,0,-67
17759,1,0,11,0,-11
17760,1,0,4,0,-4
17761,1,1,208,3542,3334
17762,0,0,15,0,-15
17763,0,0,22,0,-22
17764,1,1,4,2339,2335
17765,1,1,170,1650,1480
17766,0,0,29,0,-29
17767,0,0,73,0,-73
17768,1,0,31,0,-31
17769,0,0,43,0,-43
17770,1,1,344,1473,1129
17771,1,0,249,0,-249
17772,1,1,391,1719,1328
17773,1,1,380,2718,2338
17774,1,1,624,1627,1003
17775,1,1,481,1348,867
17776,0,0,43,0,-43
17777,0,0,75,0,-75
17778,0,0,24,0,-24
17779,1,0,26,0,-26
17780,1,1,456,1324,868
17781,0,0,10,0,-10
17782,0,0,53,0,-53
17783,1,0,106,0,-106
17784,1,1,1463,2145,682
17785,0,0,141,0,-141
17786,0,0,48,0,-48
17787,0,0,4,0,-4
17788,1,1,92,1394,1302
17789,0,0,96,0,-96
17790,0,0,29,0,-29
17791,0,0,19,0,-19
17792,1,1,483,1364,881
17793,1,0,38,0,-38
17794,1,0,18,0,-18
17795,1,0,24,0,-24
17796,1,0,149,0,-149
17797,0,0,496,0,-496
17798,1,0,39,0,-39
17799,1,0,168,0,-168
17800,1,0,71,0,-71
17801,1,0,7,0,-7
17802,1,1,125,1234,1109
17803,0,0,37,0,-37
17804,1,0,60,0,-60
17805,1,0,33,0,-33
17806,0,0,6,0,-6
17807,1,1,278,1233,955
17808,0,0,24,0,-24
17809,1,0,149,0,-149
17810,0,0,26,0,-26
17811,1,0,47,0,-47
17812,0,0,13,0,-13
17813,1,0,83,0,-83
17814,0,0,50,0,-50
17815,1,1,108,1211,1103
17816,1,1,88,1282,1194
17817,0,0,149,0,-149
17818,1,1,142,1215,1073
17819,1,1,1862,1309,-553
17820,0,0,110,0,-110
17821,0,0,18,0,-18
17822,1,0,88,0,-88
17823,1,0,108,0,-108
17824,1,0,24,0,-24
17825,1,0,17,0,-17
17826,0,0,153,0,-153
17827,0,0,8,0,-8
17828,1,1,403,1244,841
17829,0,0,62,0,-62
17830,0,0,10,0,-10
17831,1,1,758,3640,2882
17832,0,0,45,0,-45
17833,0,0,49,0,-49
17834,1,1,45,1588,1543
17835,0,0,30,0,-30
17836,0,0,0,0,0
17837,0,0,1,0,-1
17838,1,1,183,1269,1086
17839,1,0,34,0,-34
17840,1,0,19,0,-19
17841,0,0,1,0,-1
17842,0,0,6,0,-6
17843,1,1,319,1320,1001
17844,1,0,6,0,-6
17845,0,0,4,0,-4
17846,0,0,39,0,-39
17847,0,0,82,0,-82
17848,1,1,276,1291,1015
17849,0,0,62,0,-62
17850,0,0,70,0,-70
17851,1,1,103,1211,1108
17852,1,0,105,0,-105
17853,0,0,25,0,-25
17854,1,0,70,0,-70
17855,1,1,578,1353,775
17856,0,0,30,0,-30
17857,1,0,8,0,-8
17858,0,0,14,0,-14
17859,1,0,2,0,-2
17860,1,0,2,0,-2
17861,1,1,1126,2926,1800
17862,0,0,34,0,-34
17863,0,0,96,0,-96
17864,1,0,35,0,-35
17865,1,1,368,1767,1399
17866,0,0,64,0,-64
17867,0,0,81,0,-81
17868,0,0,9,0,-9
17869,1,0,62,0,-62
17870,1,0,43,0,-43
17871,1,1,1722,1266,-456
17872,0,0,173,0,-173
17873,0,0,4,0,-4
17874,1,0,6,0,-6
17875,1,1,862,2224,1362
17876,1,0,32,0,-32
17877,1,0,5,0,-5
17878,1,0,18,0,-18
17879,1,1,199,1507,1308
17880,1,0,86,0,-86
17881,0,0,57,0,-57
17882,1,0,67,0,-67
17883,0,0,95,0,-95
17884,1,1,1064,1704,640
17885,1,0,305,0,-305
17886,1,0,13,0,-13
17887,1,1,162,1328,1166
17888,1,0,39,0,-39
17889,1,0,25,0,-25
17890,1,1,127,1633,1506
17891,1,1,361,1358,997
17892,1,1,273,1230,957
17893,1,0,6,0,-6
17894,1,1,174,1273,1099
17895,1,1,311,1712,1401
17896,1,1,626,1358,732
17897,0,0,73,0,-73
17898,1,0,14,0,-14
17899,1,0,1,0,-1
17900,1,0,19,0,-19
17901,1,1,729,1213,484
17902,1,0,3,0,-3
17903,0,0,11,0,-11
17904,1,0,87,0,-87
17905,1,0,13,0,-13
17906,1,0,120,0,-120
17907,1,1,243,1337,1094
17908,1,0,43,0,-43
17909,0,0,100,0,-100
17910,1,0,17,0,-17
17911,0,0,50,0,-50
17912,1,0,28,0,-28
17913,1,0,18,0,-18
17914,1,1,1613,2540,927
17915,1,1,487,1237,750
17916,1,0,62,0,-62
17917,1,0,8,0,-8
17918,0,0,29,0,-29
17919,0,0,11,0,-11
17920,0,0,66,0,-66
17921,0,0,68,0,-68
17922,0,0,5,0,-5
17923,1,1,905,1478,573
17924,1,1,272,1246,974
17925,0,0,73,0,-73
17926,1,0,17,0,-17
17927,1,1,152,1472,1320
17928,1,0,16,0,-16
17929,1,0,95,0,-95
17930,1,1,228,1285,1057
17931,0,0,3,0,-3
17932,1,1,602,1729,1127
17933,0,0,34,0,-34
17934,1,1,97,2841,2744
17935,1,1,743,1216,473
17936,0,0,5,0,-5
17937,1,1,1744,1318,-426
17938,1,1,285,1310,1025
17939,0,0,44,0,-44
17940,1,1,1167,1485,318
17941,1,0,56,0,-56
17942,0,0,141,0,-141
17943,0,0,34,0,-34
17944,1,1,271,1293,1022
17945,0,0,8,0,-8
17946,1,1,130,1204,1074
17947,1,1,1310,1984,674
17948,1,1,116,1650,1534
17949,1,1,415,2513,2098
17950,1,1,1280,2176,896
17951,1,0,16,0,-16
17952,1,1,881,1380,499
17953,1,1,316,1359,1043
17954,1,1,109,1689,1580
17955,0,0,31,0,-31
17956,0,0,129,0,-129
17957,1,0,9,0,-9
17958,0,0,1,0,-1
17959,0,0,84,0,-84
17960,1,1,165,2199,2034
17961,0,0,46,0,-46
17962,1,1,531,1333,802
17963,1,1,433,1443,1010
17964,1,0,51,0,-51
17965,1,0,47,0,-47
17966,0,0,13,0,-13
17967,0,0,65,0,-65
17968,1,1,120,3368,3248
17969,1,1,3163,1281,-1882
17970,0,0,79,0,-79
17971,0,0,59,0,-59
17972,0,0,48,0,-48
17973,1,0,10,0,-10
17974,0,0,148,0,-148
17975,0,0,38,0,-38
17976,1,1,232,1363,1131
17977,1,0,4,0,-4
17978,1,1,1430,1342,-88
17979,1,0,131,0,-131
17980,0,0,39,0,-39
17981,1,0,19,0,-19
17982,1,0,11,0,-11
17983,0,0,44,0,-44
17984,1,1,1178,2021,843
17985,0,0,2,0,-2
17986,0,0,29,0,-29
17987,0,0,102,0,-102
17988,0,0,4,0,-4
17989,1,1,571,1211,640
17990,1,1,293,1613,1320
17991,0,0,109,0,-109
17992,1,0,1,0,-1
17993,0,0,3,0,-3
17994,1,1,44,2587,2543
17995,1,0,129,0,-129
17996,1,1,198,1241,1043
17997,1,0,33,0,-33
17998,0,0,56,0,-56
17999,1,0,37,0,-37
18000,0,0,2,0,-2
18001,1,1,332,1549,1217
18002,1,1,451,1369,918
18003,1,1,239,1460,1221
18004,0,0,7,0,-7
18005,1,1,415,4084,3669
18006,1,1,427,1488,1061
18007,1,1,1587,1928,341
18008,1,1,762,1229,467
18009,0,0,91,0,-91
18010,0,0,25,0,-25
18011,1,1,173,1406,1233
18012,1,0,10,0,-10
18013,0,0,107,0,-107
18014,0,0,181,0,-181
18015,1,1,614,1328,714
18016,1,1,667,1281,614
18017,1,0,93,0,-93
18018,0,0,54,0,-54
18019,1,1,426,1685,1259
18020,1,1,370,2218,1848
18021,1,1,1682,1256,-426
18022,0,0,42,0,-42
18023,1,1,1108,1242,134
18024,0,0,13,0,-13
18025,1,1,1491,1332,-159
18026,1,1,594,1387,793
18027,1,1,1055,1424,369
18028,1,1,124,1354,1230
18029,0,0,74,0,-74
18030,0,0,18,0,-18
18031,0,0,33,0,-33
18032,0,0,10,0,-10
18033,0,0,89,0,-89
18034,1,1,568,1378,810
18035,0,0,25,0,-25
18036,0,0,14,0,-14
18037,1,1,312,1436,1124
18038,0,0,27,0,-27
18039,1,1,212,1528,1316
18040,0,0,80,0,-80
18041,1,0,3,0,-3
18042,0,0,17,0,-17
18043,1,1,2106,1499,-607
18044,1,0,22,0,-22
18045,0,0,84,0,-84
18046,1,0,61,0,-61
18047,1,0,15,0,-15
18048,0,0,33,0,-33
18049,1,0,95,0,-95
18050,1,0,84,0,-84
18051,1,1,1249,1560,311
18052,1,1,500,1375,875
18053,1,1,52,1225,1173
18054,0,0,30,0,-30
18055,1,0,41,0,-41
18056,1,0,63,0,-63
18057,1,0,9,0,-9
18058,1,0,48,0,-48
18059,1,0,18,0,-18
18060,1,1,275,1214,939
18061,1,1,318,1596,1278
18062,0,0,233,0,-233
18063,0,0,15,0,-15
18064,1,0,19,0,-19
18065,1,0,22,0,-22
18066,1,0,94,0,-94
18067,0,0,21,0,-21
18068,1,1,154,1664,1510
18069,0,0,116,0,-116
18070,1,1,14,2245,2231
18071,0,0,168,0,-168
18072,0,0,86,0,-86
18073,1,0,12,0,-12
18074,0,0,72,0,-72
18075,1,0,31,0,-31
18076,1,0,2,0,-2
18077,1,0,50,0,-50
18078,1,0,39,0,-39
18079,0,0,26,0,-26
18080,1,0,62,0,-62
18081,0,0,75,0,-75
18082,0,0,7,0,-7
18083,1,0,2,0,-2
18084,1,1,1349,1244,-105
18085,1,1,98,1904,1806
18086,1,1,1049,1382,333
18087,1,1,851,1906,1055
18088,0,0,3,0,-3
18089,0,0,84,0,-84
18090,1,1,354,1242,888
18091,0,0,65,0,-65
18092,1,0,6,0,-6
18093,1,0,21,0,-21
18094,0,0,42,0,-42
18095,1,1,972,1601,629
18096,1,0,31,0,-31
18097,1,0,28,0,-28
18098,1,0,31,0,-31
18099,1,0,16,0,-16
18100,0,0,79,0,-79
18101,1,1,326,1461,1135
18102,0,0,108,0,-108
18103,1,1,312,1304,992
18104,1,1,768,1911,1143
18105,1,1,47,1589,1542
18106,0,0,29,0,-29
18107,0,0,44,0,-44
18108,1,0,18,0,-18
18109,0,0,0,0,0
18110,1,1,335,1287,952
18111,1,1,22,1288,1266
18112,0,0,98,0,-98
18113,1,0,87,0,-87
18114,1,1,437,1450,1013
18115,1,0,85,0,-85
18116,1,1,82,1254,1172
18117,0,0,11,0,-11
18118,1,1,120,1224,1104
18119,0,0,72,0,-72
18120,1,0,0,0,0
18121,1,0,41,0,-41
18122,1,1,364,1297,933
18123,0,0,4,0,-4
18124,0,0,109,0,-109
18125,1,0,58,0,-58
18126,0,0,11,0,-11
18127,0,0,47,0,-47
18128,1,1,923,1236,313
18129,1,0,25,0,-25
18130,0,0,56,0,-56
18131,1,1,209,1243,1034
18132,0,0,16,0,-16
18133,1,0,5,0,-5
18134,1,0,167,0,-167
18135,1,0,36,0,-36
18136,0,0,45,0,-45
18137,0,0,33,0,-33
18138,1,0,26,0,-26
18139,1,1,676,2061,1385
18140,1,1,112,1315,1203
18141,0,0,25,0,-25
18142,0,0,5,0,-5
18143,1,0,3,0,-3
18144,1,0,1,0,-1
18145,0,0,87,0,-87
18146,1,0,12,0,-12
18147,1,0,111,0,-111
18148,0,0,25,0,-25
18149,0,0,1,0,-1
18150,1,1,1723,1498,-225
18151,1,0,153,0,-153
18152,0,0,47,0,-47
18153,0,0,57,0,-57
18154,0,0,54,0,-54
18155,1,1,161,1255,1094
18156,1,0,81,0,-81
18157,0,0,28,0,-28
18158,1,0,10,0,-10
18159,0,0,30,0,-30
18160,1,1,502,1312,810
18161,1,1,1847,1620,-227
18162,1,1,2642,1568,-1074
18163,0,0,20,0,-20
18164,0,0,6,0,-6
18165,0,0,23,0,-23
18166,0,0,5,0,-5
18167,1,1,904,2077,1173
18168,1,1,82,1251,1169
18169,1,1,1566,2343,777
18170,0,0,20,0,-20
18171,1,1,573,1453,880
18172,1,1,263,1232,969
18173,1,0,0,0,0
18174,1,1,450,1262,812
18175,0,0,78,0,-78
18176,0,0,18,0,-18
18177,1,1,248,2116,1868
18178,1,1,68,1366,1298
18179,1,1,576,1457,881
18180,0,0,39,0,-39
18181,1,0,24,0,-24
18182,1,0,51,0,-51
18183,0,0,24,0,-24
18184,0,0,15,0,-15
18185,1,0,38,0,-38
18186,1,1,404,1962,1558
18187,1,0,43,0,-43
18188,1,0,27,0,-27
18189,1,0,90,0,-90
18190,0,0,97,0,-97
18191,0,0,0,0,0
18192,1,0,2,0,-2
18193,0,0,47,0,-47
18194,1,1,543,1255,712
18195,1,0,18,0,-18
18196,1,1,517,1816,1299
18197,0,0,26,0,-26
18198,0,0,135,0,-135
18199,0,0,6,0,-6
18200,0,0,76,0,-76
18201,1,0,6,0,-6
18202,1,1,379,1638,1259
18203,1,0,3,0,-3
18204,1,0,43,0,-43
18205,1,1,317,1281,964
18206,1,0,114,0,-114
18207,0,0,55,0,-55
18208,0,0,19,0,-19
18209,1,0,155,0,-155
18210,1,0,88,0,-88
18211,1,0,96,0,-96
18212,1,1,836,1922,1086
18213,0,0,18,0,-18
18214,0,0,55,0,-55
18215,1,1,2326,2308,-18
18216,1,0,27,0,-27
18217,1,0,18,0,-18
18218,1,0,27,0,-27
18219,0,0,37,0,-37
18220,0,0,5,0,-5
18221,1,0,101,0,-101
18222,0,0,20,0,-20
18223,1,0,139,0,-139
18224,1,1,144,1725,1581
18225,1,1,183,1322,1139
18226,1,0,55,0,-55
18227,1,0,58,0,-58
18228,1,0,18,0,-18
18229,1,1,175,1730,1555
18230,0,0,6,0,-6
18231,0,0,70,0,-70
18232,1,0,0,0,0
18233,1,0,70,0,-70
18234,0,0,97,0,-97
18235,0,0,36,0,-36
18236,1,1,472,1315,843
18237,0,0,28,0,-28
18238,1,0,39,0,-39
18239,1,1,1092,1451,359
18240,0,0,5,0,-5
18241,1,0,11,0,-11
18242,1,0,42,0,-42
18243,0,0,99,0,-99
18244,1,0,21,0,-21
18245,1,1,574,1245,671
18246,1,1,22,2060,2038
18247,1,0,8,0,-8
18248,1,0,19,0,-19
18249,1,1,963,1488,525
18250,1,1,20,1321,1301
18251,0,0,38,0,-38
18252,0,0,91,0,-91
18253,0,0,96,0,-96
18254,1,1,170,1306,1136
18255,1,0,52,0,-52
18256,0,0,42,0,-42
18257,1,0,76,0,-76
18258,1,0,3,0,-3
18259,0,0,28,0,-28
18260,0,0,1,0,-1
18261,0,0,41,0,-41
18262,0,0,23,0,-23
18263,1,1,290,1269,979
18264,1,0,127,0,-127
18265,0,0,76,0,-76
18266,0,0,18,0,-18
18267,1,1,265,1205,940
18268,1,0,34,0,-34
18269,0,0,30,0,-30
18270,1,0,32,0,-32
18271,0,0,21,0,-21
18272,1,0,21,0,-21
18273,1,0,122,0,-122
18274,0,0,8,0,-8
18275,0,0,8,0,-8
18276,0,0,23,0,-23
18277,1,1,569,1554,985
18278,1,0,85,0,-85
18279,1,1,38,1217,1179
18280,0,0,32,0,-32
18281,1,1,93,1834,1741
18282,1,1,454,1464,1010
18283,1,0,11,0,-11
18284,0,0,4,0,-4
18285,1,0,230,0,-230
18286,1,0,166,0,-166
18287,1,0,84,0,-84
18288,1,0,14,0,-14
18289,1,0,21,0,-21
18290,0,0,76,0,-76
18291,1,0,55,0,-55
18292,1,1,597,1355,758
18293,1,1,75,2670,2595
18294,1,1,250,1817,1567
18295,1,0,24,0,-24
18296,1,1,78,1294,1216
18297,0,0,34,0,-34
18298,1,1,805,1426,621
18299,0,0,39,0,-39
18300,0,0,13,0,-13
18301,1,0,61,0,-61
18302,1,1,72,1243,1171
18303,1,1,43,1656,1613
18304,0,0,10,0,-10
18305,1,1,99,1542,1443
18306,0,0,9,0,-9
18307,1,1,289,1301,1012
18308,1,0,56,0,-56
18309,0,0,7,0,-7
18310,1,1,1601,1381,-220
18311,1,0,18,0,-18
18312,0,0,7,0,-7
18313,1,0,19,0,-19
18314,1,0,95,0,-95
18315,1,0,0,0,0
18316,1,0,5,0,-5
18317,0,0,4,0,-4
18318,1,1,1547,2042,495
18319,1,1,774,1807,1033
18320,1,1,219,1253,1034
18321,1,1,491,1757,1266
18322,1,1,80,1820,1740
18323,1,1,694,1356,662
18324,0,0,23,0,-23
18325,1,0,95,0,-95
18326,1,1,656,1897,1241
18327,1,0,41,0,-41
18328,1,1,105,2503,2398
18329,0,0,12,0,-12
18330,1,0,45,0,-45
18331,0,0,29,0,-29
18332,1,0,19,0,-19
18333,0,0,51,0,-51
18334,0,0,20,0,-20
18335,1,1,214,1661,1447
18336,1,1,892,1278,386
18337,1,0,11,0,-11
18338,1,1,978,1205,227
18339,1,0,16,0,-16
18340,1,0,37,0,-37
18341,1,1,223,2514,2291
18342,0,0,32,0,-32
18343,0,0,173,0,-173
18344,1,1,372,1737,1365
18345,1,0,36,0,-36
18346,1,0,26,0,-26
18347,1,1,1203,2127,924
18348,1,0,86,0,-86
18349,1,1,1289,1978,689
18350,1,1,541,1418,877
18351,1,1,636,1329,693
18352,0,0,5,0,-5
18353,1,0,23,0,-23
18354,0,0,114,0,-114
18355,0,0,12,0,-12
18356,0,0,18,0,-18
18357,1,0,55,0,-55
18358,0,0,64,0,-64
18359,0,0,71,0,-71
18360,1,0,8,0,-8
18361,0,0,120,0,-120
18362,1,1,256,1689,1433
18363,0,0,33,0,-33
18364,1,1,124,1286,1162
18365,0,0,13,0,-13
18366,1,1,178,4246,4068
18367,0,0,3,0,-3
18368,1,1,771,2306,1535
18369,1,0,96,0,-96
18370,0,0,34,0,-34
18371,1,1,165,1493,1328
18372,0,0,26,0,-26
18373,1,0,1,0,-1
18374,1,0,28,0,-28
18375,0,0,26,0,-26
18376,0,0,22,0,-22
18377,1,1,159,1364,1205
18378,0,0,51,0,-51
18379,1,0,17,0,-17
18380,1,0,19,0,-19
18381,1,1,498,1598,1100
18382,1,0,6,0,-6
18383,1,1,76,1668,1592
18384,0,0,28,0,-28
18385,1,0,45,0,-45
18386,1,1,941,1433,492
18387,1,1,590,1210,620
18388,0,0,53,0,-53
18389,0,0,14,0,-14
18390,1,1,580,1229,649
18391,1,0,92,0,-92
18392,1,1,203,2179,1976
18393,1,1,777,1465,688
18394,1,0,25,0,-25
18395,1,0,65,0,-65
18396,0,0,31,0,-31
18397,0,0,6,0,-6
18398,1,1,421,1279,858
18399,1,0,14,0,-14
18400,1,1,489,1364,875
18401,1,1,328,3491,3163
18402,1,0,44,0,-44
18403,0,0,13,0,-13
18404,1,0,92,0,-92
18405,1,1,85,1396,1311
18406,0,0,3,0,-3
18407,1,0,65,0,-65
18408,0,0,26,0,-26
18409,1,1,556,1669,1113
18410,0,0,5,0,-5
18411,1,1,88,1511,1423
18412,0,0,94,0,-94
18413,0,0,39,0,-39
18414,1,1,180,1219,1039
18415,0,0,38,0,-38
18416,0,0,89,0,-89
18417,1,0,52,0,-52
18418,0,0,30,0,-30
18419,1,0,74,0,-74
18420,0,0,26,0,-26
18421,1,1,92,1280,1188
18422,1,1,437,1605,1168
18423,1,1,210,3857,3647
18424,1,0,60,0,-60
18425,1,1,746,1215,469
18426,0,0,70,0,-70
18427,1,1,458,1365,907
18428,0,0,78,0,-78
18429,0,0,79,0,-79
18430,1,1,282,1417,1135
18431,0,0,60,0,-60
18432,0,0,30,0,-30
18433,1,0,48,0,-48
18434,0,0,57,0,-57
18435,1,1,407,1615,1208
18436,1,1,89,1625,1536
18437,1,0,26,0,-26
18438,1,0,56,0,-56
18439,1,1,1756,1893,137
18440,0,0,3,0,-3
18441,0,0,0,0,0
18442,1,1,121,1447,1326
18443,1,1,207,3326,3119
18444,1,1,441,1615,1174
18445,1,1,446,1356,910
18446,0,0,33,0,-33
18447,1,1,875,1214,339
18448,1,0,17,0,-17
18449,1,1,564,1728,1164
18450,1,1,1332,1635,303
18451,1,0,46,0,-46
18452,1,0,61,0,-61
18453,1,1,136,1809,1673
18454,1,0,46,0,-46
18455,0,0,6,0,-6
18456,1,1,136,1285,1149
18457,0,0,85,0,-85
18458,0,0,2,0,-2
18459,1,1,463,1455,992
18460,1,0,71,0,-71
18461,0,0,32,0,-32
18462,1,0,2,0,-2
18463,0,0,190,0,-190
18464,0,0,26,0,-26
18465,1,0,56,0,-56
18466,0,0,1,0,-1
18467,0,0,22,0,-22
18468,0,0,91,0,-91
18469,0,0,12,0,-12
18470,1,0,11,0,-11
18471,0,0,20,0,-20
18472,0,0,58,0,-58
18473,1,1,633,2271,1638
18474,1,1,617,1427,810
18475,0,0,13,0,-13
18476,0,0,93,0,-93
18477,1,0,9,0,-9
18478,0,0,93,0,-93
18479,0,0,67,0,-67
18480,0,0,48,0,-48
18481,1,0,54,0,-54
18482,0,0,50,0,-50
18483,1,1,266,2157,1891
18484,1,1,91,1298,1207
18485,1,0,19,0,-19
18486,0,0,32,0,-32
18487,0,0,117,0,-117
18488,1,1,236,1558,1322
18489,1,0,12,0,-12
18490,1,1,116,1722,1606
18491,1,1,613,1375,762
18492,1,1,232,1314,1082
18493,0,0,77,0,-77
18494,1,0,13,0,-13
18495,1,1,238,1663,1425
18496,1,1,1598,1888,290
18497,1,1,707,1950,1243
18498,0,0,30,0,-30
18499,1,0,93,0,-93
18500,0,0,77,0,-77
18501,1,0,4,0,-4
18502,0,0,3,0,-3
18503,1,0,2,0,-2
18504,0,0,138,0,-138
18505,1,0,36,0,-36
18506,1,0,55,0,-55
18507,1,1,190,1216,1026
18508,1,0,41,0,-41
18509,1,0,21,0,-21
18510,0,0,18,0,-18
18511,0,0,47,0,-47
18512,1,0,71,0,-71
18513,1,1,73,1275,1202
18514,1,1,782,1382,600
18515,1,0,71,0,-71
18516,1,0,28,0,-28
18517,1,1,330,1692,1362
18518,1,1,370,1669,1299
18519,0,0,16,0,-16
18520,1,1,44,1243,1199
18521,0,0,30,0,-30
18522,0,0,99,0,-99
18523,0,0,32,0,-32
18524,0,0,128,0,-128
18525,1,1,914,1208,294
18526,0,0,16,0,-16
18527,0,0,5,0,-5
18528,1,0,27,0,-27
18529,0,0,10,0,-10
18530,1,1,57,2458,2401
18531,1,0,38,0,-38
18532,0,0,4,0,-4
18533,1,1,1722,1894,172
18534,1,0,27,0,-27
18535,1,1,938,1252,314
18536,1,0,62,0,-62
18537,0,0,9,0,-9
18538,0,0,76,0,-76
18539,1,0,9,0,-9
18540,1,1,152,2105,1953
18541,1,1,1398,1201,-197
18542,1,0,18,0,-18
18543,1,0,38,0,-38
18544,0,0,65,0,-65
18545,1,0,134,0,-134
18546,1,1,155,1267,1112
18547,0,0,37,0,-37
18548,1,0,46,0,-46
18549,1,1,2214,1889,-325
18550,1,0,11,0,-11
18551,0,0,85,0,-85
18552,1,0,103,0,-103
18553,1,0,162,0,-162
18554,1,0,49,0,-49
18555,1,0,29,0,-29
18556,1,0,8,0,-8
18557,1,1,105,1493,1388
18558,0,0,98,0,-98
18559,1,0,13,0,-13
18560,1,0,19,0,-19
18561,1,1,113,1461,1348
18562,1,0,1,0,-1
18563,1,1,947,1243,296
18564,1,1,187,1341,1154
18565,1,1,78,1229,1151
18566,1,0,120,0,-120
18567,0,0,31,0,-31
18568,0,0,9,0,-9
18569,1,1,113,1468,1355
18570,1,0,1,0,-1
18571,1,0,48,0,-48
18572,1,0,122,0,-122
18573,0,0,7,0,-7
18574,0,0,41,0,-41
18575,1,0,7,0,-7
18576,1,1,1249,1341,92
18577,0,0,94,0,-94
18578,0,0,55,0,-55
18579,1,0,207,0,-207
18580,1,1,1253,1228,-25
18581,0,0,16,0,-16
18582,1,0,13,0,-13
18583,1,1,918,1390,472
18584,0,0,22,0,-22
18585,1,1,147,3388,3241
18586,0,0,53,0,-53
18587,1,1,14,1525,1511
18588,0,0,10,0,-10
18589,1,0,40,0,-40
18590,1,0,230,0,-230
18591,1,0,19,0,-19
18592,1,1,243,1393,1150
18593,0,0,16,0,-16
18594,1,0,16,0,-16
18595,1,1,413,4249,3836
18596,1,1,89,2396,2307
18597,1,1,271,1430,1159
18598,0,0,75,0,-75
18599,1,0,10,0,-10
18600,0,0,77,0,-77
18601,0,0,40,0,-40
18602,0,0,28,0,-28
18603,1,0,214,0,-214
18604,1,1,83,1534,1451
18605,1,1,1276,1359,83
18606,1,1,597,1238,641
18607,0,0,69,0,-69
18608,1,0,7,0,-7
18609,1,1,367,1333,966
18610,1,0,25,0,-25
18611,0,0,12,0,-12
18612,1,1,301,1841,1540
18613,0,0,102,0,-102
18614,0,0,37,0,-37
18615,1,1,1379,1241,-138
18616,0,0,8,0,-8
18617,0,0,21,0,-21
18618,1,0,178,0,-178
18619,1,0,217,0,-217
18620,0,0,20,0,-20
18621,1,1,309,2548,2239
18622,0,0,50,0,-50
18623,1,1,123,1272,1149
18624,0,0,31,0,-31
18625,0,0,145,0,-145
18626,0,0,4,0,-4
18627,1,0,90,0,-90
18628,0,0,91,0,-91
18629,1,0,19,0,-19
18630,1,1,1225,1359,134
18631,1,1,1159,1514,355
18632,1,1,358,1257,899
18633,1,0,48,0,-48
18634,0,0,28,0,-28
18635,0,0,111,0,-111
18636,0,0,26,0,-26
18637,1,1,54,1265,1211
18638,1,1,529,1397,868
18639,0,0,161,0,-161
18640,1,1,211,1556,1345
18641,1,0,17,0,-17
18642,0,0,30,0,-30
18643,1,0,50,0,-50
18644,1,0,67,0,-67
18645,1,0,19,0,-19
18646,0,0,15,0,-15
18647,1,0,10,0,-10
18648,0,0,41,0,-41
18649,0,0,17,0,-17
18650,1,1,214,1584,1370
18651,1,1,156,1251,1095
18652,1,0,13,0,-13
18653,1,0,7,0,-7
18654,1,1,647,1618,971
18655,1,0,3,0,-3
18656,1,1,206,2914,2708
18657,1,0,317,0,-317
18658,1,1,965,1386,421
18659,1,0,16,0,-16
18660,1,1,355,2113,1758
18661,1,1,1147,1200,53
18662,0,0,11,0,-11
18663,0,0,8,0,-8
18664,1,0,68,0,-68
18665,1,0,83,0,-83
18666,1,1,351,1280,929
18667,0,0,5,0,-5
18668,1,0,62,0,-62
18669,1,1,312,1268,956
18670,0,0,29,0,-29
18671,0,0,124,0,-124
18672,1,1,185,1480,1295
18673,1,1,1032,1317,285
18674,1,0,17,0,-17
18675,0,0,5,0,-5
18676,1,0,12,0,-12
18677,0,0,166,0,-166
18678,0,0,37,0,-37
18679,0,0,55,0,-55
18680,1,0,45,0,-45
18681,0,0,83,0,-83
18682,0,0,22,0,-22
18683,1,1,875,1353,478
18684,1,1,133,1929,1796
18685,0,0,20,0,-20
18686,0,0,149,0,-149
18687,1,0,17,0,-17
18688,0,0,13,0,-13
18689,0,0,7,0,-7
18690,0,0,5,0,-5
18691,0,0,20,0,-20
18692,1,0,3,0,-3
18693,0,0,161,0,-161
18694,1,0,49,0,-49
18695,0,0,23,0,-23
18696,1,1,330,1252,922
18697,1,0,31,0,-31
18698,1,0,91,0,-91
18699,1,1,273,1336,1063
18700,1,0,121,0,-121
18701,1,1,120,1495,1375
18702,1,0,21,0,-21
18703,0,0,5,0,-5
18704,0,0,5,0,-5
18705,0,0,6,0,-6
18706,0,0,197,0,-197
18707,1,1,743,2216,1473
18708,0,0,6,0,-6
18709,1,1,600,1254,654
18710,1,1,711,1387,676
18711,1,1,857,1500,643
18712,1,1,1586,1740,154
18713,1,0,31,0,-31
18714,0,0,164,0,-164
18715,1,1,149,1621,1472
18716,0,0,53,0,-53
18717,0,0,46,0,-46
18718,1,0,4,0,-4
18719,1,1,177,1353,1176
18720,1,0,64,0,-64
18721,0,0,80,0,-80
18722,1,1,77,1565,1488
18723,1,0,26,0,-26
18724,1,1,445,2050,1605
18725,1,1,305,2111,1806
18726,1,0,158,0,-158
18727,0,0,33,0,-33
18728,0,0,3,0,-3
18729,1,1,889,1618,729
18730,0,0,7,0,-7
18731,0,0,34,0,-34
18732,1,0,27,0,-27
18733,1,0,41,0,-41
18734,1,0,142,0,-142
18735,0,0,23,0,-23
18736,1,0,64,0,-64
18737,0,0,16,0,-16
18738,1,0,65,0,-65
18739,1,1,357,1881,1524
18740,1,0,101,0,-101
18741,1,0,75,0,-75
18742,1,0,25,0,-25
18743,1,0,37,0,-37
18744,1,0,67,0,-67
18745,1,0,42,0,-42
18746,1,0,55,0,-55
18747,0,0,9,0,-9
18748,1,0,35,0,-35
18749,1,0,4,0,-4
18750,1,1,417,1519,1102
18751,0,0,1,0,-1
18752,1,0,0,0,0
18753,0,0,6,0,-6
18754,1,0,158,0,-158
18755,1,1,2725,1213,-1512
18756,0,0,22,0,-22
18757,0,0,91,0,-91
18758,1,1,342,3063,2721
18759,1,0,52,0,-52
18760,1,0,0,0,0
18761,1,1,1550,1230,-320
18762,0,0,15,0,-15
18763,0,0,58,0,-58
18764,0,0,14,0,-14
18765,1,0,23,0,-23
18766,1,1,360,1269,909
18767,1,1,1059,1569,510
18768,1,0,32,0,-32
18769,1,1,1463,1210,-253
18770,0,0,46,0,-46
18771,1,1,69,1281,1212
18772,1,1,131,1331,1200
18773,1,1,578,1360,782
18774,1,1,253,1397,1144
18775,1,0,8,0,-8
18776,0,0,26,0,-26
18777,0,0,74,0,-74
18778,1,1,597,1355,758
18779,1,0,26,0,-26
18780,0,0,31,0,-31
18781,1,1,1629,2369,740
18782,1,1,43,1378,1335
18783,0,0,18,0,-18
18784,1,1,1024,1326,302
18785,1,0,18,0,-18
18786,0,0,33,0,-33
18787,0,0,62,0,-62
18788,1,1,742,1341,599
18789,0,0,1,0,-1
18790,0,0,145,0,-145
18791,1,0,35,0,-35
18792,0,0,0,0,0
18793,1,0,93,0,-93
18794,0,0,21,0,-21
18795,0,0,138,0,-138
18796,1,0,63,0,-63
18797,1,0,31,0,-31
18798,1,0,13,0,-13
18799,1,0,12,0,-12
18800,1,1,1033,1333,300
18801,0,0,125,0,-125
18802,1,0,6,0,-6
18803,1,1,161,1220,1059
18804,0,0,7,0,-7
18805,1,0,210,0,-210
18806,1,1,139,1254,1115
18807,0,0,24,0,-24
18808,1,1,542,1737,1195
18809,1,0,68,0,-68
18810,1,1,156,1713,1557
18811,0,0,64,0,-64
18812,1,0,192,0,-192
18813,1,0,63,0,-63
18814,1,1,1449,1374,-75
18815,0,0,25,0,-25
18816,1,1,267,1218,951
18817,1,0,116,0,-116
18818,1,0,129,0,-129
18819,1,1,467,1356,889
18820,0,0,27,0,-27
18821,1,1,300,2108,1808
18822,1,0,47,0,-47
18823,0,0,26,0,-26
18824,1,1,1217,1315,98
18825,1,0,8,0,-8
18826,1,1,406,1558,1152
18827,0,0,1,0,-1
18828,0,0,45,0,-45
18829,0,0,97,0,-97
18830,0,0,105,0,-105
18831,1,1,239,3655,3416
18832,0,0,27,0,-27
18833,1,1,77,1390,1313
18834,1,1,787,1202,415
18835,1,0,156,0,-156
18836,0,0,28,0,-28
18837,0,0,34,0,-34
18838,0,0,32,0,-32
18839,0,0,20,0,-20
18840,0,0,46,0,-46
18841,1,0,100,0,-100
18842,0,0,13,0,-13
18843,0,0,13,0,-13
18844,1,1,549,1252,703
18845,0,0,23,0,-23
18846,0,0,87,0,-87
18847,1,1,558,1302,744
18848,1,0,102,0,-102
18849,0,0,130,0,-130
18850,1,1,1428,1409,-19
18851,0,0,32,0,-32
18852,1,1,516,1257,741
18853,1,0,20,0,-20
18854,0,0,60,0,-60
18855,1,1,172,2597,2425
18856,1,1,177,1449,1272
18857,1,0,8,0,-8
18858,0,0,42,0,-42
18859,1,1,944,1376,432
18860,1,1,330,1231,901
18861,0,0,4,0,-4
18862,1,1,767,1334,567
18863,1,0,22,0,-22
18864,0,0,29,0,-29
18865,0,0,62,0,-62
18866,0,0,15,0,-15
18867,1,0,44,0,-44
18868,1,1,522,1312,790
18869,1,1,321,2555,2234
18870,0,0,134,0,-134
18871,1,0,51,0,-51
18872,1,1,477,1211,734
18873,1,0,12,0,-12
18874,0,0,166,0,-166
18875,1,0,33,0,-33
18876,0,0,5,0,-5
18877,0,0,59,0,-59
18878,1,1,349,1233,884
18879,0,0,108,0,-108
18880,1,0,17,0,-17
18881,0,0,56,0,-56
18882,0,0,42,0,-42
18883,1,1,268,2689,2421
18884,0,0,81,0,-81
18885,1,1,431,1500,1069
18886,1,0,39,0,-39
18887,0,0,256,0,-256
18888,0,0,90,0,-90
18889,0,0,66,0,-66
18890,1,1,918,1318,400
18891,1,0,43,0,-43
18892,1,0,7,0,-7
18893,0,0,104,0,-104
18894,0,0,232,0,-232
18895,1,0,34,0,-34
18896,0,0,31,0,-31
18897,1,0,2,0,-2
18898,0,0,5,0,-5
18899,1,0,78,0,-78
18900,0,0,75,0,-75
18901,1,0,8,0,-8
18902,1,1,504,1332,828
18903,0,0,25,0,-25
18904,0,0,4,0,-4
18905,1,0,73,0,-73
18906,1,1,989,1485,496
18907,0,0,31,0,-31
18908,1,0,132,0,-132
18909,1,1,556,1754,1198
18910,0,0,29,0,-29
18911,0,0,112,0,-112
18912,1,1,592,1837,1245
18913,0,0,9,0,-9
18914,0,0,69,0,-69
18915,1,1,684,1403,719
18916,0,0,6,0,-6
18917,0,0,70,0,-70
18918,1,0,6,0,-6
18919,1,1,831,1288,457
18920,1,0,53,0,-53
18921,1,0,8,0,-8
18922,0,0,90,0,-90
18923,1,1,35,1228,1193
18924,0,0,36,0,-36
18925,0,0,4,0,-4
18926,1,0,105,0,-105
18927,0,0,46,0,-46
18928,0,0,38,0,-38
18929,1,0,55,0,-55
18930,1,1,277,1262,985
18931,1,1,132,1207,1075
18932,1,0,146,0,-146
18933,0,0,71,0,-71
18934,0,0,70,0,-70
18935,1,0,4,0,-4
18936,1,0,65,0,-65
18937,1,0,5,0,-5
18938,0,0,8,0,-8
18939,1,1,1051,1294,243
18940,1,0,30,0,-30
18941,1,0,18,0,-18
18942,0,0,126,0,-126
18943,0,0,83,0,-83
18944,0,0,14,0,-14
18945,1,0,3,0,-3
18946,1,0,35,0,-35
18947,1,0,58,0,-58
18948,0,0,86,0,-86
18949,1,1,242,1402,1160
18950,1,0,11,0,-11
18951,1,0,17,0,-17
18952,1,1,1280,4458,3178
18953,1,0,215,0,-215
18954,0,0,8,0,-8
18955,1,1,1658,1334,-324
18956,0,0,51,0,-51
18957,1,0,14,0,-14
18958,1,0,62,0,-62
18959,0,0,39,0,-39
18960,1,0,13,0,-13
18961,1,1,30,1602,1572
18962,1,0,20,0,-20
18963,0,0,79,0,-79
18964,0,0,20,0,-20
18965,1,1,1196,1408,212
18966,1,1,108,1543,1435
18967,1,0,3,0,-3
18968,1,0,11,0,-11
18969,1,1,651,1520,869
18970,0,0,3,0,-3
18971,0,0,4,0,-4
18972,0,0,66,0,-66
18973,1,0,15,0,-15
18974,1,0,8,0,-8
18975,1,1,206,1263,1057
18976,1,0,3,0,-3
18977,0,0,56,0,-56
18978,1,0,28,0,-28
18979,1,0,9,0,-9
18980,0,0,21,0,-21
18981,1,1,801,1283,482
18982,1,1,155,1655,1500
18983,1,1,77,1212,1135
18984,1,0,24,0,-24
18985,1,1,719,2281,1562
18986,1,0,38,0,-38
18987,0,0,68,0,-68
18988,1,0,67,0,-67
18989,0,0,15,0,-15
18990,1,1,509,1482,973
18991,0,0,231,0,-231
18992,1,0,46,0,-46
18993,1,1,1027,1241,214
18994,1,0,6,0,-6
18995,1,1,659,1604,945
18996,0,0,117,0,-117
18997,0,0,37,0,-37
18998,1,1,100,1251,1151
18999,1,0,139,0,-139
19000,0,0,32,0,-32
19001,1,1,988,1314,326
19002,1,0,134,0,-134
19003,1,1,741,1367,626
19004,1,1,43,1785,1742
19005,1,1,205,1652,1447
19006,0,0,43,0,-43
19007,0,0,59,0,-59
19008,1,0,33,0,-33
19009,1,1,106,1353,1247
19010,0,0,37,0,-37
19011,0,0,77,0,-77
19012,1,0,33,0,-33
19013,1,1,124,1893,1769
19014,0,0,19,0,-19
19015,0,0,6,0,-6
19016,1,0,12,0,-12
19017,0,0,52,0,-52
19018,1,1,2529,1209,-1320
19019,1,1,265,1590,1325
19020,1,1,678,1218,540
19021,1,1,111,1214,1103
19022,0,0,207,0,-207
19023,1,0,58,0,-58
19024,0,0,81,0,-81
19025,1,1,528,1907,1379
19026,1,1,891,1222,331
19027,1,0,342,0,-342
19028,1,1,798,1641,843
19029,0,0,14,0,-14
19030,0,0,58,0,-58
19031,0,0,5,0,-5
19032,1,1,247,1652,1405
19033,1,0,95,0,-95
19034,1,0,57,0,-57
19035,1,0,146,0,-146
19036,1,0,26,0,-26
19037,0,0,134,0,-134
19038,0,0,294,0,-294
19039,0,0,5,0,-5
19040,1,1,362,2794,2432
19041,0,0,44,0,-44
19042,1,0,26,0,-26
19043,1,1,208,2560,2352
19044,0,0,27,0,-27
19045,1,1,301,1238,937
19046,1,1,1019,1269,250
19047,1,0,57,0,-57
19048,1,0,42,0,-42
19049,1,0,19,0,-19
19050,1,0,182,0,-182
19051,0,0,109,0,-109
19052,1,0,1,0,-1
19053,1,1,149,1316,1167
19054,0,0,5,0,-5
19055,0,0,80,0,-80
19056,1,1,192,1226,1034
19057,1,0,127,0,-127
19058,1,1,375,2592,2217
19059,0,0,3,0,-3
19060,1,1,441,1314,873
19061,0,0,19,0,-19
19062,1,1,762,2388,1626
19063,0,0,53,0,-53
19064,1,0,89,0,-89
19065,0,0,76,0,-76
19066,0,0,59,0,-59
19067,1,0,156,0,-156
19068,0,0,17,0,-17
19069,1,0,104,0,-104
19070,1,1,172,1327,1155
19071,0,0,75,0,-75
19072,0,0,57,0,-57
19073,0,0,55,0,-55
19074,1,0,45,0,-45
19075,0,0,70,0,-70
19076,1,1,1546,2534,988
19077,0,0,0,0,0
19078,1,0,63,0,-63
19079,0,0,29,0,-29
19080,0,0,109,0,-109
19081,1,1,700,1377,677
19082,0,0,48,0,-48
19083,1,1,641,1281,640
19084,0,0,171,0,-171
19085,1,0,12,0,-12
19086,1,1,1671,1357,-314
19087,1,1,140,1380,1240
19088,1,0,2,0,-2
19089,1,1,277,1271,994
19090,0,0,8,0,-8
19091,1,1,123,1984,1861
19092,1,1,1031,2866,1835
19093,1,0,69,0,-69
19094,0,0,13,0,-13
19095,1,0,45,0,-45
19096,1,1,1652,1408,-244
19097,0,0,56,0,-56
19098,0,0,34,0,-34
19099,1,0,60,0,-60
19100,1,1,567,2267,1700
19101,0,0,99,0,-99
19102,1,1,292,1453,1161
19103,0,0,24,0,-24
19104,0,0,4,0,-4
19105,0,0,0,0,0
19106,0,0,149,0,-149
19107,1,1,252,1219,967
19108,1,0,111,0,-111
19109,0,0,3,0,-3
19110,0,0,75,0,-75
19111,0,0,18,0,-18
19112,0,0,19,0,-19
19113,1,0,27,0,-27
19114,1,0,70,0,-70
19115,1,1,88,1701,1613
19116,1,0,8,0,-8
19117,0,0,72,0,-72
19118,1,1,2114,1350,-764
19119,1,1,168,1379,1211
19120,1,0,11,0,-11
19121,1,1,215,1268,1053
19122,0,0,64,0,-64
19123,1,1,154,1227,1073
19124,1,0,17,0,-17
19125,1,0,114,0,-114
19126,1,0,7,0,-7
19127,0,0,45,0,-45
19128,0,0,12,0,-12
19129,1,1,631,1362,731
19130,1,1,193,1278,1085
19131,1,1,512,2086,1574
19132,1,1,1228,1497,269
19133,1,0,110,0,-110
19134,1,0,28,0,-28
19135,0,0,24,0,-24
19136,1,1,322,1976,1654
19137,1,0,55,0,-55
19138,0,0,41,0,-41
19139,1,1,3152,1322,-1830
19140,0,0,125,0,-125
19141,1,0,30,0,-30
19142,0,0,130,0,-130
19143,1,0,7,0,-7
19144,0,0,5,0,-5
19145,0,0,18,0,-18
19146,0,0,113,0,-113
19147,1,0,0,0,0
19148,1,0,8,0,-8
19149,1,0,93,0,-93
19150,0,0,9,0,-9
19151,0,0,54,0,-54
19152,1,0,42,0,-42
19153,1,0,59,0,-59
19154,1,0,68,0,-68
19155,1,1,334,1397,1063
19156,0,0,15,0,-15
19157,1,1,859,1211,352
19158,0,0,43,0,-43
19159,1,1,338,1888,1550
19160,0,0,13,0,-13
19161,1,0,16,0,-16
19162,0,0,20,0,-20
19163,0,0,15,0,-15
19164,1,0,7,0,-7
19165,0,0,20,0,-20
19166,0,0,45,0,-45
19167,1,0,69,0,-69
19168,0,0,90,0,-90
19169,1,0,133,0,-133
19170,0,0,3,0,-3
19171,1,0,36,0,-36
19172,1,1,233,1351,1118
19173,0,0,13,0,-13
19174,0,0,26,0,-26
19175,0,0,37,0,-37
19176,1,0,5,0,-5
19177,1,0,22,0,-22
19178,0,0,47,0,-47
19179,1,1,427,1873,1446
19180,1,1,158,2294,2136
19181,0,0,1,0,-1
19182,1,1,156,1210,1054
19183,0,0,0,0,0
19184,1,1,1855,1205,-650
19185,1,0,44,0,-44
19186,1,0,113,0,-113
19187,0,0,34,0,-34
19188,1,1,120,2124,2004
19189,0,0,45,0,-45
19190,1,0,95,0,-95
19191,0,0,78,0,-78
19192,0,0,37,0,-37
19193,1,0,66,0,-66
19194,0,0,53,0,-53
19195,0,0,47,0,-47
19196,1,0,106,0,-106
19197,0,0,13,0,-13
19198,0,0,53,0,-53
19199,1,0,72,0,-72
19200,0,0,31,0,-31
19201,0,0,24,0,-24
19202,0,0,47,0,-47
19203,0,0,3,0,-3
19204,1,1,524,2140,1616
19205,1,0,3,0,-3
19206,0,0,76,0,-76
19207,0,0,25,0,-25
19208,0,0,9,0,-9
19209,0,0,12,0,-12
19210,1,0,141,0,-141
19211,1,1,1281,1716,435
19212,1,0,47,0,-47
19213,1,1,397,1787,1390
19214,0,0,65,0,-65
19215,0,0,41,0,-41
19216,0,0,68,0,-68
19217,1,1,300,1488,1188
19218,0,0,16,0,-16
19219,1,0,80,0,-80
19220,1,0,56,0,-56
19221,1,1,323,3105,2782
19222,1,0,45,0,-45
19223,1,1,387,1342,955
19224,1,0,125,0,-125
19225,1,1,59,1215,1156
19226,0,0,7,0,-7
19227,1,1,2160,1284,-876
19228,0,0,144,0,-144
19229,1,1,142,1284,1142
19230,1,1,581,1253,672
19231,1,0,37,0,-37
19232,1,0,20,0,-20
19233,0,0,18,0,-18
19234,1,1,43,1502,1459
19235,1,1,572,1378,806
19236,0,0,5,0,-5
19237,1,0,18,0,-18
19238,0,0,43,0,-43
19239,1,1,18,1448,1430
19240,1,1,799,1425,626
19241,0,0,4,0,-4
19242,1,0,118,0,-118
19243,0,0,11,0,-11
19244,1,1,676,1600,924
19245,1,1,955,1217,262
19246,1,1,294,1485,1191
19247,1,1,265,1312,1047
19248,1,1,816,1576,760
19249,1,1,136,1341,1205
19250,1,1,1276,1442,166
19251,0,0,12,0,-12
19252,1,0,5,0,-5
19253,1,0,30,0,-30
19254,1,1,1803,1336,-467
19255,1,1,155,1391,1236
19256,1,0,95,0,-95
19257,1,0,67,0,-67
19258,1,1,257,1441,1184
19259,0,0,78,0,-78
19260,0,0,10,0,-10
19261,1,0,14,0,-14
19262,0,0,34,0,-34
19263,1,1,1201,3710,2509
19264,1,1,9,1578,1569
19265,1,1,747,1295,548
19266,0,0,43,0,-43
19267,0,0,122,0,-122
19268,1,1,10,1710,1700
19269,0,0,1,0,-1
19270,1,0,71,0,-71
19271,1,0,30,0,-30
19272,0,0,11,0,-11
19273,1,1,140,1444,1304
19274,0,0,5,0,-5
19275,1,0,212,0,-212
19276,0,0,45,0,-45
19277,1,0,21,0,-21
19278,0,0,17,0,-17
19279,1,0,43,0,-43
19280,1,0,12,0,-12
19281,0,0,76,0,-76
19282,0,0,47,0,-47
19283,1,0,128,0,-128
19284,1,0,56,0,-56
19285,0,0,0,0,0
19286,1,1,934,1244,310
19287,1,0,83,0,-83
19288,0,0,36,0,-36
19289,1,0,106,0,-106
19290,1,0,2,0,-2
19291,0,0,48,0,-48
19292,1,1,271,1534,1263
19293,1,1,148,1526,1378
19294,0,0,21,0,-21
19295,1,1,595,1733,1138
19296,1,1,588,1700,1112
19297,0,0,31,0,-31
19298,0,0,1,0,-1
19299,1,0,130,0,-130
19300,1,1,185,1258,1073
19301,0,0,101,0,-101
19302,0,0,0,0,0
19303,0,0,31,0,-31
19304,0,0,8,0,-8
19305,1,0,38,0,-38
19306,1,1,652,1983,1331
19307,0,0,33,0,-33
19308,0,0,13,0,-13
19309,0,0,20,0,-20
19310,1,1,272,1255,983
19311,0,0,30,0,-30
19312,0,0,9,0,-9
19313,1,1,104,1454,1350
19314,1,0,20,0,-20
19315,1,1,1285,1269,-16
19316,1,0,54,0,-54
19317,0,0,169,0,-169
19318,1,0,91,0,-91
19319,1,0,25,0,-25
19320,0,0,39,0,-39
19321,0,0,12,0,-12
19322,1,0,6,0,-6
19323,1,1,851,1377,526
19324,0,0,8,0,-8
19325,1,1,328,1251,923
19326,1,0,180,0,-180
19327,0,0,43,0,-43
19328,0,0,69,0,-69
19329,1,1,177,1901,1724
19330,1,0,143,0,-143
19331,1,0,30,0,-30
19332,0,0,53,0,-53
19333,0,0,181,0,-181
19334,1,0,19,0,-19
19335,1,1,128,1374,1246
19336,1,1,617,1208,591
19337,0,0,27,0,-27
19338,1,0,20,0,-20
19339,0,0,43,0,-43
19340,1,1,420,1583,1163
19341,1,0,104,0,-104
19342,0,0,54,0,-54
19343,0,0,15,0,-15
19344,1,0,47,0,-47
19345,0,0,9,0,-9
19346,1,1,284,1627,1343
19347,1,1,100,1251,1151
19348,0,0,12,0,-12
19349,1,0,58,0,-58
19350,0,0,92,0,-92
19351,1,1,2937,1597,-1340
19352,1,1,527,2225,1698
19353,0,0,9,0,-9
19354,0,0,89,0,-89
19355,0,0,118,0,-118
19356,1,1,1017,1231,214
19357,1,0,0,0,0
19358,1,1,159,1251,1092
19359,0,0,5,0,-5
19360,0,0,68,0,-68
19361,0,0,25,0,-25
19362,0,0,61,0,-61
19363,0,0,11,0,-11
19364,1,1,680,1276,596
19365,1,0,148,0,-148
19366,0,0,185,0,-185
19367,1,1,458,1207,749
19368,0,0,24,0,-24
19369,1,0,23,0,-23
19370,1,0,53,0,-53
19371,0,0,6,0,-6
19372,1,1,437,1328,891
19373,0,0,111,0,-111
19374,1,1,401,1421,1020
19375,1,0,91,0,-91
19376,1,1,262,1206,944
19377,0,0,40,0,-40
19378,0,0,94,0,-94
19379,0,0,14,0,-14
19380,1,1,154,4369,4215
19381,1,1,1026,1235,209
19382,1,1,798,1276,478
19383,1,1,922,1302,380
19384,1,1,218,2827,2609
19385,0,0,81,0,-81
19386,0,0,12,0,-12
19387,1,0,9,0,-9
19388,0,0,128,0,-128
19389,1,1,76,1294,1218
19390,0,0,56,0,-56
19391,1,1,249,2072,1823
19392,1,0,66,0,-66
19393,1,1,5,1590,1585
19394,1,1,726,1403,677
19395,1,1,213,1386,1173
19396,1,0,26,0,-26
19397,1,0,10,0,-10
19398,1,1,922,1639,717
19399,1,1,491,1430,939
19400,1,1,549,1205,656
19401,1,1,346,1497,1151
19402,1,0,187,0,-187
19403,1,1,534,3147,2613
19404,1,0,24,0,-24
19405,0,0,58,0,-58
19406,0,0,5,0,-5
19407,1,0,0,0,0
19408,0,0,101,0,-101
19409,1,0,104,0,-104
19410,1,0,46,0,-46
19411,1,1,2416,1233,-1183
19412,1,0,70,0,-70
19413,0,0,19,0,-19
19414,1,0,21,0,-21
19415,1,0,4,0,-4
19416,0,0,24,0,-24
19417,1,1,713,2071,1358
19418,1,1,1374,2274,900
19419,1,0,50,0,-50
19420,0,0,35,0,-35
19421,0,0,202,0,-202
19422,1,0,25,0,-25
19423,1,0,117,0,-117
19424,1,1,985,1487,502
19425,0,0,40,0,-40
19426,1,0,124,0,-124
19427,1,0,189,0,-189
19428,0,0,88,0,-88
19429,1,1,1262,1532,270
19430,1,0,158,0,-158
19431,1,1,314,1279,965
19432,1,1,127,1204,1077
19433,0,0,0,0,0
19434,1,0,2,0,-2
19435,0,0,30,0,-30
19436,0,0,6,0,-6
19437,1,0,24,0,-24
19438,0,0,78,0,-78
19439,0,0,66,0,-66
19440,0,0,166,0,-166
19441,1,0,11,0,-11
19442,1,0,23,0,-23
19443,0,0,23,0,-23
19444,1,1,191,1855,1664
19445,0,0,172,0,-172
19446,1,0,65,0,-65
19447,1,1,410,1211,801
19448,1,1,252,1212,960
19449,0,0,192,0,-192
19450,1,0,108,0,-108
19451,0,0,87,0,-87
19452,1,0,58,0,-58
19453,1,0,45,0,-45
19454,0,0,72,0,-72
19455,1,1,69,1517,1448
19456,1,0,17,0,-17
19457,0,0,37,0,-37
19458,0,0,40,0,-40
19459,1,0,173,0,-173
19460,0,0,27,0,-27
19461,0,0,230,0,-230
19462,0,0,12,0,-12
19463,0,0,34,0,-34
19464,1,1,619,2412,1793
19465,1,0,28,0,-28
19466,1,0,24,0,-24
19467,0,0,17,0,-17
19468,1,1,552,2080,1528
19469,1,1,678,3489,2811
19470,1,0,31,0,-31
19471,0,0,69,0,-69
19472,0,0,37,0,-37
19473,1,1,341,1371,1030
19474,1,0,24,0,-24
19475,1,1,435,1565,1130
19476,1,1,722,1632,910
19477,0,0,85,0,-85
19478,0,0,1,0,-1
19479,1,0,59,0,-59
19480,1,1,115,1679,1564
19481,0,0,8,0,-8
19482,1,0,50,0,-50
19483,0,0,34,0,-34
19484,0,0,94,0,-94
19485,1,1,240,2303,2063
19486,1,1,396,1227,831
19487,0,0,94,0,-94
19488,1,1,707,2736,2029
19489,1,1,61,4621,4560
19490,0,0,56,0,-56
19491,1,1,850,1226,376
19492,1,0,121,0,-121
19493,0,0,22,0,-22
19494,1,1,143,3839,3696
19495,1,0,77,0,-77
19496,1,0,75,0,-75
19497,0,0,9,0,-9
19498,1,1,79,2072,1993
19499,0,0,18,0,-18
19500,1,0,29,0,-29
19501,0,0,86,0,-86
19502,0,0,15,0,-15
19503,1,0,33,0,-33
19504,0,0,67,0,-67
19505,1,1,337,1210,873
19506,0,0,16,0,-16
19507,1,1,407,2332,1925
19508,1,0,68,0,-68
19509,0,0,87,0,-87
19510,0,0,154,0,-154
19511,1,1,15,1704,1689
19512,1,1,872,1257,385
19513,1,1,94,1486,1392
19514,1,1,238,1311,1073
19515,1,1,602,1233,631
19516,0,0,48,0,-48
19517,1,0,50,0,-50
19518,0,0,7,0,-7
19519,1,0,100,0,-100
19520,0,0,3,0,-3
19521,0,0,29,0,-29
19522,0,0,46,0,-46
19523,1,0,44,0,-44
19524,0,0,54,0,-54
19525,0,0,8,0,-8
19526,0,0,26,0,-26
19527,0,0,74,0,-74
19528,1,1,456,3321,2865
19529,1,1,348,2049,1701
19530,1,1,829,1808,979
19531,1,0,147,0,-147
19532,1,1,229,1262,1033
19533,1,1,850,1543,693
19534,1,1,333,1730,1397
19535,0,0,200,0,-200
19536,1,0,76,0,-76
19537,1,1,186,1262,1076
19538,1,1,418,1238,820
19539,1,0,104,0,-104
19540,1,1,396,1296,900
19541,0,0,188,0,-188
19542,1,0,14,0,-14
19543,0,0,15,0,-15
19544,1,1,148,1685,1537
19545,0,0,23,0,-23
19546,1,0,117,0,-117
19547,0,0,20,0,-20
19548,1,0,24,0,-24
19549,1,0,28,0,-28
19550,1,1,161,2303,2142
19551,1,1,202,1496,1294
19552,1,0,15,0,-15
19553,1,0,2,0,-2
19554,1,1,516,2150,1634
19555,1,1,474,1463,989
19556,0,0,34,0,-34
19557,1,0,0,0,0
19558,0,0,25,0,-25
19559,1,1,2483,1475,-1008
19560,0,0,0,0,0
19561,0,0,68,0,-68
19562,0,0,44,0,-44
19563,1,0,69,0,-69
19564,1,1,514,2267,1753
19565,0,0,68,0,-68
19566,1,0,2,0,-2
19567,1,0,20,0,-20
19568,1,1,303,1323,1020
19569,0,0,24,0,-24
19570,0,0,42,0,-42
19571,0,0,46,0,-46
19572,1,1,199,1224,1025
19573,0,0,5,0,-5
19574,1,1,237,1639,1402
19575,0,0,99,0,-99
19576,1,0,60,0,-60
19577,1,1,637,1514,877
19578,1,0,41,0,-41
19579,0,0,40,0,-40
19580,1,0,15,0,-15
19581,1,0,29,0,-29
19582,1,0,119,0,-119
19583,1,1,163,1352,1189
19584,0,0,104,0,-104
19585,1,0,11,0,-11
19586,1,0,41,0,-41
19587,0,0,36,0,-36
19588,1,1,937,1357,420
19589,1,1,391,3983,3592
19590,1,1,87,1324,1237
19591,1,1,601,1367,766
19592,0,0,17,0,-17
19593,1,0,4,0,-4
19594,1,1,270,2145,1875
19595,1,1,876,2334,1458
19596,1,1,296,1602,1306
19597,0,0,82,0,-82
19598,1,0,8,0,-8
19599,1,1,757,1465,708
19600,1,0,140,0,-140
19601,0,0,15,0,-15
19602,0,0,20,0,-20
19603,0,0,53,0,-53
19604,0,0,54,0,-54
19605,1,1,319,1275,956
19606,1,0,19,0,-19
19607,1,1,710,1251,541
19608,1,0,8,0,-8
19609,1,0,101,0,-101
19610,1,1,634,1233,599
19611,1,1,1359,1901,542
19612,0,0,61,0,-61
19613,1,1,66,1500,1434
19614,0,0,20,0,-20
19615,0,0,56,0,-56
19616,1,1,222,1472,1250
19617,0,0,20,0,-20
19618,1,0,11,0,-11
19619,0,0,3,0,-3
19620,0,0,153,0,-153
19621,1,1,278,1225,947
19622,1,0,32,0,-32
19623,0,0,22,0,-22
19624,1,0,57,0,-57
19625,0,0,110,0,-110
19626,0,0,45,0,-45
19627,1,0,15,0,-15
19628,1,0,2,0,-2
19629,0,0,17,0,-17
19630,1,1,351,1828,1477
19631,1,0,47,0,-47
19632,1,1,189,1639,1450
19633,1,0,49,0,-49
19634,1,1,404,1555,1151
19635,1,1,131,1274,1143
19636,0,0,16,0,-16
19637,1,1,67,1672,1605
19638,1,0,47,0,-47
19639,1,0,68,0,-68
19640,0,0,123,0,-123
19641,0,0,69,0,-69
19642,0,0,114,0,-114
19643,1,0,32,0,-32
19644,1,0,16,0,-16
19645,0,0,26,0,-26
19646,1,1,344,2408,2064
19647,0,0,42,0,-42
19648,0,0,75,0,-75
19649,0,0,58,0,-58
19650,1,1,1108,2191,1083
19651,1,1,122,2553,2431
19652,0,0,32,0,-32
19653,0,0,19,0,-19
19654,1,0,3,0,-3
19655,0,0,80,0,-80
19656,1,1,196,1470,1274
19657,1,1,340,1370,1030
19658,1,0,17,0,-17
19659,1,1,508,1872,1364
19660,0,0,122,0,-122
19661,1,0,40,0,-40
19662,1,0,101,0,-101
19663,0,0,18,0,-18
19664,0,0,12,0,-12
19665,0,0,11,0,-11
19666,1,0,31,0,-31
19667,0,0,17,0,-17
19668,1,0,0,0,0
19669,0,0,11,0,-11
19670,0,0,12,0,-12
19671,0,0,12,0,-12
19672,0,0,110,0,-110
19673,0,0,32,0,-32
19674,0,0,113,0,-113
19675,0,0,143,0,-143
19676,1,1,106,1420,1314
19677,1,0,56,0,-56
19678,0,0,31,0,-31
19679,1,1,2437,1210,-1227
19680,1,1,1027,3654,2627
19681,1,1,216,1389,1173
19682,0,0,58,0,-58
19683,1,0,61,0,-61
19684,1,0,0,0,0
19685,0,0,130,0,-130
19686,0,0,71,0,-71
19687,1,0,26,0,-26
19688,1,1,244,2997,2753
19689,0,0,89,0,-89
19690,0,0,13,0,-13
19691,1,0,28,0,-28
19692,0,0,13,0,-13
19693,0,0,45,0,-45
19694,0,0,60,0,-60
19695,1,1,561,3215,2654
19696,0,0,29,0,-29
19697,1,1,1371,1462,91
19698,0,0,2,0,-2
19699,1,0,6,0,-6
19700,1,0,125,0,-125
19701,1,0,3,0,-3
19702,0,0,14,0,-14
19703,1,0,90,0,-90
19704,1,1,1505,1842,337
19705,1,1,490,1362,872
19706,1,0,13,0,-13
19707,1,0,42,0,-42
19708,1,0,6,0,-6
19709,0,0,1,0,-1
19710,1,1,490,1592,1102
19711,0,0,62,0,-62
19712,1,0,0,0,0
19713,0,0,56,0,-56
19714,1,0,23,0,-23
19715,1,1,499,1378,879
19716,0,0,0,0,0
19717,0,0,46,0,-46
19718,1,1,613,1446,833
19719,1,1,578,1215,637
19720,1,0,12,0,-12
19721,1,1,206,1409,1203
19722,0,0,104,0,-104
19723,1,0,6,0,-6
19724,0,0,30,0,-30
19725,1,1,371,1501,1130
19726,1,1,187,2671,2484
19727,1,0,90,0,-90
19728,0,0,0,0,0
19729,1,0,10,0,-10
19730,0,0,12,0,-12
19731,0,0,93,0,-93
19732,1,0,20,0,-20
19733,0,0,2,0,-2
19734,0,0,44,0,-44
19735,1,0,9,0,-9
19736,0,0,131,0,-131
19737,0,0,13,0,-13
19738,1,0,65,0,-65
19739,1,0,102,0,-102
19740,1,1,176,1554,1378
19741,1,0,58,0,-58
19742,1,1,397,2000,1603
19743,1,1,641,1550,909
19744,0,0,50,0,-50
19745,0,0,169,0,-169
19746,1,1,202,1352,1150
19747,1,0,0,0,0
19748,0,0,13,0,-13
19749,0,0,86,0,-86
19750,1,0,97,0,-97
19751,1,1,683,1274,591
19752,0,0,62,0,-62
19753,0,0,109,0,-109
19754,1,0,2,0,-2
19755,0,0,10,0,-10
19756,0,0,68,0,-68
19757,1,1,319,1359,1040
19758,0,0,28,0,-28
19759,0,0,9,0,-9
19760,1,0,86,0,-86
19761,0,0,93,0,-93
19762,1,1,464,1931,1467
19763,0,0,27,0,-27
19764,1,0,115,0,-115
19765,1,0,120,0,-120
19766,1,1,680,1225,545
19767,0,0,94,0,-94
19768,0,0,61,0,-61
19769,0,0,27,0,-27
19770,0,0,65,0,-65
19771,1,1,196,1377,1181
19772,0,0,4,0,-4
19773,1,1,120,1231,1111
19774,1,1,244,1292,1048
19775,1,1,156,1440,1284
19776,1,0,100,0,-100
19777,1,1,475,1329,854
19778,1,1,488,1896,1408
19779,1,0,30,0,-30
19780,0,0,186,0,-186
19781,1,1,231,1769,1538
19782,1,0,82,0,-82
19783,1,1,7,1358,1351
19784,1,1,154,1409,1255
19785,1,0,148,0,-148
19786,1,0,3,0,-3
19787,0,0,34,0,-34
19788,0,0,1,0,-1
19789,1,1,637,1275,638
19790,0,0,99,0,-99
19791,1,1,525,1318,793
19792,0,0,3,0,-3
19793,1,0,67,0,-67
19794,1,1,249,2015,1766
19795,1,1,375,1886,1511
19796,0,0,36,0,-36
19797,0,0,84,0,-84
19798,1,1,622,1384,762
19799,1,1,406,2140,1734
19800,1,1,1537,1309,-228
19801,1,0,20,0,-20
19802,0,0,37,0,-37
19803,1,1,380,1367,987
19804,1,0,62,0,-62
19805,1,0,38,0,-38
19806,0,0,10,0,-10
19807,0,0,44,0,-44
19808,0,0,51,0,-51
19809,1,0,101,0,-101
19810,1,0,57,0,-57
19811,1,0,37,0,-37
19812,0,0,24,0,-24
19813,1,0,4,0,-4
19814,1,1,122,2071,1949
19815,0,0,36,0,-36
19816,0,0,48,0,-48
19817,1,1,416,1202,786
19818,1,0,7,0,-7
19819,0,0,273,0,-273
19820,1,1,740,1375,635
19821,1,1,724,1219,495
19822,1,1,569,1394,825
19823,0,0,13,0,-13
19824,1,1,168,1238,1070
19825,0,0,102,0,-102
19826,1,0,69,0,-69
19827,1,0,70,0,-70
19828,1,0,0,0,0
19829,0,0,17,0,-17
19830,1,0,6,0,-6
19831,0,0,69,0,-69
19832,0,0,51,0,-51
19833,1,0,72,0,-72
19834,1,1,317,1594,1277
19835,1,1,283,1570,1287
19836,0,0,28,0,-28
19837,1,0,63,0,-63
19838,1,1,198,1209,1011
19839,1,0,189,0,-189
19840,1,1,381,1287,906
19841,0,0,5,0,-5
19842,1,1,542,2555,2013
19843,0,0,36,0,-36
19844,1,0,36,0,-36
19845,1,0,4,0,-4
19846,1,0,58,0,-58
19847,1,0,17,0,-17
19848,0,0,59,0,-59
19849,0,0,49,0,-49
19850,1,0,202,0,-202
19851,1,0,5,0,-5
19852,1,0,1,0,-1
19853,1,0,81,0,-81
19854,1,1,672,1655,983
19855,1,1,1364,1719,355
19856,1,0,219,0,-219
19857,1,0,18,0,-18
19858,0,0,19,0,-19
19859,0,0,1,0,-1
19860,1,1,606,1304,698
19861,1,0,5,0,-5
19862,0,0,106,0,-106
19863,1,1,143,2484,2341
19864,0,0,53,0,-53
19865,1,1,703,1348,645
19866,1,0,19,0,-19
19867,0,0,19,0,-19
19868,1,1,790,1253,463
19869,1,0,9,0,-9
19870,1,0,13,0,-13
19871,0,0,9,0,-9
19872,1,0,5,0,-5
19873,1,0,97,0,-97
19874,0,0,88,0,-88
19875,1,1,456,1302,846
19876,1,1,1116,1274,158
19877,0,0,68,0,-68
19878,0,0,2,0,-2
19879,1,0,239,0,-239
19880,1,0,63,0,-63
19881,0,0,51,0,-51
19882,1,0,22,0,-22
19883,0,0,106,0,-106
19884,0,0,8,0,-8
19885,0,0,9,0,-9
19886,0,0,83,0,-83
19887,0,0,7,0,-7
19888,1,1,93,1221,1128
19889,1,0,32,0,-32
19890,0,0,44,0,-44
19891,0,0,45,0,-45
19892,1,1,149,1559,1410
19893,1,1,708,3245,2537
19894,0,0,99,0,-99
19895,1,1,989,2148,1159
19896,1,1,564,1352,788
19897,0,0,2,0,-2
19898,1,1,136,2050,1914
19899,1,1,2872,1223,-1649
19900,0,0,177,0,-177
19901,0,0,6,0,-6
19902,1,0,45,0,-45
19903,0,0,11,0,-11
19904,0,0,50,0,-50
19905,0,0,98,0,-98
19906,1,0,29,0,-29
19907,0,0,6,0,-6
19908,0,0,134,0,-134
19909,0,0,5,0,-5
19910,1,0,17,0,-17
19911,1,1,1946,1795,-151
19912,0,0,13,0,-13
19913,1,1,1416,1629,213
19914,0,0,140,0,-140
19915,1,0,33,0,-33
19916,1,0,5,0,-5
19917,1,1,2326,1313,-1013
19918,1,1,1392,1283,-109
19919,0,0,45,0,-45
19920,1,1,228,1774,1546
19921,0,0,8,0,-8
19922,0,0,3,0,-3
19923,0,0,0,0,0
19924,0,0,10,0,-10
19925,1,0,57,0,-57
19926,1,0,30,0,-30
19927,0,0,3,0,-3
19928,1,0,17,0,-17
19929,0,0,33,0,-33
19930,0,0,30,0,-30
19931,1,0,2,0,-2
19932,0,0,4,0,-4
19933,1,1,1335,1410,75
19934,1,0,10,0,-10
19935,0,0,25,0,-25
19936,1,1,300,1358,1058
19937,1,1,93,1586,1493
19938,1,1,446,1926,1480
19939,0,0,43,0,-43
19940,1,1,912,1719,807
19941,0,0,78,0,-78
19942,1,1,463,1263,800
19943,1,1,483,1397,914
19944,1,0,88,0,-88
19945,1,0,68,0,-68
19946,1,0,34,0,-34
19947,0,0,21,0,-21
19948,1,0,52,0,-52
19949,0,0,7,0,-7
19950,0,0,155,0,-155
19951,1,0,72,0,-72
19952,0,0,53,0,-53
19953,0,0,13,0,-13
19954,1,1,1109,1219,110
19955,1,0,79,0,-79
19956,1,1,588,1732,1144
19957,1,1,17,1381,1364
19958,1,1,96,1480,1384
19959,0,0,4,0,-4
19960,0,0,58,0,-58
19961,1,1,739,3377,2638
19962,1,1,271,1317,1046
19963,0,0,181,0,-181
19964,0,0,18,0,-18
19965,1,1,255,1273,1018
19966,0,0,5,0,-5
19967,1,1,121,1395,1274
19968,0,0,13,0,-13
19969,0,0,59,0,-59
19970,0,0,31,0,-31
19971,1,1,170,1401,1231
19972,1,1,313,1348,1035
19973,1,0,123,0,-123
19974,1,0,48,0,-48
19975,1,0,0,0,0
19976,1,1,539,1615,1076
19977,0,0,50,0,-50
19978,0,0,45,0,-45
19979,1,1,176,1797,1621
19980,1,0,187,0,-187
19981,1,1,163,1491,1328
19982,0,0,3,0,-3
19983,1,1,511,1521,1010
19984,1,0,93,0,-93
19985,0,0,12,0,-12
19986,0,0,0,0,0
19987,1,1,148,2516,2368
19988,0,0,40,0,-40
19989,0,0,10,0,-10
19990,1,0,14,0,-14
19991,1,0,26,0,-26
19992,0,0,0,0,0
19993,0,0,157,0,-157
19994,1,0,25,0,-25
19995,1,0,49,0,-49
19996,1,1,929,1344,415
19997,0,0,137,0,-137
19998,1,0,4,0,-4
19999,0,0,7,0,-7
20000,1,1,170,1604,1434
20001,1,1,312,1262,950
20002,0,0,46,0,-46
20003,1,0,16,0,-16
20004,1,1,947,1445,498
20005,1,1,667,1247,580
20006,1,1,316,1403,1087
20007,1,0,24,0,-24
20008,1,0,28,0,-28
20009,0,0,25,0,-25
20010,1,1,438,1544,1106
20011,1,0,37,0,-37
20012,0,0,38,0,-38
20013,0,0,86,0,-86
20014,0,0,18,0,-18
20015,1,1,122,1382,1260
20016,0,0,267,0,-267
20017,1,1,178,1522,1344
20018,0,0,112,0,-112
20019,1,0,5,0,-5
20020,1,1,841,1260,419
20021,0,0,110,0,-110
20022,0,0,50,0,-50
20023,1,1,414,1240,826
20024,1,1,80,1652,1572
20025,0,0,23,0,-23
20026,0,0,185,0,-185
20027,0,0,32,0,-32
20028,1,1,126,1242,1116
20029,0,0,70,0,-70
20030,1,0,21,0,-21
20031,1,1,691,1225,534
20032,1,0,49,0,-49
20033,1,0,3,0,-3
20034,0,0,184,0,-184
20035,1,1,434,1834,1400
20036,1,0,37,0,-37
20037,0,0,0,0,0
20038,0,0,34,0,-34
20039,1,1,1354,1209,-145
20040,1,0,160,0,-160
20041,1,1,65,3196,3131
20042,1,0,52,0,-52
20043,1,1,1154,1356,202
20044,0,0,3,0,-3
20045,1,0,89,0,-89
20046,0,0,0,0,0
20047,1,1,241,1359,1118
20048,1,0,35,0,-35
20049,0,0,34,0,-34
20050,1,0,11,0,-11
20051,0,0,27,0,-27
20052,1,0,19,0,-19
20053,1,0,49,0,-49
20054,1,0,53,0,-53
20055,1,1,270,1258,988
20056,0,0,40,0,-40
20057,1,0,16,0,-16
20058,1,0,24,0,-24
20059,1,1,20,1690,1670
20060,1,0,48,0,-48
20061,0,0,30,0,-30
20062,0,0,69,0,-69
20063,0,0,24,0,-24
20064,0,0,2,0,-2
20065,1,1,785,1358,573
20066,1,1,955,1362,407
20067,0,0,11,0,-11
20068,0,0,7,0,-7
20069,1,0,90,0,-90
20070,1,0,17,0,-17
20071,0,0,6,0,-6
20072,0,0,22,0,-22
20073,1,0,25,0,-25
20074,1,1,1214,1210,-4
20075,1,1,219,1343,1124
20076,0,0,103,0,-103
20077,0,0,57,0,-57
20078,0,0,35,0,-35
20079,1,0,38,0,-38
20080,1,0,135,0,-135
20081,0,0,20,0,-20
20082,1,1,766,1367,601
20083,1,1,258,1465,1207
20084,1,0,70,0,-70
20085,1,1,291,1657,1366
20086,1,0,89,0,-89
20087,0,0,39,0,-39
20088,1,1,766,2719,1953
20089,1,0,12,0,-12
20090,1,1,1772,1202,-570
20091,1,0,46,0,-46
20092,1,0,17,0,-17
20093,0,0,5,0,-5
20094,1,1,757,1446,689
20095,1,1,419,1251,832
20096,0,0,131,0,-131
20097,1,0,10,0,-10
20098,0,0,11,0,-11
20099,1,1,56,1205,1149
20100,1,0,54,0,-54
20101,1,1,2880,3343,463
20102,1,0,22,0,-22
20103,0,0,80,0,-80
20104,1,1,979,1470,491
20105,0,0,4,0,-4
20106,0,0,7,0,-7
20107,0,0,12,0,-12
20108,0,0,234,0,-234
20109,1,1,1454,1977,523
20110,0,0,68,0,-68
20111,0,0,22,0,-22
20112,0,0,8,0,-8
20113,1,1,1182,1479,297
20114,0,0,0,0,0
20115,1,0,33,0,-33
20116,0,0,38,0,-38
20117,0,0,199,0,-199
20118,1,0,11,0,-11
20119,1,1,1899,1355,-544
20120,0,0,183,0,-183
20121,1,1,1308,1558,250
20122,0,0,47,0,-47
20123,0,0,31,0,-31
20124,0,0,6,0,-6
20125,0,0,58,0,-58
20126,0,0,45,0,-45
20127,0,0,13,0,-13
20128,1,0,24,0,-24
20129,1,1,308,1353,1045
20130,1,0,69,0,-69
20131,0,0,53,0,-53
20132,1,0,51,0,-51
20133,0,0,48,0,-48
20134,0,0,120,0,-120
20135,0,0,32,0,-32
20136,0,0,18,0,-18
20137,1,0,81,0,-81
20138,0,0,7,0,-7
20139,1,1,521,1257,736
20140,1,0,7,0,-7
20141,1,1,219,1221,1002
20142,1,0,74,0,-74
20143,0,0,13,0,-13
20144,1,1,674,1891,1217
20145,0,0,67,0,-67
20146,0,0,65,0,-65
20147,1,1,57,1249,1192
20148,1,1,50,1783,1733
20149,0,0,76,0,-76
20150,0,0,26,0,-26
20151,1,1,343,1548,1205
20152,0,0,5,0,-5
20153,0,0,14,0,-14
20154,1,1,671,2813,2142
20155,0,0,28,0,-28
20156,1,0,60,0,-60
20157,1,1,532,1379,847
20158,1,0,27,0,-27
20159,0,0,62,0,-62
20160,0,0,68,0,-68
20161,1,0,49,0,-49
20162,1,0,22,0,-22
20163,1,1,214,1719,1505
20164,1,0,5,0,-5
20165,1,1,118,1223,1105
20166,1,1,211,1809,1598
20167,0,0,44,0,-44
20168,1,0,23,0,-23
20169,1,1,1397,1251,-146
20170,0,0,82,0,-82
20171,0,0,28,0,-28
20172,1,0,28,0,-28
20173,1,1,256,1227,971
20174,1,0,28,0,-28
20175,0,0,23,0,-23
20176,0,0,129,0,-129
20177,0,0,104,0,-104
20178,1,1,300,1625,1325
20179,0,0,112,0,-112
20180,1,1,382,1201,819
20181,1,1,400,2241,1841
20182,0,0,19,0,-19
20183,1,0,74,0,-74
20184,1,0,49,0,-49
20185,1,0,14,0,-14
20186,1,0,1,0,-1
20187,1,0,43,0,-43
20188,1,1,528,1698,1170
20189,0,0,60,0,-60
20190,1,0,11,0,-11
20191,0,0,3,0,-3
20192,1,0,58,0,-58
20193,1,0,1,0,-1
20194,1,1,1532,1592,60
20195,1,0,52,0,-52
20196,0,0,52,0,-52
20197,1,0,11,0,-11
20198,0,0,82,0,-82
20199,1,1,481,1769,1288
20200,1,1,305,1613,1308
20201,1,1,546,1391,845
20202,1,1,618,1442,824
20203,0,0,23,0,-23
20204,0,0,5,0,-5
20205,0,0,60,0,-60
20206,1,0,20,0,-20
20207,1,0,141,0,-141
20208,0,0,14,0,-14
20209,0,0,189,0,-189
20210,1,1,31,1211,1180
20211,1,0,31,0,-31
20212,0,0,13,0,-13
20213,0,0,31,0,-31
20214,0,0,110,0,-110
20215,1,1,650,6114,5464
20216,1,0,30,0,-30
20217,0,0,37,0,-37
20218,0,0,73,0,-73
20219,1,1,529,1207,678
20220,0,0,241,0,-241
20221,0,0,74,0,-74
20222,0,0,47,0,-47
20223,0,0,2,0,-2
20224,1,1,124,1329,1205
20225,1,1,450,1310,860
20226,1,0,148,0,-148
20227,0,0,115,0,-115
20228,1,0,59,0,-59
20229,1,1,369,1206,837
20230,0,0,69,0,-69
20231,0,0,14,0,-14
20232,1,0,23,0,-23
20233,0,0,43,0,-43
20234,1,0,148,0,-148
20235,1,1,1087,1279,192
20236,1,0,99,0,-99
20237,1,1,1414,1221,-193
20238,0,0,14,0,-14
20239,0,0,12,0,-12
20240,1,1,787,1716,929
20241,0,0,190,0,-190
20242,0,0,73,0,-73
20243,1,0,2,0,-2
20244,0,0,127,0,-127
20245,0,0,1,0,-1
20246,1,1,144,1207,1063
20247,1,0,17,0,-17
20248,0,0,178,0,-178
20249,1,0,25,0,-25
20250,1,1,1155,1341,186
20251,1,0,16,0,-16
20252,1,1,220,1424,1204
20253,1,0,118,0,-118
20254,1,1,1073,1559,486
20255,1,0,79,0,-79
20256,1,0,48,0,-48
20257,0,0,24,0,-24
20258,0,0,58,0,-58
20259,1,0,37,0,-37
20260,0,0,82,0,-82
20261,0,0,149,0,-149
20262,1,0,98,0,-98
20263,1,0,39,0,-39
20264,1,0,3,0,-3
20265,1,1,2097,1403,-694
20266,0,0,8,0,-8
20267,1,1,476,1282,806
20268,1,0,40,0,-40
20269,0,0,25,0,-25
20270,1,1,177,1311,1134
20271,1,1,151,2092,1941
20272,1,1,196,2325,2129
20273,0,0,116,0,-116
20274,1,1,1564,1890,326
20275,1,1,1465,1258,-207
20276,1,0,66,0,-66
20277,1,1,935,1235,300
20278,1,1,336,1986,1650
20279,1,1,1191,1592,401
20280,0,0,40,0,-40
20281,0,0,31,0,-31
20282,1,1,212,1338,1126
20283,1,0,48,0,-48
20284,1,0,47,0,-47
20285,1,0,110,0,-110
20286,0,0,7,0,-7
20287,0,0,94,0,-94
20288,1,0,36,0,-36
20289,0,0,2,0,-2
20290,1,1,752,1211,459
20291,1,0,235,0,-235
20292,1,1,102,1435,1333
20293,1,1,530,1659,1129
20294,0,0,13,0,-13
20295,1,0,0,0,0
20296,0,0,41,0,-41
20297,0,0,4,0,-4
20298,1,0,165,0,-165
20299,1,0,227,0,-227
20300,1,1,349,1502,1153
20301,1,1,352,1301,949
20302,1,0,62,0,-62
20303,1,0,20,0,-20
20304,1,1,161,1239,1078
20305,1,0,17,0,-17
20306,1,0,35,0,-35
20307,1,0,125,0,-125
20308,1,1,472,1548,1076
20309,1,0,42,0,-42
20310,1,1,2499,1335,-1164
20311,1,0,11,0,-11
20312,1,0,13,0,-13
20313,0,0,7,0,-7
20314,1,0,9,0,-9
20315,0,0,88,0,-88
20316,1,1,607,1362,755
20317,0,0,266,0,-266
20318,1,0,36,0,-36
20319,1,1,318,1277,959
20320,1,0,24,0,-24
20321,1,0,135,0,-135
20322,1,1,84,1271,1187
20323,1,1,302,3591,3289
20324,0,0,14,0,-14
20325,1,1,2085,1349,-736
20326,1,0,80,0,-80
20327,1,0,35,0,-35
20328,1,0,86,0,-86
20329,1,1,702,1242,540
20330,1,0,34,0,-34
20331,1,0,40,0,-40
20332,0,0,64,0,-64
20333,1,0,40,0,-40
20334,1,0,112,0,-112
20335,0,0,35,0,-35
20336,1,1,1518,1287,-231
20337,1,1,377,1353,976
20338,0,0,15,0,-15
20339,1,0,74,0,-74
20340,0,0,20,0,-20
20341,1,0,92,0,-92
20342,0,0,74,0,-74
20343,0,0,96,0,-96
20344,1,0,41,0,-41
20345,0,0,43,0,-43
20346,1,1,98,1554,1456
20347,0,0,54,0,-54
20348,1,0,6,0,-6
20349,0,0,74,0,-74
20350,1,1,96,1481,1385
20351,0,0,20,0,-20
20352,0,0,9,0,-9
20353,1,0,39,0,-39
20354,1,0,5,0,-5
20355,0,0,2,0,-2
20356,1,1,63,1295,1232
20357,0,0,44,0,-44
20358,1,0,1,0,-1
20359,1,1,120,1230,1110
20360,1,0,86,0,-86
20361,0,0,42,0,-42
20362,1,1,61,1246,1185
20363,0,0,33,0,-33
20364,1,1,613,1736,1123
20365,1,1,937,3130,2193
20366,1,0,22,0,-22
20367,1,1,58,2485,2427
20368,1,0,64,0,-64
20369,1,1,243,1771,1528
20370,0,0,23,0,-23
20371,1,1,420,3710,3290
20372,0,0,105,0,-105
20373,0,0,91,0,-91
20374,1,0,68,0,-68
20375,0,0,113,0,-113
20376,1,0,172,0,-172
20377,1,1,804,1731,927
20378,1,0,30,0,-30
20379,0,0,19,0,-19
20380,0,0,89,0,-89
20381,1,1,1047,1237,190
20382,1,0,36,0,-36
20383,0,0,11,0,-11
20384,1,0,32,0,-32
20385,1,1,626,1930,1304
20386,1,1,880,1344,464
20387,1,0,29,0,-29
20388,0,0,20,0,-20
20389,1,1,174,1561,1387
20390,0,0,82,0,-82
20391,1,1,237,1894,1657
20392,0,0,131,0,-131
20393,1,0,10,0,-10
20394,1,0,2,0,-2
20395,0,0,8,0,-8
20396,0,0,151,0,-151
20397,1,1,255,1202,947
20398,1,1,939,1993,1054
20399,1,1,692,1231,539
20400,1,1,1480,1246,-234
20401,1,1,653,1650,997
20402,1,1,478,1291,813
20403,0,0,10,0,-10
20404,1,1,654,1297,643
20405,0,0,64,0,-64
20406,0,0,85,0,-85
20407,1,0,42,0,-42
20408,0,0,1,0,-1
20409,1,0,63,0,-63
20410,1,1,165,1550,1385
20411,1,1,385,1246,861
20412,0,0,0,0,0
20413,0,0,58,0,-58
20414,1,0,37,0,-37
20415,0,0,35,0,-35
20416,1,0,22,0,-22
20417,1,0,7,0,-7
20418,0,0,9,0,-9
20419,1,0,39,0,-39
20420,0,0,43,0,-43
20421,0,0,54,0,-54
20422,0,0,5,0,-5
20423,1,1,607,1493,886
20424,1,0,100,0,-100
20425,1,0,7,0,-7
20426,1,1,273,2005,1732
20427,1,0,48,0,-48
20428,1,0,26,0,-26
20429,1,0,12,0,-12
20430,1,1,155,1352,1197
20431,0,0,13,0,-13
20432,1,1,1784,1286,-498
20433,0,0,57,0,-57
20434,0,0,82,0,-82
20435,0,0,23,0,-23
20436,0,0,8,0,-8
20437,1,1,55,1229,1174
20438,0,0,6,0,-6
20439,0,0,30,0,-30
20440,0,0,112,0,-112
20441,1,1,1488,1691,203
20442,0,0,28,0,-28
20443,1,0,47,0,-47
20444,1,0,155,0,-155
20445,1,0,12,0,-12
20446,0,0,8,0,-8
20447,0,0,34,0,-34
20448,1,0,7,0,-7
20449,0,0,8,0,-8
20450,0,0,115,0,-115
20451,0,0,119,0,-119
20452,1,1,374,1238,864
20453,1,0,41,0,-41
20454,1,1,77,1799,1722
20455,1,1,220,2511,2291
20456,1,1,1381,1293,-88
20457,0,0,35,0,-35
20458,1,0,3,0,-3
20459,1,1,732,1345,613
20460,1,0,63,0,-63
20461,1,0,73,0,-73
20462,0,0,12,0,-12
20463,1,0,22,0,-22
20464,1,1,405,1511,1106
20465,1,1,279,1221,942
20466,0,0,53,0,-53
20467,0,0,15,0,-15
20468,1,1,779,1215,436
20469,1,0,16,0,-16
20470,1,1,775,1216,441
20471,0,0,63,0,-63
20472,1,0,34,0,-34
20473,0,0,39,0,-39
20474,0,0,66,0,-66
20475,0,0,20,0,-20
20476,1,0,7,0,-7
20477,1,1,1644,1833,189
20478,0,0,28,0,-28
20479,1,0,20,0,-20
20480,1,1,2225,2436,211
20481,1,1,267,1627,1360
20482,1,1,69,1348,1279
20483,1,0,95,0,-95
20484,1,1,1319,2691,1372
20485,1,0,37,0,-37
20486,0,0,13,0,-13
20487,1,0,15,0,-15
20488,0,0,14,0,-14
20489,0,0,27,0,-27
20490,0,0,91,0,-91
20491,1,1,301,1431,1130
20492,0,0,59,0,-59
20493,1,1,69,1841,1772
20494,0,0,27,0,-27
20495,0,0,0,0,0
20496,1,1,471,1532,1061
20497,0,0,166,0,-166
20498,1,0,6,0,-6
20499,0,0,12,0,-12
20500,1,0,29,0,-29
20501,1,0,179,0,-179
20502,0,0,39,0,-39
20503,0,0,32,0,-32
20504,1,0,6,0,-6
20505,0,0,25,0,-25
20506,0,0,65,0,-65
20507,1,1,109,1237,1128
20508,1,0,40,0,-40
20509,1,1,473,3008,2535
20510,1,1,833,1353,520
20511,1,0,35,0,-35
20512,1,1,4123,1710,-2413
20513,1,1,419,1757,1338
20514,0,0,98,0,-98
20515,0,0,19,0,-19
20516,0,0,17,0,-17
20517,1,1,42,1685,1643
20518,1,0,12,0,-12
20519,1,0,60,0,-60
20520,0,0,53,0,-53
20521,0,0,65,0,-65
20522,1,0,24,0,-24
20523,0,0,22,0,-22
20524,1,0,77,0,-77
20525,1,0,167,0,-167
20526,0,0,3,0,-3
20527,0,0,94,0,-94
20528,1,1,284,1790,1506
20529,0,0,1,0,-1
20530,1,0,16,0,-16
20531,1,0,97,0,-97
20532,0,0,82,0,-82
20533,1,1,522,1289,767
20534,1,1,329,1452,1123
20535,0,0,90,0,-90
20536,1,0,51,0,-51
20537,1,0,48,0,-48
20538,1,1,972,2236,1264
20539,1,0,2,0,-2
20540,1,0,194,0,-194
20541,0,0,12,0,-12
20542,1,0,37,0,-37
20543,0,0,43,0,-43
20544,0,0,21,0,-21
20545,1,1,161,1240,1079
20546,0,0,0,0,0
20547,1,0,63,0,-63
20548,0,0,26,0,-26
20549,1,0,165,0,-165
20550,1,1,125,2041,1916
20551,0,0,94,0,-94
20552,1,0,99,0,-99
20553,0,0,43,0,-43
20554,1,1,1671,1289,-382
20555,1,0,32,0,-32
20556,1,1,611,1848,1237
20557,1,0,5,0,-5
20558,1,0,0,0,0
20559,0,0,17,0,-17
20560,0,0,47,0,-47
20561,0,0,4,0,-4
20562,0,0,100,0,-100
20563,0,0,60,0,-60
20564,1,0,140,0,-140
20565,0,0,55,0,-55
20566,1,0,84,0,-84
20567,0,0,18,0,-18
20568,0,0,2,0,-2
20569,0,0,4,0,-4
20570,0,0,64,0,-64
20571,1,1,1612,1938,326
20572,1,1,1797,2288,491
20573,0,0,32,0,-32
20574,1,0,35,0,-35
20575,0,0,32,0,-32
20576,1,1,566,1403,837
20577,1,0,31,0,-31
20578,1,1,1127,1699,572
20579,0,0,28,0,-28
20580,1,0,24,0,-24
20581,0,0,114,0,-114
20582,0,0,147,0,-147
20583,0,0,145,0,-145
20584,0,0,36,0,-36
20585,0,0,152,0,-152
20586,1,0,127,0,-127
20587,1,1,83,1421,1338
20588,1,0,79,0,-79
20589,0,0,19,0,-19
20590,1,1,1174,1931,757
20591,1,0,63,0,-63
20592,0,0,0,0,0
20593,1,0,63,0,-63
20594,1,1,38,1253,1215
20595,1,1,608,1202,594
20596,0,0,49,0,-49
20597,1,0,164,0,-164
20598,1,1,165,2082,1917
20599,0,0,85,0,-85
20600,1,1,369,1238,869
20601,0,0,25,0,-25
20602,1,1,38,1604,1566
20603,1,0,6,0,-6
20604,0,0,13,0,-13
20605,1,0,7,0,-7
20606,1,1,623,1701,1078
20607,1,0,1,0,-1
20608,1,1,50,1328,1278
20609,1,1,396,1477,1081
20610,1,0,28,0,-28
20611,1,0,5,0,-5
20612,1,1,2051,1709,-342
20613,0,0,16,0,-16
20614,1,0,117,0,-117
20615,1,0,10,0,-10
20616,0,0,53,0,-53
20617,1,0,3,0,-3
20618,1,1,660,1378,718
20619,0,0,84,0,-84
20620,0,0,39,0,-39
20621,1,1,184,1225,1041
20622,1,1,329,1230,901
20623,1,1,1241,1852,611
20624,0,0,55,0,-55
20625,0,0,39,0,-39
20626,1,0,2,0,-2
20627,1,1,780,1220,440
20628,1,0,10,0,-10
20629,1,0,25,0,-25
20630,1,0,35,0,-35
20631,1,0,37,0,-37
20632,1,1,443,1356,913
20633,0,0,37,0,-37
20634,0,0,97,0,-97
20635,0,0,20,0,-20
20636,0,0,36,0,-36
20637,1,1,1678,1236,-442
20638,1,1,1057,1361,304
20639,1,1,622,2002,1380
20640,1,1,1474,1215,-259
20641,1,0,43,0,-43
20642,0,0,52,0,-52
20643,1,1,544,1277,733
20644,1,1,261,2384,2123
20645,1,1,767,2473,1706
20646,0,0,17,0,-17
20647,0,0,3,0,-3
20648,1,0,25,0,-25
20649,1,1,347,3910,3563
20650,1,0,43,0,-43
20651,0,0,4,0,-4
20652,0,0,64,0,-64
20653,0,0,3,0,-3
20654,0,0,29,0,-29
20655,1,0,28,0,-28
20656,1,1,259,2858,2599
20657,1,0,47,0,-47
20658,0,0,51,0,-51
20659,0,0,14,0,-14
20660,0,0,100,0,-100
20661,1,0,76,0,-76
20662,1,0,97,0,-97
20663,1,1,225,1691,1466
20664,0,0,260,0,-260
20665,0,0,14,0,-14
20666,1,1,65,1205,1140
20667,0,0,18,0,-18
20668,0,0,60,0,-60
20669,1,1,492,1562,1070
20670,0,0,24,0,-24
20671,1,0,102,0,-102
20672,0,0,26,0,-26
20673,0,0,103,0,-103
20674,1,1,201,1283,1082
20675,0,0,43,0,-43
20676,1,1,751,1513,762
20677,0,0,155,0,-155
20678,1,0,2,0,-2
20679,1,0,74,0,-74
20680,0,0,52,0,-52
20681,1,1,261,1332,1071
20682,1,1,495,1216,721
20683,1,0,232,0,-232
20684,1,1,41,1508,1467
20685,1,0,30,0,-30
20686,1,1,291,1439,1148
20687,1,1,219,1508,1289
20688,1,0,8,0,-8
20689,0,0,26,0,-26
20690,0,0,111,0,-111
20691,1,0,6,0,-6
20692,1,1,439,1590,1151
20693,1,1,983,1386,403
20694,0,0,84,0,-84
20695,0,0,10,0,-10
20696,0,0,30,0,-30
20697,1,1,212,1732,1520
20698,1,0,3,0,-3
20699,1,0,18,0,-18
20700,1,1,798,1202,404
20701,0,0,3,0,-3
20702,1,1,1078,1241,163
20703,0,0,36,0,-36
20704,1,1,560,1310,750
20705,0,0,30,0,-30
20706,1,1,119,2510,2391
20707,1,1,500,1502,1002
20708,0,0,110,0,-110
20709,1,1,551,1230,679
20710,1,0,44,0,-44
20711,1,1,76,1858,1782
20712,0,0,0,0,0
20713,1,1,667,2165,1498
20714,0,0,8,0,-8
20715,1,1,235,1642,1407
20716,1,0,16,0,-16
20717,1,1,319,1222,903
20718,0,0,44,0,-44
20719,1,1,243,1871,1628
20720,0,0,21,0,-21
20721,0,0,56,0,-56
20722,1,1,42,1346,1304
20723,0,0,69,0,-69
20724,0,0,56,0,-56
20725,1,0,76,0,-76
20726,1,1,138,1294,1156
20727,1,0,96,0,-96
20728,1,1,382,1438,1056
20729,0,0,3,0,-3
20730,1,0,4,0,-4
20731,1,1,299,1365,1066
20732,1,0,15,0,-15
20733,0,0,28,0,-28
20734,1,0,59,0,-59
20735,0,0,37,0,-37
20736,1,0,73,0,-73
20737,0,0,50,0,-50
20738,0,0,45,0,-45
20739,1,1,285,1229,944
20740,1,0,45,0,-45
20741,0,0,10,0,-10
20742,0,0,51,0,-51
20743,1,1,2458,1220,-1238
20744,0,0,122,0,-122
20745,0,0,10,0,-10
20746,0,0,66,0,-66
20747,0,0,23,0,-23
20748,0,0,100,0,-100
20749,1,0,51,0,-51
20750,0,0,4,0,-4
20751,0,0,10,0,-10
20752,1,1,1313,1414,101
20753,0,0,23,0,-23
20754,1,1,309,1329,1020
20755,1,1,191,2347,2156
20756,1,1,731,1653,922
20757,1,1,383,1283,900
20758,0,0,24,0,-24
20759,0,0,72,0,-72
20760,0,0,12,0,-12
20761,1,1,346,1260,914
20762,0,0,116,0,-116
20763,0,0,119,0,-119
20764,0,0,29,0,-29
20765,1,1,296,1418,1122
20766,0,0,31,0,-31
20767,1,0,123,0,-123
20768,1,0,11,0,-11
20769,0,0,46,0,-46
20770,0,0,128,0,-128
20771,1,1,428,1864,1436
20772,1,1,182,1289,1107
20773,1,0,25,0,-25
20774,0,0,3,0,-3
20775,0,0,2,0,-2
20776,0,0,19,0,-19
20777,0,0,18,0,-18
20778,1,1,495,1287,792
20779,0,0,31,0,-31
20780,1,1,2261,1230,-1031
20781,1,1,176,1280,1104
20782,0,0,23,0,-23
20783,1,0,37,0,-37
20784,0,0,8,0,-8
20785,1,1,89,1530,1441
20786,0,0,105,0,-105
20787,0,0,8,0,-8
20788,0,0,82,0,-82
20789,1,1,287,1292,1005
20790,0,0,134,0,-134
20791,0,0,169,0,-169
20792,1,0,78,0,-78
20793,1,0,9,0,-9
20794,1,0,5,0,-5
20795,1,0,1,0,-1
20796,1,1,404,1227,823
20797,0,0,15,0,-15
20798,1,1,113,1705,1592
20799,1,1,447,2028,1581
20800,1,1,483,1225,742
20801,1,0,41,0,-41
20802,0,0,86,0,-86
20803,0,0,15,0,-15
20804,1,1,1745,1758,13
20805,1,1,440,1473,1033
20806,0,0,4,0,-4
20807,1,1,160,1590,1430
20808,1,0,104,0,-104
20809,1,1,1250,1663,413
20810,1,0,29,0,-29
20811,0,0,4,0,-4
20812,1,1,86,1492,1406
20813,1,1,1085,1909,824
20814,0,0,43,0,-43
20815,1,1,227,1362,1135
20816,1,0,45,0,-45
20817,0,0,35,0,-35
20818,0,0,23,0,-23
20819,0,0,17,0,-17
20820,1,1,1823,1566,-257
20821,1,1,631,1328,697
20822,0,0,45,0,-45
20823,1,1,164,1411,1247
20824,0,0,114,0,-114
20825,0,0,9,0,-9
20826,1,1,340,1248,908
20827,0,0,46,0,-46
20828,1,1,528,1780,1252
20829,1,1,318,1266,948
20830,0,0,49,0,-49
20831,1,0,40,0,-40
20832,0,0,119,0,-119
20833,1,0,43,0,-43
20834,1,1,1575,1253,-322
20835,1,0,17,0,-17
20836,1,0,60,0,-60
20837,0,0,16,0,-16
20838,0,0,42,0,-42
20839,1,0,21,0,-21
20840,1,0,0,0,0
20841,0,0,44,0,-44
20842,1,0,74,0,-74
20843,1,0,33,0,-33
20844,1,0,150,0,-150
20845,1,1,1873,1252,-621
20846,0,0,79,0,-79
20847,1,0,15,0,-15
20848,1,0,10,0,-10
20849,0,0,31,0,-31
20850,1,0,170,0,-170
20851,1,0,36,0,-36
20852,1,1,138,2542,2404
20853,1,0,59,0,-59
20854,0,0,51,0,-51
20855,1,1,175,1306,1131
20856,0,0,4,0,-4
20857,1,0,95,0,-95
20858,0,0,73,0,-73
20859,1,0,41,0,-41
20860,1,1,47,1642,1595
20861,1,0,43,0,-43
20862,1,1,183,1353,1170
20863,1,0,33,0,-33
20864,1,0,109,0,-109
20865,1,0,119,0,-119
20866,0,0,3,0,-3
20867,1,1,225,1347,1122
20868,1,0,5,0,-5
20869,1,0,128,0,-128
20870,1,0,14,0,-14
20871,0,0,89,0,-89
20872,0,0,8,0,-8
20873,1,1,388,2698,2310
20874,1,1,177,1220,1043
20875,1,0,34,0,-34
20876,0,0,34,0,-34
20877,0,0,18,0,-18
20878,0,0,113,0,-113
20879,0,0,50,0,-50
20880,1,0,18,0,-18
20881,1,0,79,0,-79
20882,1,0,67,0,-67
20883,1,0,115,0,-115
20884,1,0,0,0,0
20885,0,0,36,0,-36
20886,1,0,42,0,-42
20887,0,0,32,0,-32
20888,0,0,28,0,-28
20889,0,0,21,0,-21
20890,0,0,30,0,-30
20891,1,1,199,1471,1272
20892,0,0,57,0,-57
20893,1,0,103,0,-103
20894,1,0,69,0,-69
20895,1,1,384,1744,1360
20896,1,0,17,0,-17
20897,0,0,75,0,-75
20898,1,1,971,1384,413
20899,1,1,646,1322,676
20900,0,0,12,0,-12
20901,0,0,301,0,-301
20902,0,0,17,0,-17
20903,0,0,21,0,-21
20904,1,0,61,0,-61
20905,0,0,2,0,-2
20906,0,0,8,0,-8
20907,0,0,2,0,-2
20908,0,0,54,0,-54
20909,1,1,174,1268,1094
20910,1,1,1662,1482,-180
20911,1,0,93,0,-93
20912,1,0,66,0,-66
20913,1,0,100,0,-100
20914,1,0,16,0,-16
20915,0,0,13,0,-13
20916,0,0,63,0,-63
20917,1,1,247,1213,966
20918,1,0,40,0,-40
20919,1,0,150,0,-150
20920,0,0,76,0,-76
20921,1,0,42,0,-42
20922,1,0,0,0,0
20923,1,0,71,0,-71
20924,1,0,41,0,-41
20925,1,0,26,0,-26
20926,1,1,145,1688,1543
20927,1,0,19,0,-19
20928,0,0,40,0,-40
20929,1,0,70,0,-70
20930,0,0,10,0,-10
20931,0,0,8,0,-8
20932,0,0,4,0,-4
20933,0,0,1,0,-1
20934,1,0,41,0,-41
20935,1,1,180,1678,1498
20936,0,0,69,0,-69
20937,0,0,46,0,-46
20938,0,0,36,0,-36
20939,1,0,18,0,-18
20940,1,1,367,1464,1097
20941,1,1,195,4385,4190
20942,1,0,9,0,-9
20943,0,0,131,0,-131
20944,1,0,0,0,0
20945,1,0,40,0,-40
20946,0,0,29,0,-29
20947,1,0,24,0,-24
20948,1,0,27,0,-27
20949,1,0,95,0,-95
20950,0,0,21,0,-21
20951,0,0,10,0,-10
20952,1,0,126,0,-126
20953,1,0,32,0,-32
20954,0,0,12,0,-12
20955,0,0,31,0,-31
20956,1,1,698,1883,1185
20957,1,0,13,0,-13
20958,0,0,36,0,-36
20959,1,0,76,0,-76
20960,1,0,109,0,-109
20961,1,0,22,0,-22
20962,1,1,891,1230,339
20963,0,0,8,0,-8
20964,0,0,8,0,-8
20965,0,0,65,0,-65
20966,1,1,255,1517,1262
20967,1,1,222,1234,1012
20968,0,0,6,0,-6
20969,0,0,238,0,-238
20970,1,1,61,2934,2873
20971,1,0,86,0,-86
20972,1,1,109,1227,1118
20973,1,0,2,0,-2
20974,1,1,1315,1362,47
20975,0,0,67,0,-67
20976,1,1,542,1685,1143
20977,0,0,52,0,-52
20978,0,0,2,0,-2
20979,0,0,94,0,-94
20980,1,0,8,0,-8
20981,0,0,9,0,-9
20982,1,1,322,3214,2892
20983,1,0,37,0,-37
20984,1,1,1173,2044,871
20985,0,0,25,0,-25
20986,1,1,272,1292,1020
20987,0,0,12,0,-12
20988,1,0,22,0,-22
20989,1,1,279,2722,2443
20990,0,0,53,0,-53
20991,1,1,1130,1313,183
20992,1,1,192,1259,1067
20993,0,0,1,0,-1
20994,1,0,4,0,-4
20995,1,1,318,1294,976
20996,1,0,70,0,-70
20997,0,0,76,0,-76
20998,1,1,455,2805,2350
20999,1,0,11,0,-11
21000,1,0,13,0,-13
21001,0,0,8,0,-8
21002,0,0,8,0,-8
21003,0,0,39,0,-39
21004,0,0,41,0,-41
21005,0,0,46,0,-46
21006,1,1,543,1339,796
21007,1,0,62,0,-62
21008,0,0,117,0,-117
21009,1,0,51,0,-51
21010,1,1,332,1412,1080
21011,1,1,489,2274,1785
21012,1,0,11,0,-11
21013,0,0,16,0,-16
21014,1,0,153,0,-153
21015,1,0,24,0,-24
21016,1,0,23,0,-23
21017,1,1,1032,1342,310
21018,0,0,0,0,0
21019,1,0,72,0,-72
21020,1,0,11,0,-11
21021,1,0,1,0,-1
21022,0,0,60,0,-60
21023,0,0,5,0,-5
21024,1,0,81,0,-81
21025,0,0,140,0,-140
21026,0,0,82,0,-82
21027,1,0,98,0,-98
21028,0,0,52,0,-52
21029,0,0,63,0,-63
21030,0,0,43,0,-43
21031,0,0,52,0,-52
21032,0,0,48,0,-48
21033,1,0,69,0,-69
21034,1,0,13,0,-13
21035,0,0,7,0,-7
21036,1,1,113,1204,1091
21037,1,1,364,1212,848
21038,1,0,0,0,0
21039,1,1,57,1362,1305
21040,1,1,518,2876,2358
21041,0,0,64,0,-64
21042,1,0,22,0,-22
21043,1,0,6,0,-6
21044,0,0,73,0,-73
21045,1,1,914,1263,349
21046,0,0,5,0,-5
21047,1,1,1303,1261,-42
21048,1,1,211,1354,1143
21049,1,0,115,0,-115
21050,1,0,99,0,-99
21051,1,1,1460,2263,803
21052,0,0,15,0,-15
21053,1,1,155,1356,1201
21054,1,0,28,0,-28
21055,1,0,20,0,-20
21056,1,0,38,0,-38
21057,1,0,49,0,-49
21058,1,1,725,1549,824
21059,1,1,1247,1651,404
21060,0,0,37,0,-37
21061,1,0,4,0,-4
21062,0,0,110,0,-110
21063,1,0,68,0,-68
21064,0,0,54,0,-54
21065,0,0,121,0,-121
21066,1,1,184,1819,1635
21067,1,0,35,0,-35
21068,1,0,24,0,-24
21069,1,0,16,0,-16
21070,0,0,18,0,-18
21071,1,0,24,0,-24
21072,0,0,141,0,-141
21073,0,0,4,0,-4
21074,1,0,117,0,-117
21075,0,0,17,0,-17
21076,1,0,26,0,-26
21077,0,0,22,0,-22
21078,0,0,147,0,-147
21079,1,1,256,1262,1006
21080,1,1,71,1578,1507
21081,0,0,45,0,-45
21082,1,0,74,0,-74
21083,0,0,69,0,-69
21084,0,0,55,0,-55
21085,0,0,14,0,-14
21086,0,0,23,0,-23
21087,1,0,74,0,-74
21088,0,0,56,0,-56
21089,1,1,146,1541,1395
21090,1,0,9,0,-9
21091,0,0,20,0,-20
21092,1,1,49,1366,1317
21093,1,0,2,0,-2
21094,0,0,65,0,-65
21095,1,1,10,1213,1203
21096,1,0,68,0,-68
21097,1,1,115,1570,1455
21098,0,0,54,0,-54
21099,1,0,33,0,-33
21100,1,1,374,1457,1083
21101,1,0,2,0,-2
21102,1,1,48,1201,1153
21103,0,0,28,0,-28
21104,1,1,253,1667,1414
21105,1,0,22,0,-22
21106,0,0,49,0,-49
21107,0,0,31,0,-31
21108,1,0,7,0,-7
21109,1,1,705,2113,1408
21110,0,0,138,0,-138
21111,1,1,734,1321,587
21112,1,0,18,0,-18
21113,0,0,36,0,-36
21114,1,1,944,1528,584
21115,1,1,720,1218,498
21116,1,0,11,0,-11
21117,0,0,73,0,-73
21118,0,0,77,0,-77
21119,1,0,194,0,-194
21120,0,0,25,0,-25
21121,1,0,69,0,-69
21122,0,0,8,0,-8
21123,0,0,201,0,-201
21124,1,0,7,0,-7
21125,1,0,26,0,-26
21126,1,1,361,1247,886
21127,0,0,177,0,-177
21128,0,0,26,0,-26
21129,0,0,1,0,-1
21130,0,0,7,0,-7
21131,1,0,20,0,-20
21132,1,0,201,0,-201
21133,1,1,594,1414,820
21134,1,0,5,0,-5
21135,1,0,12,0,-12
21136,1,1,155,1618,1463
21137,1,1,319,1371,1052
21138,0,0,245,0,-245
21139,0,0,59,0,-59
21140,1,0,46,0,-46
21141,1,0,53,0,-53
21142,0,0,79,0,-79
21143,1,1,702,1364,662
21144,1,0,107,0,-107
21145,0,0,30,0,-30
21146,1,0,2,0,-2
21147,1,0,22,0,-22
21148,1,0,78,0,-78
21149,0,0,12,0,-12
21150,1,0,52,0,-52
21151,1,1,392,1357,965
21152,1,0,169,0,-169
21153,1,0,26,0,-26
21154,1,1,961,1329,368
21155,0,0,29,0,-29
21156,1,1,572,1285,713
21157,0,0,17,0,-17
21158,1,1,808,1245,437
21159,1,1,2251,1204,-1047
21160,0,0,1,0,-1
21161,1,1,956,1560,604
21162,1,1,196,1306,1110
21163,0,0,9,0,-9
21164,1,0,10,0,-10
21165,0,0,74,0,-74
21166,0,0,37,0,-37
21167,1,0,4,0,-4
21168,1,1,1166,1596,430
21169,1,0,4,0,-4
21170,0,0,125,0,-125
21171,1,1,392,1406,1014
21172,0,0,93,0,-93
21173,1,1,451,1204,753
21174,1,0,91,0,-91
21175,0,0,224,0,-224
21176,1,0,22,0,-22
21177,1,0,3,0,-3
21178,1,0,78,0,-78
21179,0,0,3,0,-3
21180,1,1,258,1320,1062
21181,1,0,44,0,-44
21182,1,1,22,1450,1428
21183,1,1,626,2540,1914
21184,0,0,21,0,-21
21185,0,0,19,0,-19
21186,0,0,17,0,-17
21187,1,1,213,1389,1176
21188,1,1,204,2246,2042
21189,0,0,130,0,-130
21190,1,1,124,1241,1117
21191,1,1,702,1386,684
21192,1,0,5,0,-5
21193,1,1,345,1548,1203
21194,0,0,30,0,-30
21195,1,0,9,0,-9
21196,1,1,639,1511,872
21197,0,0,13,0,-13
21198,1,0,143,0,-143
21199,1,0,68,0,-68
21200,1,1,247,1503,1256
21201,1,1,208,1407,1199
21202,1,1,892,1432,540
21203,0,0,52,0,-52
21204,1,1,759,1543,784
21205,0,0,135,0,-135
21206,0,0,75,0,-75
21207,1,1,461,1655,1194
21208,0,0,22,0,-22
21209,0,0,4,0,-4
21210,1,0,96,0,-96
21211,0,0,33,0,-33
21212,0,0,193,0,-193
21213,1,1,378,1517,1139
21214,1,1,2253,1518,-735
21215,0,0,5,0,-5
21216,1,1,48,3662,3614
21217,0,0,51,0,-51
21218,0,0,21,0,-21
21219,1,0,19,0,-19
21220,1,1,155,1262,1107
21221,1,0,4,0,-4
21222,1,1,235,1719,1484
21223,0,0,96,0,-96
21224,0,0,37,0,-37
21225,0,0,3,0,-3
21226,1,1,359,2937,2578
21227,0,0,117,0,-117
21228,0,0,18,0,-18
21229,0,0,3,0,-3
21230,0,0,103,0,-103
21231,1,0,88,0,-88
21232,1,1,85,1226,1141
21233,1,0,104,0,-104
21234,1,1,305,2162,1857
21235,1,1,408,1229,821
21236,1,0,25,0,-25
21237,0,0,41,0,-41
21238,1,1,563,1222,659
21239,0,0,11,0,-11
21240,1,0,75,0,-75
21241,1,1,285,1557,1272
21242,0,0,12,0,-12
21243,1,0,13,0,-13
21244,1,1,696,1232,536
21245,0,0,4,0,-4
21246,1,1,860,1416,556
21247,1,0,37,0,-37
21248,1,1,92,1235,1143
21249,1,1,335,1854,1519
21250,1,1,566,1209,643
21251,0,0,1,0,-1
21252,1,1,127,1315,1188
21253,1,0,166,0,-166
21254,1,1,50,1492,1442
21255,1,1,672,3025,2353
21256,0,0,34,0,-34
21257,0,0,87,0,-87
21258,0,0,28,0,-28
21259,1,1,275,1577,1302
21260,1,0,29,0,-29
21261,1,0,118,0,-118
21262,1,0,0,0,0
21263,0,0,35,0,-35
21264,1,0,46,0,-46
21265,1,0,37,0,-37
21266,0,0,2,0,-2
21267,1,1,2385,1320,-1065
21268,1,1,130,1321,1191
21269,0,0,11,0,-11
21270,0,0,83,0,-83
21271,1,1,717,1247,530
21272,1,0,16,0,-16
21273,1,0,42,0,-42
21274,1,1,655,1557,902
21275,1,0,43,0,-43
21276,1,1,4,1327,1323
21277,1,1,179,1604,1425
21278,0,0,5,0,-5
21279,0,0,22,0,-22
21280,1,0,22,0,-22
21281,1,0,76,0,-76
21282,1,0,22,0,-22
21283,0,0,38,0,-38
21284,0,0,76,0,-76
21285,0,0,12,0,-12
21286,1,1,281,1276,995
21287,0,0,35,0,-35
21288,0,0,87,0,-87
21289,0,0,216,0,-216
21290,0,0,25,0,-25
21291,0,0,6,0,-6
21292,0,0,84,0,-84
21293,1,1,408,1528,1120
21294,1,1,241,1814,1573
21295,1,0,32,0,-32
21296,1,0,230,0,-230
21297,1,0,118,0,-118
21298,0,0,49,0,-49
21299,1,0,40,0,-40
21300,1,1,236,1687,1451
21301,1,1,1457,1468,11
21302,0,0,14,0,-14
21303,1,1,933,1229,296
21304,1,1,1025,1214,189
21305,1,0,32,0,-32
21306,1,1,295,1573,1278
21307,0,0,8,0,-8
21308,1,0,25,0,-25
21309,1,1,157,1307,1150
21310,0,0,24,0,-24
21311,0,0,46,0,-46
21312,1,0,10,0,-10
21313,0,0,18,0,-18
21314,1,0,24,0,-24
21315,1,1,416,1789,1373
21316,0,0,101,0,-101
21317,0,0,8,0,-8
21318,0,0,75,0,-75
21319,0,0,6,0,-6
21320,1,0,27,0,-27
21321,0,0,11,0,-11
21322,1,1,687,1532,845
21323,0,0,7,0,-7
21324,0,0,30,0,-30
21325,0,0,45,0,-45
21326,1,1,353,1531,1178
21327,1,0,112,0,-112
21328,1,1,109,1234,1125
21329,1,0,10,0,-10
21330,1,1,1265,1571,306
21331,1,1,1081,1985,904
21332,1,0,4,0,-4
21333,1,0,59,0,-59
21334,1,1,1548,1242,-306
21335,0,0,38,0,-38
21336,0,0,57,0,-57
21337,1,0,66,0,-66
21338,1,0,21,0,-21
21339,1,1,307,1884,1577
21340,1,0,46,0,-46
21341,0,0,7,0,-7
21342,1,1,194,1903,1709
21343,1,0,0,0,0
21344,1,1,131,1379,1248
21345,1,0,5,0,-5
21346,0,0,23,0,-23
21347,1,1,28,1281,1253
21348,1,0,8,0,-8
21349,1,0,54,0,-54
21350,1,0,4,0,-4
21351,0,0,14,0,-14
21352,1,1,724,4630,3906
21353,0,0,31,0,-31
21354,0,0,92,0,-92
21355,0,0,23,0,-23
21356,0,0,14,0,-14
21357,1,1,372,1689,1317
21358,1,1,1183,1448,265
21359,1,1,2453,1213,-1240
21360,1,1,19,1234,1215
21361,0,0,3,0,-3
21362,0,0,53,0,-53
21363,1,0,83,0,-83
21364,1,1,2118,1225,-893
21365,0,0,73,0,-73
21366,0,0,57,0,-57
21367,0,0,47,0,-47
21368,0,0,26,0,-26
21369,0,0,210,0,-210
21370,1,0,76,0,-76
21371,0,0,60,0,-60
21372,1,1,275,1363,1088
21373,0,0,59,0,-59
21374,1,0,23,0,-23
21375,1,1,630,1355,725
21376,0,0,17,0,-17
21377,0,0,85,0,-85
21378,1,0,33,0,-33
21379,1,1,313,1427,1114
21380,0,0,143,0,-143
21381,0,0,46,0,-46
21382,1,0,35,0,-35
21383,0,0,75,0,-75
21384,0,0,80,0,-80
21385,0,0,7,0,-7
21386,1,0,37,0,-37
21387,0,0,203,0,-203
21388,1,0,5,0,-5
21389,1,0,2,0,-2
21390,0,0,1,0,-1
21391,1,0,103,0,-103
21392,1,0,2,0,-2
21393,0,0,27,0,-27
21394,1,0,36,0,-36
21395,1,1,282,2184,1902
21396,1,0,3,0,-3
21397,1,0,0,0,0
21398,0,0,77,0,-77
21399,0,0,58,0,-58
21400,1,0,46,0,-46
21401,1,1,317,1631,1314
21402,1,0,10,0,-10
21403,0,0,30,0,-30
21404,1,1,67,1218,1151
21405,0,0,53,0,-53
21406,1,0,8,0,-8
21407,1,0,2,0,-2
21408,0,0,222,0,-222
21409,0,0,4,0,-4
21410,1,0,69,0,-69
21411,1,0,18,0,-18
21412,1,1,666,2026,1360
21413,1,1,12,1321,1309
21414,1,0,74,0,-74
21415,1,0,66,0,-66
21416,0,0,27,0,-27
21417,0,0,161,0,-161
21418,1,0,1,0,-1
21419,1,1,107,1219,1112
21420,0,0,29,0,-29
21421,1,1,844,1490,646
21422,1,1,65,1244,1179
21423,1,1,120,1428,1308
21424,1,0,147,0,-147
21425,0,0,167,0,-167
21426,1,0,3,0,-3
21427,1,0,9,0,-9
21428,0,0,8,0,-8
21429,0,0,31,0,-31
21430,1,0,22,0,-22
21431,0,0,64,0,-64
21432,1,1,1257,1514,257
21433,0,0,45,0,-45
21434,1,1,103,1321,1218
21435,1,0,133,0,-133
21436,1,0,57,0,-57
21437,0,0,66,0,-66
21438,1,1,355,1228,873
21439,1,0,20,0,-20
21440,0,0,135,0,-135
21441,1,0,32,0,-32
21442,1,0,45,0,-45
21443,1,1,533,1205,672
21444,0,0,6,0,-6
21445,1,0,12,0,-12
21446,1,1,155,1374,1219
21447,1,1,1592,1258,-334
21448,1,0,9,0,-9
21449,0,0,68,0,-68
21450,1,1,243,1419,1176
21451,0,0,2,0,-2
21452,0,0,19,0,-19
21453,0,0,20,0,-20
21454,1,1,118,1346,1228
21455,1,1,384,1842,1458
21456,1,0,37,0,-37
21457,1,0,1,0,-1
21458,1,1,2876,1612,-1264
21459,0,0,2,0,-2
21460,1,1,590,1356,766
21461,0,0,7,0,-7
21462,1,0,87,0,-87
21463,1,1,108,1376,1268
21464,1,1,130,1461,1331
21465,1,0,83,0,-83
21466,1,1,276,1270,994
21467,1,0,18,0,-18
21468,0,0,37,0,-37
21469,0,0,13,0,-13
21470,0,0,21,0,-21
21471,1,0,3,0,-3
21472,1,1,885,1348,463
21473,1,1,36,1348,1312
21474,1,1,1361,1312,-49
21475,0,0,7,0,-7
21476,1,0,12,0,-12
21477,1,1,487,1415,928
21478,0,0,30,0,-30
21479,1,0,49,0,-49
21480,1,0,16,0,-16
21481,0,0,70,0,-70
21482,0,0,25,0,-25
21483,1,1,1858,1240,-618
21484,1,1,162,1298,1136
21485,1,1,279,1270,991
21486,1,1,1136,1294,158
21487,0,0,0,0,0
21488,1,1,773,1372,599
21489,1,1,268,2121,1853
21490,1,1,402,1388,986
21491,0,0,1,0,-1
21492,0,0,40,0,-40
21493,1,0,2,0,-2
21494,1,1,308,2009,1701
21495,1,0,12,0,-12
21496,1,0,23,0,-23
21497,1,0,146,0,-146
21498,1,0,5,0,-5
21499,0,0,29,0,-29
21500,1,1,208,1292,1084
21501,0,0,11,0,-11
21502,1,0,24,0,-24
21503,1,1,2534,1222,-1312
21504,1,0,9,0,-9
21505,1,0,2,0,-2
21506,1,0,20,0,-20
21507,1,1,898,1537,639
21508,0,0,75,0,-75
21509,1,1,972,1302,330
21510,1,0,10,0,-10
21511,1,1,77,1239,1162
21512,1,0,57,0,-57
21513,1,1,862,1206,344
21514,0,0,61,0,-61
21515,0,0,14,0,-14
21516,1,0,51,0,-51
21517,0,0,18,0,-18
21518,1,0,119,0,-119
21519,1,1,1765,1979,214
21520,1,0,22,0,-22
21521,0,0,1,0,-1
21522,0,0,24,0,-24
21523,0,0,1,0,-1
21524,1,0,37,0,-37
21525,0,0,15,0,-15
21526,1,0,30,0,-30
21527,1,1,193,1501,1308
21528,1,0,92,0,-92
21529,0,0,16,0,-16
21530,0,0,37,0,-37
21531,0,0,14,0,-14
21532,0,0,15,0,-15
21533,0,0,39,0,-39
21534,0,0,4,0,-4
21535,1,0,27,0,-27
21536,1,0,108,0,-108
21537,1,0,32,0,-32
21538,0,0,25,0,-25
21539,0,0,16,0,-16
21540,1,0,16,0,-16
21541,0,0,56,0,-56
21542,0,0,64,0,-64
21543,1,0,52,0,-52
21544,1,0,17,0,-17
21545,1,1,107,1596,1489
21546,1,1,814,1686,872
21547,0,0,66,0,-66
21548,1,1,258,1218,960
21549,1,0,35,0,-35
21550,0,0,87,0,-87
21551,1,1,231,1924,1693
21552,0,0,33,0,-33
21553,0,0,86,0,-86
21554,0,0,30,0,-30
21555,1,1,60,1323,1263
21556,0,0,1,0,-1
21557,1,1,839,1319,480
21558,0,0,64,0,-64
21559,1,0,15,0,-15
21560,1,0,7,0,-7
21561,0,0,25,0,-25
21562,0,0,67,0,-67
21563,1,1,65,1720,1655
21564,1,0,31,0,-31
21565,1,1,2353,1442,-911
21566,0,0,36,0,-36
21567,0,0,17,0,-17
21568,0,0,55,0,-55
21569,0,0,22,0,-22
21570,0,0,3,0,-3
21571,1,0,177,0,-177
21572,0,0,8,0,-8
21573,0,0,109,0,-109
21574,0,0,8,0,-8
21575,0,0,88,0,-88
21576,0,0,25,0,-25
21577,1,0,9,0,-9
21578,0,0,7,0,-7
21579,1,0,34,0,-34
21580,1,1,118,1666,1548
21581,0,0,15,0,-15
21582,1,1,66,1202,1136
21583,1,1,474,1625,1151
21584,0,0,15,0,-15
21585,0,0,54,0,-54
21586,1,1,494,1825,1331
21587,1,1,218,1717,1499
21588,1,1,124,1289,1165
21589,0,0,30,0,-30
21590,1,1,169,1219,1050
21591,0,0,34,0,-34
21592,1,1,259,1732,1473
21593,0,0,49,0,-49
21594,0,0,42,0,-42
21595,1,1,136,2469,2333
21596,0,0,43,0,-43
21597,1,1,564,1239,675
21598,1,0,28,0,-28
21599,1,1,38,1314,1276
21600,0,0,99,0,-99
21601,0,0,13,0,-13
21602,1,1,90,1386,1296
21603,0,0,2,0,-2
21604,0,0,45,0,-45
21605,1,1,1328,2563,1235
21606,0,0,10,0,-10
21607,0,0,20,0,-20
21608,0,0,30,0,-30
21609,1,1,500,1241,741
21610,1,0,42,0,-42
21611,0,0,97,0,-97
21612,0,0,46,0,-46
21613,0,0,42,0,-42
21614,1,1,247,1440,1193
21615,0,0,12,0,-12
21616,1,0,52,0,-52
21617,1,0,43,0,-43
21618,1,1,777,1372,595
21619,0,0,57,0,-57
21620,1,0,147,0,-147
21621,0,0,25,0,-25
21622,1,1,176,1347,1171
21623,0,0,82,0,-82
21624,0,0,7,0,-7
21625,1,0,111,0,-111
21626,1,0,28,0,-28
21627,0,0,26,0,-26
21628,0,0,102,0,-102
21629,1,1,480,1306,826
21630,0,0,28,0,-28
21631,0,0,77,0,-77
21632,1,0,44,0,-44
21633,1,1,270,2030,1760
21634,0,0,19,0,-19
21635,1,0,2,0,-2
21636,1,0,68,0,-68
21637,0,0,9,0,-9
21638,1,1,1106,1249,143
21639,1,1,42,1390,1348
21640,1,0,20,0,-20
21641,1,1,276,1450,1174
21642,0,0,43,0,-43
21643,0,0,11,0,-11
21644,0,0,55,0,-55
21645,1,0,64,0,-64
21646,1,1,36,1325,1289
21647,1,1,363,1275,912
21648,1,1,52,1226,1174
21649,1,1,1640,1910,270
21650,1,1,997,1382,385
21651,1,0,19,0,-19
21652,0,0,32,0,-32
21653,0,0,79,0,-79
21654,1,0,10,0,-10
21655,0,0,60,0,-60
21656,1,0,149,0,-149
21657,1,0,33,0,-33
21658,0,0,87,0,-87
21659,1,1,240,1320,1080
21660,1,1,813,4145,3332
21661,1,1,303,1206,903
21662,0,0,3,0,-3
21663,0,0,4,0,-4
21664,1,1,159,1308,1149
21665,0,0,32,0,-32
21666,0,0,100,0,-100
21667,1,1,1241,1388,147
21668,0,0,57,0,-57
21669,0,0,105,0,-105
21670,1,1,109,2853,2744
21671,1,0,30,0,-30
21672,1,0,3,0,-3
21673,1,1,2824,1487,-1337
21674,0,0,88,0,-88
21675,1,0,41,0,-41
21676,1,1,313,1611,1298
21677,1,1,2020,1317,-703
21678,1,1,202,2194,1992
21679,0,0,100,0,-100
21680,0,0,5,0,-5
21681,0,0,26,0,-26
21682,1,0,23,0,-23
21683,1,1,48,1207,1159
21684,0,0,40,0,-40
21685,1,0,120,0,-120
21686,1,1,376,1829,1453
21687,1,0,11,0,-11
21688,1,1,476,2127,1651
21689,1,1,431,2377,1946
21690,0,0,12,0,-12
21691,1,1,1964,1251,-713
21692,1,1,145,1618,1473
21693,1,1,317,1352,1035
21694,0,0,33,0,-33
21695,0,0,48,0,-48
21696,1,1,280,1213,933
21697,1,0,76,0,-76
21698,1,1,365,1371,1006
21699,1,1,84,1295,1211
21700,0,0,0,0,0
21701,1,0,24,0,-24
21702,1,1,533,1209,676
21703,0,0,19,0,-19
21704,1,1,619,1214,595
21705,0,0,15,0,-15
21706,1,0,19,0,-19
21707,1,1,1319,1408,89
21708,1,0,9,0,-9
21709,1,0,24,0,-24
21710,1,0,26,0,-26
21711,1,0,9,0,-9
21712,0,0,52,0,-52
21713,1,1,693,1612,919
21714,0,0,132,0,-132
21715,0,0,7,0,-7
21716,0,0,142,0,-142
21717,0,0,36,0,-36
21718,1,0,75,0,-75
21719,1,1,206,1435,1229
21720,0,0,16,0,-16
21721,1,1,369,1916,1547
21722,0,0,11,0,-11
21723,1,0,38,0,-38
21724,1,0,38,0,-38
21725,0,0,66,0,-66
21726,1,1,304,1564,1260
21727,1,0,1,0,-1
21728,1,1,270,2820,2550
21729,0,0,32,0,-32
21730,0,0,0,0,0
21731,1,0,131,0,-131
21732,0,0,54,0,-54
21733,0,0,61,0,-61
21734,0,0,52,0,-52
21735,1,0,35,0,-35
21736,1,1,1528,1239,-289
21737,0,0,57,0,-57
21738,0,0,16,0,-16
21739,1,1,486,2036,1550
21740,1,1,92,1520,1428
21741,1,0,182,0,-182
21742,1,0,111,0,-111
21743,1,0,25,0,-25
21744,1,0,0,0,0
21745,1,0,15,0,-15
21746,1,0,105,0,-105
21747,1,1,20,1385,1365
21748,1,1,212,1537,1325
21749,1,1,1109,1450,341
21750,1,0,107,0,-107
21751,0,0,3,0,-3
21752,1,0,40,0,-40
21753,1,0,14,0,-14
21754,0,0,23,0,-23
21755,1,0,99,0,-99
21756,0,0,67,0,-67
21757,1,0,46,0,-46
21758,0,0,20,0,-20
21759,1,1,183,1208,1025
21760,1,0,33,0,-33
21761,1,0,92,0,-92
21762,1,0,96,0,-96
21763,0,0,43,0,-43
21764,1,0,28,0,-28
21765,0,0,9,0,-9
21766,1,0,95,0,-95
21767,0,0,127,0,-127
21768,0,0,28,0,-28
21769,1,0,22,0,-22
21770,1,1,109,1376,1267
21771,0,0,1,0,-1
21772,1,1,609,1375,766
21773,0,0,50,0,-50
21774,1,1,690,1277,587
21775,1,0,56,0,-56
21776,1,1,935,1218,283
21777,1,1,1438,2253,815
21778,0,0,33,0,-33
21779,1,0,0,0,0
21780,1,0,27,0,-27
21781,1,0,102,0,-102
21782,1,1,410,2924,2514
21783,1,1,457,1627,1170
21784,1,0,1,0,-1
21785,1,1,271,2383,2112
21786,1,1,430,1432,1002
21787,0,0,6,0,-6
21788,0,0,5,0,-5
21789,1,1,757,2412,1655
21790,1,1,871,1495,624
21791,1,0,20,0,-20
21792,1,0,152,0,-152
21793,1,1,1723,1571,-152
21794,1,1,251,1359,1108
21795,1,1,195,1628,1433
21796,1,0,36,0,-36
21797,1,0,41,0,-41
21798,1,1,955,1595,640
21799,1,0,127,0,-127
21800,1,0,47,0,-47
21801,1,1,339,1353,1014
21802,1,1,1193,3037,1844
21803,0,0,16,0,-16
21804,0,0,104,0,-104
21805,1,1,83,1253,1170
21806,1,1,247,1451,1204
21807,0,0,8,0,-8
21808,1,1,449,2159,1710
21809,0,0,89,0,-89
21810,1,1,1055,1860,805
21811,1,0,196,0,-196
21812,1,1,83,1622,1539
21813,0,0,3,0,-3
21814,1,1,766,1325,559
21815,1,1,273,1265,992
21816,1,1,112,1686,1574
21817,0,0,19,0,-19
21818,1,1,257,1745,1488
21819,1,0,33,0,-33
21820,1,0,14,0,-14
21821,1,0,85,0,-85
21822,1,1,188,1623,1435
21823,0,0,8,0,-8
21824,0,0,69,0,-69
21825,1,0,26,0,-26
21826,1,0,113,0,-113
21827,1,0,63,0,-63
21828,1,1,392,1903,1511
21829,0,0,1,0,-1
21830,1,1,162,1204,1042
21831,1,1,132,3062,2930
21832,0,0,46,0,-46
21833,0,0,46,0,-46
21834,1,0,48,0,-48
21835,0,0,64,0,-64
21836,1,1,892,1310,418
21837,1,1,1243,2002,759
21838,0,0,95,0,-95
21839,1,0,43,0,-43
21840,0,0,67,0,-67
21841,0,0,109,0,-109
21842,1,1,588,1314,726
21843,1,0,27,0,-27
21844,1,0,88,0,-88
21845,0,0,16,0,-16
21846,0,0,5,0,-5
21847,0,0,77,0,-77
21848,1,0,2,0,-2
21849,1,0,5,0,-5
21850,1,1,150,1322,1172
21851,1,1,288,1972,1684
21852,1,0,42,0,-42
21853,1,0,33,0,-33
21854,1,0,119,0,-119
21855,1,0,78,0,-78
21856,1,0,11,0,-11
21857,0,0,4,0,-4
21858,1,0,3,0,-3
21859,0,0,15,0,-15
21860,1,1,505,1232,727
21861,0,0,65,0,-65
21862,1,1,1972,1670,-302
21863,0,0,66,0,-66
21864,1,1,738,1263,525
21865,1,1,573,1248,675
21866,1,1,200,1488,1288
21867,0,0,29,0,-29
21868,1,0,8,0,-8
21869,0,0,84,0,-84
21870,1,0,12,0,-12
21871,1,1,506,1219,713
21872,1,1,210,1247,1037
21873,1,1,92,1515,1423
21874,1,1,180,1536,1356
21875,0,0,27,0,-27
21876,1,0,17,0,-17
21877,0,0,163,0,-163
21878,1,1,92,1277,1185
21879,1,0,85,0,-85
21880,1,0,108,0,-108
21881,1,1,43,1481,1438
21882,1,1,191,1233,1042
21883,1,1,156,1315,1159
21884,0,0,26,0,-26
21885,1,1,1221,1414,193
21886,0,0,9,0,-9
21887,0,0,237,0,-237
21888,1,1,2143,1686,-457
21889,0,0,22,0,-22
21890,1,1,156,1786,1630
21891,0,0,17,0,-17
21892,0,0,34,0,-34
21893,0,0,70,0,-70
21894,0,0,11,0,-11
21895,1,1,291,1230,939
21896,1,0,83,0,-83
21897,1,0,3,0,-3
21898,0,0,37,0,-37
21899,1,0,47,0,-47
21900,1,1,796,1364,568
21901,1,0,77,0,-77
21902,1,0,33,0,-33
21903,1,0,32,0,-32
21904,1,1,171,1646,1475
21905,0,0,38,0,-38
21906,1,1,353,1307,954
21907,1,1,539,1206,667
21908,1,1,505,1559,1054
21909,1,0,91,0,-91
21910,0,0,50,0,-50
21911,1,0,42,0,-42
21912,0,0,84,0,-84
21913,1,1,384,1270,886
21914,1,0,13,0,-13
21915,1,0,135,0,-135
21916,1,1,1099,1260,161
21917,1,1,389,1359,970
21918,0,0,49,0,-49
21919,1,1,558,1459,901
21920,0,0,27,0,-27
21921,0,0,58,0,-58
21922,0,0,43,0,-43
21923,1,0,18,0,-18
21924,1,1,191,1496,1305
21925,1,0,62,0,-62
21926,1,0,67,0,-67
21927,1,1,572,1553,981
21928,1,1,746,1603,857
21929,0,0,3,0,-3
21930,1,0,46,0,-46
21931,1,1,124,1750,1626
21932,1,0,64,0,-64
21933,0,0,8,0,-8
21934,1,1,486,1712,1226
21935,0,0,3,0,-3
21936,0,0,19,0,-19
21937,1,1,798,1241,443
21938,0,0,37,0,-37
21939,0,0,15,0,-15
21940,0,0,34,0,-34
21941,0,0,105,0,-105
21942,0,0,11,0,-11
21943,1,1,445,1823,1378
21944,1,0,2,0,-2
21945,0,0,97,0,-97
21946,1,0,6,0,-6
21947,1,0,60,0,-60
21948,1,0,79,0,-79
21949,1,1,1185,1263,78
21950,0,0,111,0,-111
21951,1,0,216,0,-216
21952,1,1,355,1297,942
21953,0,0,32,0,-32
21954,0,0,4,0,-4
21955,1,1,1141,1549,408
21956,1,1,191,1686,1495
21957,1,1,706,1842,1136
21958,1,0,11,0,-11
21959,0,0,12,0,-12
21960,0,0,27,0,-27
21961,1,0,16,0,-16
21962,0,0,52,0,-52
21963,1,1,28,1272,1244
21964,1,1,899,1291,392
21965,0,0,35,0,-35
21966,0,0,22,0,-22
21967,0,0,22,0,-22
21968,1,0,29,0,-29
21969,1,0,71,0,-71
21970,0,0,28,0,-28
21971,1,1,402,2011,1609
21972,0,0,14,0,-14
21973,1,1,772,1235,463
21974,1,0,3,0,-3
21975,0,0,0,0,0
21976,0,0,42,0,-42
21977,1,1,665,1254,589
21978,0,0,72,0,-72
21979,1,1,27,1711,1684
21980,1,1,61,1485,1424
21981,1,0,100,0,-100
21982,0,0,61,0,-61
21983,1,0,72,0,-72
21984,1,1,1003,1582,579
21985,0,0,57,0,-57
21986,0,0,30,0,-30
21987,1,0,24,0,-24
21988,0,0,1,0,-1
21989,1,1,240,1432,1192
21990,1,0,28,0,-28
21991,0,0,8,0,-8
21992,1,0,15,0,-15
21993,0,0,21,0,-21
21994,1,0,94,0,-94
21995,0,0,2,0,-2
21996,1,0,26,0,-26
21997,0,0,132,0,-132
21998,1,0,20,0,-20
21999,0,0,0,0,0
22000,1,1,808,1738,930
22001,0,0,0,0,0
22002,1,1,93,1288,1195
22003,0,0,0,0,0
22004,1,0,1,0,-1
22005,1,1,71,1295,1224
22006,1,1,197,1203,1006
22007,1,1,204,1336,1132
22008,1,1,64,1414,1350
22009,1,1,1119,1310,191
22010,0,0,47,0,-47
22011,1,0,31,0,-31
22012,1,1,69,1719,1650
22013,0,0,13,0,-13
22014,0,0,28,0,-28
22015,0,0,29,0,-29
22016,1,0,16,0,-16
22017,0,0,55,0,-55
22018,0,0,58,0,-58
22019,1,0,12,0,-12
22020,1,1,213,1516,1303
22021,1,1,218,1668,1450
22022,0,0,1,0,-1
22023,1,0,77,0,-77
22024,1,0,110,0,-110
22025,0,0,14,0,-14
22026,1,0,21,0,-21
22027,0,0,55,0,-55
22028,0,0,25,0,-25
22029,1,0,51,0,-51
22030,1,1,597,1743,1146
22031,0,0,32,0,-32
22032,0,0,13,0,-13
22033,0,0,107,0,-107
22034,1,1,329,1550,1221
22035,1,1,111,1299,1188
22036,1,1,161,1225,1064
22037,0,0,7,0,-7
22038,0,0,2,0,-2
22039,1,1,112,2112,2000
22040,0,0,10,0,-10
22041,1,1,414,1475,1061
22042,1,1,76,1203,1127
22043,1,1,667,1428,761
22044,0,0,151,0,-151
22045,1,0,21,0,-21
22046,1,0,2,0,-2
22047,1,0,25,0,-25
22048,1,0,106,0,-106
22049,1,0,51,0,-51
22050,1,0,111,0,-111
22051,1,1,609,1294,685
22052,1,0,15,0,-15
22053,1,0,3,0,-3
22054,1,1,2556,1774,-782
22055,0,0,79,0,-79
22056,1,0,4,0,-4
22057,0,0,2,0,-2
22058,0,0,157,0,-157
22059,1,1,93,1288,1195
22060,1,1,582,1370,788
22061,0,0,3,0,-3
22062,1,1,82,1230,1148
22063,1,0,15,0,-15
22064,1,0,11,0,-11
22065,1,1,266,2280,2014
22066,0,0,5,0,-5
22067,1,1,370,1623,1253
22068,1,1,432,1339,907
22069,1,0,6,0,-6
22070,1,0,57,0,-57
22071,1,1,471,1203,732
22072,1,1,98,1351,1253
22073,0,0,3,0,-3
22074,1,1,200,1326,1126
22075,1,0,73,0,-73
22076,1,1,842,1241,399
22077,0,0,104,0,-104
22078,0,0,18,0,-18
22079,0,0,0,0,0
22080,0,0,21,0,-21
22081,1,0,29,0,-29
22082,0,0,12,0,-12
22083,1,0,13,0,-13
22084,1,1,46,1901,1855
22085,1,1,902,2707,1805
22086,1,0,46,0,-46
22087,0,0,124,0,-124
22088,0,0,17,0,-17
22089,0,0,139,0,-139
22090,0,0,36,0,-36
22091,0,0,83,0,-83
22092,0,0,2,0,-2
22093,1,1,326,2283,1957
22094,0,0,202,0,-202
22095,0,0,13,0,-13
22096,0,0,28,0,-28
22097,1,1,466,1847,1381
22098,0,0,58,0,-58
22099,0,0,27,0,-27
22100,0,0,61,0,-61
22101,0,0,65,0,-65
22102,1,0,0,0,0
22103,1,1,1342,2320,978
22104,0,0,51,0,-51
22105,0,0,221,0,-221
22106,1,0,6,0,-6
22107,0,0,73,0,-73
22108,1,0,14,0,-14
22109,1,1,430,2033,1603
22110,1,1,91,1374,1283
22111,0,0,49,0,-49
22112,0,0,13,0,-13
22113,0,0,37,0,-37
22114,1,0,51,0,-51
22115,1,0,17,0,-17
22116,1,1,346,1867,1521
22117,1,1,612,1234,622
22118,0,0,6,0,-6
22119,1,1,215,1572,1357
22120,1,1,1388,1247,-141
22121,1,1,203,1563,1360
22122,0,0,17,0,-17
22123,0,0,75,0,-75
22124,0,0,37,0,-37
22125,1,1,205,1200,995
22126,1,0,4,0,-4
22127,1,0,59,0,-59
22128,1,1,3289,1732,-1557
22129,1,1,778,1261,483
22130,0,0,35,0,-35
22131,1,0,118,0,-118
22132,0,0,108,0,-108
22133,0,0,72,0,-72
22134,1,1,159,1272,1113
22135,1,0,0,0,0
22136,1,0,6,0,-6
22137,0,0,19,0,-19
22138,1,0,6,0,-6
22139,1,0,67,0,-67
22140,1,1,228,1794,1566
22141,1,1,429,1248,819
22142,1,1,373,1433,1060
22143,1,1,551,1242,691
22144,0,0,13,0,-13
22145,1,0,23,0,-23
22146,0,0,148,0,-148
22147,1,1,468,1355,887
22148,1,0,112,0,-112
22149,1,1,522,1661,1139
22150,1,1,236,1350,1114
22151,1,0,3,0,-3
22152,1,1,98,1855,1757
22153,0,0,5,0,-5
22154,1,0,58,0,-58
22155,0,0,154,0,-154
22156,0,0,47,0,-47
22157,1,1,480,1263,783
22158,1,1,233,1504,1271
22159,1,1,100,1488,1388
22160,0,0,38,0,-38
22161,1,0,47,0,-47
22162,1,1,260,1349,1089
22163,1,1,108,1270,1162
22164,0,0,80,0,-80
22165,1,1,498,1587,1089
22166,0,0,30,0,-30
22167,1,1,158,1417,1259
22168,1,1,588,4638,4050
22169,1,1,56,1765,1709
22170,1,0,17,0,-17
22171,1,0,157,0,-157
22172,0,0,24,0,-24
22173,1,1,2244,1476,-768
22174,0,0,12,0,-12
22175,1,1,9,1634,1625
22176,1,0,41,0,-41
22177,0,0,111,0,-111
22178,1,1,647,1453,806
22179,0,0,129,0,-129
22180,1,0,35,0,-35
22181,0,0,2,0,-2
22182,0,0,44,0,-44
22183,1,0,2,0,-2
22184,0,0,47,0,-47
22185,1,0,121,0,-121
22186,1,1,657,1503,846
22187,1,0,150,0,-150
22188,1,1,673,1646,973
22189,1,0,14,0,-14
22190,1,1,80,2124,2044
22191,0,0,17,0,-17
22192,0,0,113,0,-113
22193,1,0,1,0,-1
22194,1,0,27,0,-27
22195,0,0,52,0,-52
22196,1,1,95,1515,1420
22197,0,0,36,0,-36
22198,0,0,118,0,-118
22199,0,0,249,0,-249
22200,1,0,49,0,-49
22201,1,1,159,1205,1046
22202,1,1,38,1588,1550
22203,0,0,148,0,-148
22204,1,0,16,0,-16
22205,0,0,53,0,-53
22206,1,1,342,1484,1142
22207,0,0,24,0,-24
22208,1,1,377,1472,1095
22209,1,1,77,1236,1159
22210,1,1,66,1418,1352
22211,0,0,20,0,-20
22212,1,1,484,1295,811
22213,0,0,0,0,0
22214,0,0,56,0,-56
22215,1,1,210,1858,1648
22216,1,0,7,0,-7
22217,1,0,3,0,-3
22218,0,0,4,0,-4
22219,1,1,212,1346,1134
22220,0,0,5,0,-5
22221,1,0,7,0,-7
22222,1,0,86,0,-86
22223,1,0,59,0,-59
22224,0,0,35,0,-35
22225,0,0,52,0,-52
22226,1,1,895,1490,595
22227,0,0,70,0,-70
22228,1,1,934,1359,425
22229,0,0,9,0,-9
22230,1,1,468,1236,768
22231,0,0,45,0,-45
22232,1,0,44,0,-44
22233,1,0,39,0,-39
22234,1,0,101,0,-101
22235,1,0,2,0,-2
22236,1,0,31,0,-31
22237,1,1,183,1302,1119
22238,0,0,32,0,-32
22239,0,0,1,0,-1
22240,1,1,555,1437,882
22241,1,1,158,1296,1138
22242,1,0,30,0,-30
22243,1,0,142,0,-142
22244,0,0,37,0,-37
22245,1,1,1221,1494,273
22246,1,0,36,0,-36
22247,1,1,494,1532,1038
22248,0,0,2,0,-2
22249,1,0,58,0,-58
22250,0,0,9,0,-9
22251,1,0,25,0,-25
22252,1,0,34,0,-34
22253,1,0,161,0,-161
22254,1,0,25,0,-25
22255,0,0,20,0,-20
22256,0,0,167,0,-167
22257,0,0,10,0,-10
22258,1,0,59,0,-59
22259,0,0,49,0,-49
22260,1,0,72,0,-72
22261,0,0,49,0,-49
22262,1,0,23,0,-23
22263,1,1,203,2098,1895
22264,0,0,92,0,-92
22265,0,0,21,0,-21
22266,0,0,114,0,-114
22267,0,0,37,0,-37
22268,1,1,64,1346,1282
22269,0,0,18,0,-18
22270,1,0,61,0,-61
22271,1,1,240,1311,1071
22272,1,1,544,1570,1026
22273,1,0,152,0,-152
22274,1,1,173,1418,1245
22275,1,0,96,0,-96
22276,1,1,155,1423,1268
22277,1,1,175,1282,1107
22278,0,0,21,0,-21
22279,1,0,30,0,-30
22280,0,0,41,0,-41
22281,0,0,44,0,-44
22282,1,0,189,0,-189
22283,0,0,47,0,-47
22284,0,0,2,0,-2
22285,0,0,10,0,-10
22286,1,0,18,0,-18
22287,1,1,1480,1292,-188
22288,1,0,18,0,-18
22289,1,1,424,1315,891
22290,0,0,45,0,-45
22291,1,0,48,0,-48
22292,0,0,20,0,-20
22293,0,0,87,0,-87
22294,1,1,541,1679,1138
22295,1,0,0,0,0
22296,1,1,485,1211,726
22297,1,1,231,1599,1368
22298,1,0,30,0,-30
22299,0,0,8,0,-8
22300,0,0,164,0,-164
22301,1,0,20,0,-20
22302,0,0,22,0,-22
22303,1,0,39,0,-39
22304,1,1,374,2456,2082
22305,0,0,60,0,-60
22306,1,1,928,1975,1047
22307,1,1,504,1421,917
22308,0,0,26,0,-26
22309,1,0,148,0,-148
22310,1,0,17,0,-17
22311,1,1,342,1396,1054
22312,1,1,393,1383,990
22313,1,1,102,1735,1633
22314,1,0,26,0,-26
22315,1,1,1691,1441,-250
22316,1,1,207,1211,1004
22317,1,0,6,0,-6
22318,1,1,59,1478,1419
22319,1,1,278,1204,926
22320,1,1,123,1524,1401
22321,0,0,74,0,-74
22322,1,1,422,1566,1144
22323,0,0,43,0,-43
22324,0,0,35,0,-35
22325,0,0,102,0,-102
22326,0,0,25,0,-25
22327,1,0,43,0,-43
22328,0,0,45,0,-45
22329,1,0,50,0,-50
22330,0,0,38,0,-38
22331,1,1,1062,1353,291
22332,1,1,1398,1318,-80
22333,1,1,177,1518,1341
22334,1,0,65,0,-65
22335,1,0,8,0,-8
22336,0,0,19,0,-19
22337,1,0,23,0,-23
22338,1,0,2,0,-2
22339,1,1,49,1446,1397
22340,1,1,790,2234,1444
22341,1,1,515,1474,959
22342,0,0,7,0,-7
22343,0,0,15,0,-15
22344,1,1,852,1845,993
22345,1,0,49,0,-49
22346,0,0,21,0,-21
22347,1,0,60,0,-60
22348,1,1,1780,1208,-572
22349,0,0,30,0,-30
22350,1,1,57,2481,2424
22351,1,1,742,1479,737
22352,0,0,27,0,-27
22353,1,0,30,0,-30
22354,0,0,30,0,-30
22355,1,0,26,0,-26
22356,0,0,7,0,-7
22357,1,1,832,1361,529
22358,0,0,81,0,-81
22359,0,0,5,0,-5
22360,1,1,1446,1213,-233
22361,1,0,56,0,-56
22362,0,0,14,0,-14
22363,0,0,69,0,-69
22364,1,0,24,0,-24
22365,1,0,51,0,-51
22366,1,1,231,1703,1472
22367,1,0,66,0,-66
22368,1,1,518,1554,1036
22369,1,0,21,0,-21
22370,0,0,79,0,-79
22371,1,1,1197,1821,624
22372,1,0,172,0,-172
22373,0,0,91,0,-91
22374,0,0,120,0,-120
22375,0,0,17,0,-17
22376,0,0,63,0,-63
22377,1,1,692,1450,758
22378,1,1,349,1213,864
22379,0,0,18,0,-18
22380,1,1,311,1253,942
22381,0,0,25,0,-25
22382,0,0,10,0,-10
22383,1,0,60,0,-60
22384,1,0,155,0,-155
22385,1,0,24,0,-24
22386,0,0,164,0,-164
22387,0,0,44,0,-44
22388,1,1,792,1509,717
22389,1,0,3,0,-3
22390,1,1,237,1237,1000
22391,0,0,112,0,-112
22392,1,0,1,0,-1
22393,1,1,2300,1230,-1070
22394,1,1,212,1303,1091
22395,1,0,124,0,-124
22396,1,0,1,0,-1
22397,1,0,89,0,-89
22398,0,0,88,0,-88
22399,1,0,15,0,-15
22400,0,0,18,0,-18
22401,0,0,57,0,-57
22402,1,1,469,1273,804
22403,1,0,23,0,-23
22404,0,0,29,0,-29
22405,0,0,25,0,-25
22406,1,0,22,0,-22
22407,1,1,207,1626,1419
22408,1,0,28,0,-28
22409,1,1,484,1209,725
22410,0,0,97,0,-97
22411,0,0,58,0,-58
22412,1,0,33,0,-33
22413,0,0,184,0,-184
22414,1,0,110,0,-110
22415,0,0,110,0,-110
22416,1,0,0,0,0
22417,0,0,56,0,-56
22418,1,0,5,0,-5
22419,0,0,241,0,-241
22420,1,1,366,1459,1093
22421,0,0,79,0,-79
22422,1,1,875,1321,446
22423,0,0,16,0,-16
22424,0,0,42,0,-42
22425,1,0,18,0,-18
22426,0,0,33,0,-33
22427,1,1,1241,1548,307
22428,0,0,27,0,-27
22429,1,0,260,0,-260
22430,0,0,9,0,-9
22431,1,0,173,0,-173
22432,1,1,466,1293,827
22433,1,1,56,2426,2370
22434,0,0,14,0,-14
22435,1,1,432,1556,1124
22436,0,0,68,0,-68
22437,1,1,959,1536,577
22438,1,0,88,0,-88
22439,0,0,28,0,-28
22440,0,0,50,0,-50
22441,0,0,17,0,-17
22442,1,0,54,0,-54
22443,0,0,50,0,-50
22444,0,0,32,0,-32
22445,0,0,138,0,-138
22446,1,0,10,0,-10
22447,1,1,533,1440,907
22448,1,0,11,0,-11
22449,1,0,6,0,-6
22450,0,0,20,0,-20
22451,1,0,86,0,-86
22452,0,0,81,0,-81
22453,1,0,123,0,-123
22454,0,0,34,0,-34
22455,1,1,589,1556,967
22456,0,0,54,0,-54
22457,1,1,772,1241,469
22458,0,0,46,0,-46
22459,1,1,24,1710,1686
22460,1,0,2,0,-2
22461,1,0,155,0,-155
22462,1,1,216,1411,1195
22463,1,1,233,1221,988
22464,0,0,88,0,-88
22465,0,0,74,0,-74
22466,0,0,33,0,-33
22467,0,0,134,0,-134
22468,1,0,233,0,-233
22469,1,1,784,1340,556
22470,1,1,356,1303,947
22471,1,1,876,1362,486
22472,1,0,7,0,-7
22473,1,0,15,0,-15
22474,1,0,115,0,-115
22475,1,1,378,1275,897
22476,1,0,25,0,-25
22477,1,1,754,2632,1878
22478,0,0,61,0,-61
22479,1,1,47,2228,2181
22480,1,0,35,0,-35
22481,0,0,44,0,-44
22482,0,0,10,0,-10
22483,1,0,33,0,-33
22484,0,0,65,0,-65
22485,1,0,46,0,-46
22486,1,1,145,1932,1787
22487,0,0,21,0,-21
22488,0,0,24,0,-24
22489,1,1,965,1790,825
22490,0,0,14,0,-14
22491,0,0,117,0,-117
22492,0,0,23,0,-23
22493,1,1,568,1206,638
22494,0,0,5,0,-5
22495,0,0,31,0,-31
22496,1,1,125,1440,1315
22497,1,1,222,2419,2197
22498,1,1,2353,1333,-1020
22499,1,1,431,1794,1363
22500,0,0,75,0,-75
22501,0,0,7,0,-7
22502,1,1,103,1728,1625
22503,1,0,29,0,-29
22504,1,1,1108,1614,506
22505,1,0,85,0,-85
22506,1,0,12,0,-12
22507,0,0,302,0,-302
22508,1,0,24,0,-24
22509,0,0,84,0,-84
22510,0,0,81,0,-81
22511,0,0,27,0,-27
22512,1,0,71,0,-71
22513,1,1,598,1208,610
22514,0,0,22,0,-22
22515,0,0,52,0,-52
22516,1,1,79,1433,1354
22517,1,0,18,0,-18
22518,1,1,135,1533,1398
22519,0,0,29,0,-29
22520,0,0,132,0,-132
22521,0,0,93,0,-93
22522,0,0,95,0,-95
22523,1,1,281,1382,1101
22524,0,0,25,0,-25
22525,1,0,40,0,-40
22526,0,0,16,0,-16
22527,1,0,17,0,-17
22528,0,0,7,0,-7
22529,1,1,534,1353,819
22530,0,0,124,0,-124
22531,1,0,55,0,-55
22532,1,1,1241,1453,212
22533,0,0,12,0,-12
22534,0,0,22,0,-22
22535,1,0,20,0,-20
22536,1,1,833,1242,409
22537,1,0,35,0,-35
22538,0,0,39,0,-39
22539,0,0,62,0,-62
22540,0,0,117,0,-117
22541,1,0,40,0,-40
22542,0,0,29,0,-29
22543,1,1,108,1314,1206
22544,0,0,17,0,-17
22545,0,0,75,0,-75
22546,1,1,187,1585,1398
22547,1,0,96,0,-96
22548,1,1,102,1263,1161
22549,1,0,5,0,-5
22550,1,0,10,0,-10
22551,0,0,118,0,-118
22552,0,0,127,0,-127
22553,0,0,69,0,-69
22554,1,0,44,0,-44
22555,0,0,6,0,-6
22556,0,0,112,0,-112
22557,1,0,21,0,-21
22558,0,0,30,0,-30
22559,1,1,1496,1674,178
22560,1,0,40,0,-40
22561,1,1,210,1906,1696
22562,1,1,194,1252,1058
22563,1,0,0,0,0
22564,0,0,16,0,-16
22565,1,1,944,1600,656
22566,1,0,99,0,-99
22567,1,0,46,0,-46
22568,0,0,108,0,-108
22569,1,0,8,0,-8
22570,1,1,203,2200,1997
22571,1,1,149,1265,1116
22572,1,1,540,1972,1432
22573,1,0,161,0,-161
22574,1,1,1039,1608,569
22575,0,0,10,0,-10
22576,0,0,180,0,-180
22577,1,0,34,0,-34
22578,0,0,21,0,-21
22579,0,0,20,0,-20
22580,0,0,85,0,-85
22581,0,0,60,0,-60
22582,0,0,12,0,-12
22583,1,1,91,1209,1118
22584,1,0,79,0,-79
22585,1,1,1185,2182,997
22586,1,1,64,1349,1285
22587,1,1,874,1365,491
22588,1,1,514,2797,2283
22589,1,0,33,0,-33
22590,0,0,37,0,-37
22591,0,0,12,0,-12
22592,0,0,37,0,-37
22593,0,0,22,0,-22
22594,1,1,95,1202,1107
22595,0,0,43,0,-43
22596,1,1,515,1310,795
22597,1,1,298,3554,3256
22598,0,0,13,0,-13
22599,1,1,343,1241,898
22600,1,0,54,0,-54
22601,0,0,46,0,-46
22602,0,0,47,0,-47
22603,0,0,13,0,-13
22604,1,1,179,1373,1194
22605,0,0,17,0,-17
22606,1,0,47,0,-47
22607,0,0,74,0,-74
22608,0,0,4,0,-4
22609,1,1,266,1360,1094
22610,0,0,64,0,-64
22611,1,1,357,3135,2778
22612,1,1,1137,2044,907
22613,1,1,1977,1376,-601
22614,1,0,4,0,-4
22615,1,1,150,1249,1099
22616,1,1,284,1337,1053
22617,1,0,22,0,-22
22618,0,0,30,0,-30
22619,0,0,106,0,-106
22620,1,1,86,1380,1294
22621,1,0,22,0,-22
22622,0,0,3,0,-3
22623,1,1,157,1461,1304
22624,1,1,743,1825,1082
22625,0,0,4,0,-4
22626,0,0,33,0,-33
22627,1,1,278,1370,1092
22628,1,0,30,0,-30
22629,1,1,773,1699,926
22630,0,0,25,0,-25
22631,0,0,124,0,-124
22632,1,0,24,0,-24
22633,1,1,131,2086,1955
22634,1,1,486,1352,866
22635,0,0,214,0,-214
22636,0,0,37,0,-37
22637,0,0,12,0,-12
22638,1,0,59,0,-59
22639,0,0,8,0,-8
22640,0,0,5,0,-5
22641,0,0,8,0,-8
22642,1,0,13,0,-13
22643,0,0,14,0,-14
22644,1,0,48,0,-48
22645,0,0,19,0,-19
22646,1,0,54,0,-54
22647,1,0,19,0,-19
22648,0,0,36,0,-36
22649,0,0,6,0,-6
22650,0,0,13,0,-13
22651,1,0,5,0,-5
22652,1,1,82,1302,1220
22653,1,1,350,1541,1191
22654,1,1,411,1465,1054
22655,1,1,200,2135,1935
22656,1,0,48,0,-48
22657,1,0,9,0,-9
22658,1,0,15,0,-15
22659,1,0,6,0,-6
22660,0,0,96,0,-96
22661,1,0,119,0,-119
22662,0,0,9,0,-9
22663,1,0,80,0,-80
22664,1,0,20,0,-20
22665,0,0,117,0,-117
22666,1,0,147,0,-147
22667,1,0,40,0,-40
22668,1,0,67,0,-67
22669,1,0,10,0,-10
22670,1,1,590,1246,656
22671,0,0,26,0,-26
22672,0,0,55,0,-55
22673,0,0,52,0,-52
22674,1,1,538,1724,1186
22675,1,1,714,1347,633
22676,0,0,45,0,-45
22677,1,1,645,1454,809
22678,0,0,19,0,-19
22679,1,0,100,0,-100
22680,1,0,110,0,-110
22681,1,0,62,0,-62
22682,0,0,100,0,-100
22683,1,1,246,1217,971
22684,0,0,37,0,-37
22685,1,0,8,0,-8
22686,0,0,11,0,-11
22687,1,1,212,1208,996
22688,1,0,11,0,-11
22689,0,0,0,0,0
22690,1,0,10,0,-10
22691,0,0,40,0,-40
22692,0,0,102,0,-102
22693,0,0,24,0,-24
22694,1,0,11,0,-11
22695,0,0,90,0,-90
22696,1,1,442,2039,1597
22697,0,0,14,0,-14
22698,1,1,51,1848,1797
22699,1,1,920,1823,903
22700,0,0,29,0,-29
22701,0,0,16,0,-16
22702,1,1,1014,1598,584
22703,0,0,29,0,-29
22704,1,0,32,0,-32
22705,0,0,84,0,-84
22706,1,0,0,0,0
22707,0,0,74,0,-74
22708,1,1,202,1355,1153
22709,1,0,14,0,-14
22710,0,0,112,0,-112
22711,1,0,35,0,-35
22712,1,1,89,2329,2240
22713,1,0,63,0,-63
22714,1,0,35,0,-35
22715,0,0,7,0,-7
22716,0,0,25,0,-25
22717,1,0,15,0,-15
22718,0,0,70,0,-70
22719,0,0,46,0,-46
22720,1,0,2,0,-2
22721,0,0,86,0,-86
22722,0,0,150,0,-150
22723,1,1,159,6574,6415
22724,1,0,6,0,-6
22725,1,1,462,1218,756
22726,1,0,33,0,-33
22727,1,1,332,1345,1013
22728,1,0,61,0,-61
22729,1,0,77,0,-77
22730,1,0,92,0,-92
22731,1,0,15,0,-15
22732,1,1,584,1945,1361
22733,0,0,68,0,-68
22734,1,0,2,0,-2
22735,0,0,50,0,-50
22736,0,0,33,0,-33
22737,0,0,24,0,-24
22738,1,0,16,0,-16
22739,1,0,36,0,-36
22740,1,0,33,0,-33
22741,1,0,30,0,-30
22742,0,0,38,0,-38
22743,1,1,822,2559,1737
22744,1,1,1622,1482,-140
22745,1,0,7,0,-7
22746,1,1,995,1389,394
22747,1,0,33,0,-33
22748,1,1,379,1277,898
22749,0,0,35,0,-35
22750,0,0,0,0,0
22751,0,0,202,0,-202
22752,1,1,664,1456,792
22753,1,1,208,1446,1238
22754,1,0,6,0,-6
22755,1,1,510,1958,1448
22756,0,0,40,0,-40
22757,1,0,117,0,-117
22758,1,0,63,0,-63
22759,1,0,101,0,-101
22760,0,0,10,0,-10
22761,1,1,65,1319,1254
22762,1,0,118,0,-118
22763,1,0,0,0,0
22764,1,0,97,0,-97
22765,1,1,1000,1499,499
22766,1,1,957,1323,366
22767,1,1,595,1825,1230
22768,0,0,1,0,-1
22769,1,1,251,1219,968
22770,1,1,88,1452,1364
22771,1,1,667,1382,715
22772,0,0,22,0,-22
22773,1,1,807,1726,919
22774,1,0,20,0,-20
22775,1,1,2615,1466,-1149
22776,0,0,106,0,-106
22777,0,0,91,0,-91
22778,0,0,101,0,-101
22779,0,0,52,0,-52
22780,1,1,590,1366,776
22781,0,0,7,0,-7
22782,0,0,50,0,-50
22783,1,1,80,1630,1550
22784,1,1,31,1431,1400
22785,0,0,49,0,-49
22786,1,0,98,0,-98
22787,1,1,342,1309,967
22788,1,0,16,0,-16
22789,1,1,103,1238,1135
22790,1,1,1083,1278,195
22791,0,0,71,0,-71
22792,1,1,924,1370,446
22793,1,1,352,1690,1338
22794,0,0,129,0,-129
22795,0,0,21,0,-21
22796,1,1,637,1243,606
22797,0,0,32,0,-32
22798,1,1,39,1249,1210
22799,1,1,454,1202,748
22800,0,0,20,0,-20
22801,0,0,14,0,-14
22802,1,1,94,1259,1165
22803,1,1,979,1558,579
22804,1,1,1002,2929,1927
22805,0,0,105,0,-105
22806,0,0,117,0,-117
22807,1,0,18,0,-18
22808,1,0,48,0,-48
22809,1,1,652,1568,916
22810,1,0,5,0,-5
22811,1,1,644,1242,598
22812,1,0,56,0,-56
22813,1,1,1386,1233,-153
22814,0,0,3,0,-3
22815,1,1,287,1543,1256
22816,0,0,101,0,-101
22817,1,0,13,0,-13
22818,0,0,17,0,-17
22819,0,0,12,0,-12
22820,0,0,11,0,-11
22821,0,0,1,0,-1
22822,0,0,197,0,-197
22823,1,0,5,0,-5
22824,0,0,133,0,-133
22825,1,1,105,2554,2449
22826,0,0,0,0,0
22827,0,0,31,0,-31
22828,0,0,70,0,-70
22829,1,0,76,0,-76
22830,1,0,36,0,-36
22831,0,0,54,0,-54
22832,1,1,335,1325,990
22833,1,1,208,1256,1048
22834,1,1,1413,1557,144
22835,1,1,948,1426,478
22836,0,0,41,0,-41
22837,1,1,232,1759,1527
22838,1,0,155,0,-155
22839,0,0,106,0,-106
22840,0,0,54,0,-54
22841,0,0,139,0,-139
22842,1,1,124,1319,1195
22843,1,0,140,0,-140
22844,1,1,146,1764,1618
22845,1,0,39,0,-39
22846,0,0,13,0,-13
22847,0,0,8,0,-8
22848,0,0,40,0,-40
22849,1,0,47,0,-47
22850,0,0,13,0,-13
22851,1,0,113,0,-113
22852,0,0,12,0,-12
22853,0,0,34,0,-34
22854,0,0,39,0,-39
22855,1,0,10,0,-10
22856,1,0,11,0,-11
22857,0,0,104,0,-104
22858,1,0,92,0,-92
22859,1,0,2,0,-2
22860,0,0,19,0,-19
22861,1,0,58,0,-58
22862,1,1,848,1294,446
22863,1,1,2964,1715,-1249
22864,1,0,52,0,-52
22865,0,0,10,0,-10
22866,1,0,89,0,-89
22867,0,0,55,0,-55
22868,1,1,273,1205,932
22869,0,0,41,0,-41
22870,0,0,96,0,-96
22871,0,0,36,0,-36
22872,0,0,18,0,-18
22873,0,0,70,0,-70
22874,1,0,10,0,-10
22875,1,1,516,1273,757
22876,0,0,13,0,-13
22877,1,1,238,1314,1076
22878,1,1,1793,1203,-590
22879,0,0,14,0,-14
22880,0,0,64,0,-64
22881,1,0,41,0,-41
22882,1,1,133,1218,1085
22883,1,0,30,0,-30
22884,1,0,7,0,-7
22885,0,0,23,0,-23
22886,1,1,1429,1600,171
22887,1,1,411,3582,3171
22888,0,0,139,0,-139
22889,0,0,22,0,-22
22890,1,1,1086,2298,1212
22891,1,1,502,2056,1554
22892,0,0,10,0,-10
22893,1,0,185,0,-185
22894,0,0,1,0,-1
22895,1,0,14,0,-14
22896,0,0,17,0,-17
22897,1,1,116,2204,2088
22898,1,1,268,1327,1059
22899,1,0,47,0,-47
22900,1,0,17,0,-17
22901,0,0,7,0,-7
22902,1,1,93,2090,1997
22903,1,0,104,0,-104
22904,0,0,9,0,-9
22905,0,0,42,0,-42
22906,0,0,30,0,-30
22907,0,0,57,0,-57
22908,0,0,4,0,-4
22909,1,0,11,0,-11
22910,1,1,143,1337,1194
22911,0,0,5,0,-5
22912,1,0,9,0,-9
22913,0,0,10,0,-10
22914,0,0,10,0,-10
22915,1,0,70,0,-70
22916,0,0,14,0,-14
22917,0,0,45,0,-45
22918,1,0,31,0,-31
22919,0,0,20,0,-20
22920,0,0,182,0,-182
22921,1,0,4,0,-4
22922,1,1,229,1205,976
22923,1,0,47,0,-47
22924,0,0,49,0,-49
22925,0,0,92,0,-92
22926,1,1,584,1774,1190
22927,0,0,24,0,-24
22928,1,0,10,0,-10
22929,1,1,559,1873,1314
22930,1,0,80,0,-80
22931,0,0,11,0,-11
22932,1,0,47,0,-47
22933,1,0,27,0,-27
22934,1,0,14,0,-14
22935,0,0,58,0,-58
22936,0,0,33,0,-33
22937,1,0,22,0,-22
22938,1,0,57,0,-57
22939,1,1,1483,2415,932
22940,1,0,27,0,-27
22941,1,0,55,0,-55
22942,1,1,1262,1580,318
22943,1,1,283,1464,1181
22944,0,0,128,0,-128
22945,1,0,14,0,-14
22946,1,1,379,1345,966
22947,0,0,77,0,-77
22948,1,0,109,0,-109
22949,0,0,30,0,-30
22950,0,0,142,0,-142
22951,0,0,147,0,-147
22952,1,1,297,1852,1555
22953,1,0,39,0,-39
22954,1,1,208,1365,1157
22955,1,1,492,1322,830
22956,1,0,142,0,-142
22957,0,0,86,0,-86
22958,1,1,355,1847,1492
22959,1,0,72,0,-72
22960,1,0,0,0,0
22961,0,0,16,0,-16
22962,0,0,39,0,-39
22963,1,1,874,1209,335
22964,0,0,11,0,-11
22965,1,0,122,0,-122
22966,0,0,154,0,-154
22967,1,1,961,1275,314
22968,1,1,273,1353,1080
22969,0,0,10,0,-10
22970,1,1,264,1386,1122
22971,0,0,161,0,-161
22972,0,0,12,0,-12
22973,1,0,92,0,-92
22974,1,1,1699,1271,-428
22975,0,0,46,0,-46
22976,1,0,27,0,-27
22977,1,1,262,1203,941
22978,0,0,62,0,-62
22979,1,0,51,0,-51
22980,1,1,503,1525,1022
22981,0,0,174,0,-174
22982,0,0,45,0,-45
22983,0,0,75,0,-75
22984,0,0,85,0,-85
22985,0,0,97,0,-97
22986,0,0,116,0,-116
22987,1,0,60,0,-60
22988,1,0,3,0,-3
22989,1,0,16,0,-16
22990,1,0,28,0,-28
22991,1,1,1359,1893,534
22992,1,0,28,0,-28
22993,1,1,129,1309,1180
22994,1,1,1176,1736,560
22995,1,0,39,0,-39
22996,1,0,9,0,-9
22997,1,1,291,1409,1118
22998,1,0,30,0,-30
22999,0,0,11,0,-11
23000,1,1,143,1264,1121
23001,1,1,408,1766,1358
23002,1,0,24,0,-24
23003,1,0,12,0,-12
23004,1,0,136,0,-136
23005,0,0,10,0,-10
23006,1,0,62,0,-62
23007,0,0,146,0,-146
23008,1,0,112,0,-112
23009,0,0,77,0,-77
23010,1,1,647,1201,554
23011,1,1,692,2444,1752
23012,0,0,18,0,-18
23013,1,1,147,1311,1164
23014,0,0,32,0,-32
23015,0,0,5,0,-5
23016,1,0,66,0,-66
23017,1,1,180,1601,1421
23018,0,0,10,0,-10
23019,0,0,1,0,-1
23020,1,0,2,0,-2
23021,0,0,11,0,-11
23022,1,0,9,0,-9
23023,0,0,55,0,-55
23024,0,0,118,0,-118
23025,0,0,22,0,-22
23026,0,0,11,0,-11
23027,0,0,3,0,-3
23028,1,0,1,0,-1
23029,1,1,737,1331,594
23030,1,0,52,0,-52
23031,0,0,9,0,-9
23032,1,1,237,1535,1298
23033,1,0,28,0,-28
23034,1,0,102,0,-102
23035,1,0,0,0,0
23036,0,0,43,0,-43
23037,0,0,0,0,0
23038,1,0,18,0,-18
23039,0,0,148,0,-148
23040,1,0,3,0,-3
23041,1,1,1038,1343,305
23042,0,0,73,0,-73
23043,1,1,297,1301,1004
23044,1,1,673,1489,816
23045,1,0,13,0,-13
23046,0,0,4,0,-4
23047,1,1,190,1525,1335
23048,0,0,3,0,-3
23049,1,0,183,0,-183
23050,1,1,234,1272,1038
23051,1,1,154,1973,1819
23052,1,1,687,1277,590
23053,0,0,60,0,-60
23054,0,0,4,0,-4
23055,1,0,10,0,-10
23056,1,0,18,0,-18
23057,0,0,91,0,-91
23058,1,0,11,0,-11
23059,1,1,276,1743,1467
23060,0,0,5,0,-5
23061,1,0,24,0,-24
23062,0,0,38,0,-38
23063,1,0,70,0,-70
23064,1,0,40,0,-40
23065,1,1,306,1398,1092
23066,1,1,3064,1297,-1767
23067,0,0,429,0,-429
23068,0,0,15,0,-15
23069,1,1,209,1763,1554
23070,0,0,106,0,-106
23071,1,0,4,0,-4
23072,1,0,136,0,-136
23073,1,0,28,0,-28
23074,0,0,73,0,-73
23075,1,1,325,1204,879
23076,0,0,9,0,-9
23077,0,0,30,0,-30
23078,1,1,3575,1259,-2316
23079,0,0,44,0,-44
23080,1,1,98,1243,1145
23081,0,0,21,0,-21
23082,1,1,1155,4211,3056
23083,0,0,3,0,-3
23084,1,1,767,1209,442
23085,1,1,119,2115,1996
23086,1,0,18,0,-18
23087,1,0,42,0,-42
23088,1,0,62,0,-62
23089,0,0,167,0,-167
23090,1,0,73,0,-73
23091,1,1,397,2324,1927
23092,1,0,113,0,-113
23093,1,0,81,0,-81
23094,1,0,17,0,-17
23095,0,0,49,0,-49
23096,1,1,54,1465,1411
23097,1,0,113,0,-113
23098,0,0,125,0,-125
23099,1,1,917,4708,3791
23100,0,0,22,0,-22
23101,1,1,512,1267,755
23102,0,0,200,0,-200
23103,0,0,8,0,-8
23104,1,1,979,1474,495
23105,0,0,251,0,-251
23106,1,0,28,0,-28
23107,1,1,768,3138,2370
23108,1,0,41,0,-41
23109,1,0,2,0,-2
23110,1,1,442,1223,781
23111,1,0,20,0,-20
23112,1,1,389,1286,897
23113,0,0,65,0,-65
23114,0,0,81,0,-81
23115,1,1,756,2329,1573
23116,1,0,14,0,-14
23117,1,0,5,0,-5
23118,0,0,123,0,-123
23119,1,0,23,0,-23
23120,0,0,1,0,-1
23121,1,0,23,0,-23
23122,0,0,18,0,-18
23123,1,0,6,0,-6
23124,1,1,202,1549,1347
23125,1,0,7,0,-7
23126,1,1,221,1366,1145
23127,1,0,205,0,-205
23128,1,0,12,0,-12
23129,1,0,9,0,-9
23130,0,0,37,0,-37
23131,1,1,439,1789,1350
23132,0,0,197,0,-197
23133,1,0,71,0,-71
23134,1,0,17,0,-17
23135,1,0,63,0,-63
23136,0,0,58,0,-58
23137,1,0,8,0,-8
23138,0,0,2,0,-2
23139,1,0,198,0,-198
23140,0,0,33,0,-33
23141,0,0,16,0,-16
23142,1,1,302,1329,1027
23143,1,0,0,0,0
23144,0,0,55,0,-55
23145,1,1,340,1461,1121
23146,0,0,31,0,-31
23147,0,0,126,0,-126
23148,0,0,59,0,-59
23149,0,0,49,0,-49
23150,1,1,84,1444,1360
23151,1,1,497,1217,720
23152,1,1,537,1377,840
23153,0,0,17,0,-17
23154,1,1,1126,2643,1517
23155,1,1,163,2301,2138
23156,1,1,184,1505,1321
23157,0,0,4,0,-4
23158,1,1,380,3090,2710
23159,0,0,10,0,-10
23160,1,1,81,1494,1413
23161,0,0,52,0,-52
23162,1,1,911,1444,533
23163,0,0,149,0,-149
23164,1,0,111,0,-111
23165,0,0,17,0,-17
23166,1,0,122,0,-122
23167,0,0,18,0,-18
23168,1,1,237,2941,2704
23169,0,0,27,0,-27
23170,1,1,668,1335,667
23171,0,0,45,0,-45
23172,1,0,22,0,-22
23173,0,0,3,0,-3
23174,0,0,14,0,-14
23175,1,1,203,1338,1135
23176,0,0,80,0,-80
23177,0,0,46,0,-46
23178,1,0,6,0,-6
23179,1,0,11,0,-11
23180,0,0,106,0,-106
23181,1,0,88,0,-88
23182,1,0,14,0,-14
23183,1,0,7,0,-7
23184,1,1,264,1211,947
23185,0,0,29,0,-29
23186,1,1,162,1551,1389
23187,1,1,352,1710,1358
23188,1,1,361,1597,1236
23189,1,0,6,0,-6
23190,0,0,10,0,-10
23191,1,1,279,1358,1079
23192,1,1,180,1270,1090
23193,1,1,279,1695,1416
23194,1,1,939,1621,682
23195,0,0,20,0,-20
23196,1,0,98,0,-98
23197,1,0,22,0,-22
23198,1,1,270,1557,1287
23199,0,0,138,0,-138
23200,1,1,304,1560,1256
23201,1,1,705,1332,627
23202,1,0,170,0,-170
23203,0,0,15,0,-15
23204,1,1,311,1338,1027
23205,1,0,80,0,-80
23206,1,0,214,0,-214
23207,1,1,285,1242,957
23208,0,0,4,0,-4
23209,0,0,16,0,-16
23210,0,0,27,0,-27
23211,1,1,201,1297,1096
23212,0,0,2,0,-2
23213,1,1,111,1490,1379
23214,1,0,1,0,-1
23215,1,0,57,0,-57
23216,1,1,197,1228,1031
23217,1,0,90,0,-90
23218,1,1,211,1340,1129
23219,0,0,99,0,-99
23220,1,1,938,1813,875
23221,1,1,973,1271,298
23222,0,0,40,0,-40
23223,1,0,23,0,-23
23224,1,0,42,0,-42
23225,1,0,32,0,-32
23226,1,0,19,0,-19
23227,1,1,216,1232,1016
23228,1,1,739,1205,466
23229,1,1,314,2563,2249
23230,1,1,56,1324,1268
23231,1,1,176,1472,1296
23232,0,0,41,0,-41
23233,1,1,959,1311,352
23234,1,1,1156,1453,297
23235,0,0,27,0,-27
23236,0,0,20,0,-20
23237,1,0,40,0,-40
23238,0,0,11,0,-11
23239,0,0,134,0,-134
23240,1,0,41,0,-41
23241,1,1,1381,1377,-4
23242,1,1,739,1434,695
23243,0,0,69,0,-69
23244,1,1,265,1355,1090
23245,0,0,120,0,-120
23246,1,0,15,0,-15
23247,0,0,62,0,-62
23248,1,0,86,0,-86
23249,1,1,369,1634,1265
23250,0,0,40,0,-40
23251,0,0,45,0,-45
23252,1,0,69,0,-69
23253,0,0,60,0,-60
23254,1,1,1522,1208,-314
23255,0,0,45,0,-45
23256,1,1,275,1818,1543
23257,0,0,17,0,-17
23258,1,0,86,0,-86
23259,0,0,57,0,-57
23260,0,0,25,0,-25
23261,1,0,135,0,-135
23262,0,0,48,0,-48
23263,1,1,344,1484,1140
23264,1,1,983,1236,253
23265,0,0,122,0,-122
23266,1,0,27,0,-27
23267,1,0,6,0,-6
23268,1,1,310,1261,951
23269,0,0,29,0,-29
23270,0,0,81,0,-81
23271,0,0,46,0,-46
23272,1,1,126,1200,1074
23273,1,1,562,1515,953
23274,0,0,200,0,-200
23275,0,0,8,0,-8
23276,1,1,821,1999,1178
23277,1,1,563,2185,1622
23278,1,1,366,1334,968
23279,1,1,976,1299,323
23280,1,0,32,0,-32
23281,1,0,61,0,-61
23282,0,0,26,0,-26
23283,0,0,151,0,-151
23284,1,1,296,1669,1373
23285,0,0,89,0,-89
23286,1,0,20,0,-20
23287,0,0,25,0,-25
23288,1,0,100,0,-100
23289,0,0,94,0,-94
23290,1,0,15,0,-15
23291,0,0,1,0,-1
23292,0,0,2,0,-2
23293,0,0,24,0,-24
23294,0,0,8,0,-8
23295,1,0,34,0,-34
23296,0,0,21,0,-21
23297,1,1,1007,1546,539
23298,0,0,124,0,-124
23299,1,1,231,1328,1097
23300,1,1,304,1486,1182
23301,1,1,580,1368,788
23302,1,0,48,0,-48
23303,1,0,101,0,-101
23304,1,0,42,0,-42
23305,0,0,1,0,-1
23306,0,0,24,0,-24
23307,1,0,54,0,-54
23308,1,0,34,0,-34
23309,0,0,72,0,-72
23310,0,0,28,0,-28
23311,1,1,810,1227,417
23312,0,0,5,0,-5
23313,0,0,156,0,-156
23314,1,1,531,1635,1104
23315,1,1,977,2582,1605
23316,1,1,325,1257,932
23317,1,1,535,1450,915
23318,1,0,40,0,-40
23319,1,0,107,0,-107
23320,1,1,17,1452,1435
23321,1,0,36,0,-36
23322,0,0,154,0,-154
23323,1,0,0,0,0
23324,0,0,88,0,-88
23325,0,0,20,0,-20
23326,1,1,152,1262,1110
23327,0,0,46,0,-46
23328,1,0,127,0,-127
23329,1,0,18,0,-18
23330,0,0,45,0,-45
23331,1,1,137,1324,1187
23332,1,1,750,1251,501
23333,0,0,23,0,-23
23334,0,0,33,0,-33
23335,0,0,5,0,-5
23336,1,1,288,1267,979
23337,1,0,78,0,-78
23338,0,0,30,0,-30
23339,1,0,110,0,-110
23340,1,1,34,1314,1280
23341,1,1,370,1768,1398
23342,1,1,397,1329,932
23343,1,0,74,0,-74
23344,1,0,20,0,-20
23345,0,0,78,0,-78
23346,1,0,20,0,-20
23347,1,1,136,1233,1097
23348,1,1,557,2187,1630
23349,0,0,21,0,-21
23350,1,0,52,0,-52
23351,0,0,6,0,-6
23352,0,0,42,0,-42
23353,1,0,155,0,-155
23354,0,0,42,0,-42
23355,0,0,31,0,-31
23356,1,0,9,0,-9
23357,1,1,1330,1243,-87
23358,1,0,27,0,-27
23359,1,0,3,0,-3
23360,1,1,630,1365,735
23361,1,0,103,0,-103
23362,1,0,5,0,-5
23363,1,1,322,1226,904
23364,1,1,112,1253,1141
23365,0,0,7,0,-7
23366,1,1,1217,1469,252
23367,1,0,99,0,-99
23368,1,1,3,1346,1343
23369,0,0,83,0,-83
23370,0,0,10,0,-10
23371,1,1,1037,1357,320
23372,1,0,2,0,-2
23373,1,1,41,1685,1644
23374,1,0,25,0,-25
23375,0,0,124,0,-124
23376,0,0,7,0,-7
23377,1,0,28,0,-28
23378,1,0,135,0,-135
23379,0,0,77,0,-77
23380,0,0,56,0,-56
23381,0,0,2,0,-2
23382,1,1,1236,1226,-10
23383,0,0,0,0,0
23384,0,0,75,0,-75
23385,1,0,15,0,-15
23386,1,1,452,5797,5345
23387,0,0,8,0,-8
23388,1,0,33,0,-33
23389,1,0,87,0,-87
23390,1,1,624,1438,814
23391,1,0,205,0,-205
23392,0,0,18,0,-18
23393,0,0,10,0,-10
23394,1,1,62,2620,2558
23395,1,1,850,1222,372
23396,0,0,10,0,-10
23397,0,0,32,0,-32
23398,1,0,19,0,-19
23399,0,0,24,0,-24
23400,1,1,364,1209,845
23401,1,1,324,1293,969
23402,1,0,21,0,-21
23403,1,1,131,1226,1095
23404,0,0,27,0,-27
23405,0,0,25,0,-25
23406,1,0,7,0,-7
23407,1,1,997,1245,248
23408,1,1,640,1394,754
23409,0,0,49,0,-49
23410,1,1,78,1398,1320
23411,0,0,73,0,-73
23412,1,0,2,0,-2
23413,0,0,13,0,-13
23414,1,1,187,1304,1117
23415,1,1,734,1771,1037
23416,0,0,5,0,-5
23417,1,1,1829,1222,-607
23418,1,1,691,1337,646
23419,1,0,14,0,-14
23420,0,0,84,0,-84
23421,1,0,60,0,-60
23422,0,0,38,0,-38
23423,1,0,46,0,-46
23424,0,0,15,0,-15
23425,1,1,299,1432,1133
23426,1,0,64,0,-64
23427,1,0,19,0,-19
23428,1,0,95,0,-95
23429,1,0,4,0,-4
23430,0,0,153,0,-153
23431,0,0,4,0,-4
23432,1,1,184,1415,1231
23433,0,0,5,0,-5
23434,0,0,13,0,-13
23435,0,0,16,0,-16
23436,1,0,63,0,-63
23437,1,1,922,1856,934
23438,0,0,48,0,-48
23439,0,0,117,0,-117
23440,1,1,271,1420,1149
23441,1,0,89,0,-89
23442,0,0,23,0,-23
23443,1,0,26,0,-26
23444,1,0,47,0,-47
23445,0,0,123,0,-123
23446,1,1,78,1995,1917
23447,1,1,553,2134,1581
23448,1,1,1445,2271,826
23449,1,1,324,1363,1039
23450,1,0,16,0,-16
23451,1,1,267,1319,1052
23452,0,0,32,0,-32
23453,0,0,6,0,-6
23454,0,0,95,0,-95
23455,0,0,121,0,-121
23456,1,1,299,2141,1842
23457,1,0,78,0,-78
23458,0,0,56,0,-56
23459,1,1,443,1753,1310
23460,1,1,392,1400,1008
23461,1,1,154,1381,1227
23462,1,0,94,0,-94
23463,1,1,486,1432,946
23464,1,1,313,1438,1125
23465,0,0,88,0,-88
23466,0,0,31,0,-31
23467,1,0,14,0,-14
23468,0,0,15,0,-15
23469,1,1,317,1688,1371
23470,1,1,210,1538,1328
23471,0,0,27,0,-27
23472,0,0,6,0,-6
23473,0,0,238,0,-238
23474,0,0,76,0,-76
23475,0,0,53,0,-53
23476,1,1,205,1380,1175
23477,1,0,30,0,-30
23478,0,0,2,0,-2
23479,1,1,23,1293,1270
23480,0,0,35,0,-35
23481,0,0,9,0,-9
23482,1,1,678,1439,761
23483,1,1,529,3028,2499
23484,1,1,208,1825,1617
23485,0,0,106,0,-106
23486,1,0,20,0,-20
23487,0,0,3,0,-3
23488,1,1,398,2991,2593
23489,1,0,10,0,-10
23490,1,1,207,1211,1004
23491,0,0,3,0,-3
23492,0,0,64,0,-64
23493,0,0,7,0,-7
23494,0,0,18,0,-18
23495,0,0,26,0,-26
23496,0,0,42,0,-42
23497,1,1,1319,2127,808
23498,1,0,100,0,-100
23499,1,1,214,1895,1681
23500,1,1,349,1304,955
23501,0,0,64,0,-64
23502,0,0,6,0,-6
23503,0,0,31,0,-31
23504,0,0,38,0,-38
23505,0,0,37,0,-37
23506,1,0,37,0,-37
23507,1,1,42,1548,1506
23508,1,0,35,0,-35
23509,0,0,8,0,-8
23510,1,0,65,0,-65
23511,1,1,118,1232,1114
23512,1,1,325,1263,938
23513,0,0,14,0,-14
23514,1,1,102,1697,1595
23515,1,1,210,1236,1026
23516,0,0,20,0,-20
23517,1,0,64,0,-64
23518,0,0,43,0,-43
23519,1,0,109,0,-109
23520,0,0,64,0,-64
23521,0,0,17,0,-17
23522,0,0,105,0,-105
23523,1,0,51,0,-51
23524,1,1,199,1381,1182
23525,0,0,9,0,-9
23526,0,0,9,0,-9
23527,1,1,414,1454,1040
23528,0,0,55,0,-55
23529,1,1,1494,1287,-207
23530,1,0,101,0,-101
23531,1,1,498,2639,2141
23532,1,0,47,0,-47
23533,1,0,63,0,-63
23534,0,0,3,0,-3
23535,0,0,36,0,-36
23536,1,0,63,0,-63
23537,0,0,35,0,-35
23538,0,0,13,0,-13
23539,0,0,168,0,-168
23540,0,0,21,0,-21
23541,1,0,156,0,-156
23542,1,1,33,1345,1312
23543,1,1,240,1309,1069
23544,0,0,38,0,-38
23545,1,1,3203,1267,-1936
23546,1,0,41,0,-41
23547,1,0,7,0,-7
23548,0,0,14,0,-14
23549,1,0,71,0,-71
23550,0,0,3,0,-3
23551,1,0,65,0,-65
23552,1,0,43,0,-43
23553,0,0,3,0,-3
23554,1,0,83,0,-83
23555,1,1,69,1286,1217
23556,1,1,243,1851,1608
23557,1,1,1027,1629,602
23558,1,0,15,0,-15
23559,0,0,17,0,-17
23560,1,0,49,0,-49
23561,1,0,37,0,-37
23562,1,1,302,1471,1169
23563,1,0,12,0,-12
23564,0,0,47,0,-47
23565,1,1,82,1305,1223
23566,1,1,165,2393,2228
23567,1,0,26,0,-26
23568,1,1,177,1551,1374
23569,0,0,177,0,-177
23570,0,0,83,0,-83
23571,1,1,546,2088,1542
23572,0,0,82,0,-82
23573,0,0,40,0,-40
23574,1,0,62,0,-62
23575,1,1,485,1319,834
23576,1,1,1162,1384,222
23577,1,0,62,0,-62
23578,1,0,123,0,-123
23579,0,0,97,0,-97
23580,0,0,77,0,-77
23581,1,0,60,0,-60
23582,0,0,10,0,-10
23583,1,0,5,0,-5
23584,1,1,209,1253,1044
23585,0,0,147,0,-147
23586,1,1,75,2551,2476
23587,1,1,355,1447,1092
23588,0,0,135,0,-135
23589,0,0,4,0,-4
23590,0,0,22,0,-22
23591,1,1,338,1370,1032
23592,1,1,682,1321,639
23593,1,1,533,1439,906
23594,0,0,66,0,-66
23595,1,1,347,1254,907
23596,1,1,372,1444,1072
23597,0,0,120,0,-120
23598,0,0,23,0,-23
23599,0,0,13,0,-13
23600,1,1,1229,1367,138
23601,1,0,108,0,-108
23602,1,0,73,0,-73
23603,0,0,32,0,-32
23604,1,1,315,1346,1031
23605,1,1,1343,2300,957
23606,1,1,2093,1304,-789
23607,1,0,5,0,-5
23608,1,1,185,1297,1112
23609,0,0,55,0,-55
23610,1,1,126,1330,1204
23611,0,0,74,0,-74
23612,0,0,23,0,-23
23613,1,0,78,0,-78
23614,0,0,2,0,-2
23615,0,0,54,0,-54
23616,1,0,78,0,-78
23617,1,1,82,1315,1233
23618,1,1,969,1213,244
23619,0,0,81,0,-81
23620,0,0,87,0,-87
23621,0,0,75,0,-75
23622,1,0,4,0,-4
23623,0,0,45,0,-45
23624,0,0,27,0,-27
23625,1,1,230,1753,1523
23626,0,0,12,0,-12
23627,0,0,182,0,-182
23628,0,0,99,0,-99
23629,0,0,56,0,-56
23630,1,0,25,0,-25
23631,0,0,3,0,-3
23632,0,0,180,0,-180
23633,1,1,413,1817,1404
23634,0,0,18,0,-18
23635,1,1,3877,1460,-2417
23636,1,1,94,1372,1278
23637,1,0,0,0,0
23638,1,0,35,0,-35
23639,0,0,30,0,-30
23640,1,0,10,0,-10
23641,1,0,33,0,-33
23642,1,0,116,0,-116
23643,1,0,93,0,-93
23644,1,0,43,0,-43
23645,0,0,3,0,-3
23646,1,1,1277,1306,29
23647,1,1,103,1501,1398
23648,0,0,100,0,-100
23649,1,1,202,1251,1049
23650,1,1,350,1684,1334
23651,0,0,220,0,-220
23652,0,0,39,0,-39
23653,1,1,732,1589,857
23654,0,0,7,0,-7
23655,0,0,15,0,-15
23656,1,1,380,1626,1246
23657,1,0,21,0,-21
23658,1,0,211,0,-211
23659,1,0,46,0,-46
23660,1,0,18,0,-18
23661,1,1,414,1298,884
23662,1,0,108,0,-108
23663,1,0,30,0,-30
23664,0,0,3,0,-3
23665,0,0,15,0,-15
23666,0,0,23,0,-23
23667,1,0,80,0,-80
23668,1,1,229,1563,1334
23669,1,1,590,1983,1393
23670,1,0,70,0,-70
23671,1,1,159,3371,3212
23672,1,0,8,0,-8
23673,1,1,99,1460,1361
23674,0,0,178,0,-178
23675,0,0,1,0,-1
23676,1,0,23,0,-23
23677,0,0,1,0,-1
23678,1,1,1355,2007,652
23679,1,0,21,0,-21
23680,0,0,101,0,-101
23681,1,0,53,0,-53
23682,1,0,6,0,-6
23683,0,0,26,0,-26
23684,1,0,2,0,-2
23685,0,0,11,0,-11
23686,1,0,54,0,-54
23687,0,0,109,0,-109
23688,0,0,81,0,-81
23689,1,0,92,0,-92
23690,0,0,18,0,-18
23691,1,0,22,0,-22
23692,1,1,270,1284,1014
23693,1,0,19,0,-19
23694,1,0,84,0,-84
23695,0,0,39,0,-39
23696,1,1,774,2030,1256
23697,1,1,45,1340,1295
23698,1,0,1,0,-1
23699,1,1,532,1262,730
23700,1,1,78,1271,1193
23701,1,1,1026,1266,240
23702,1,1,515,1730,1215
23703,1,1,297,1402,1105
23704,0,0,180,0,-180
23705,1,1,257,1391,1134
23706,0,0,109,0,-109
23707,1,0,6,0,-6
23708,0,0,15,0,-15
23709,0,0,1,0,-1
23710,0,0,41,0,-41
23711,1,0,113,0,-113
23712,0,0,18,0,-18
23713,1,0,77,0,-77
23714,1,0,13,0,-13
23715,1,1,79,1314,1235
23716,1,0,142,0,-142
23717,0,0,30,0,-30
23718,1,0,12,0,-12
23719,1,1,478,1236,758
23720,1,0,177,0,-177
23721,1,1,201,1446,1245
23722,0,0,121,0,-121
23723,1,0,12,0,-12
23724,0,0,44,0,-44
23725,0,0,61,0,-61
23726,1,1,138,1240,1102
23727,1,1,70,1581,1511
23728,1,1,192,1214,1022
23729,1,1,649,1243,594
23730,0,0,138,0,-138
23731,0,0,30,0,-30
23732,0,0,3,0,-3
23733,0,0,14,0,-14
23734,1,1,257,1285,1028
23735,0,0,21,0,-21
23736,1,1,456,1781,1325
23737,0,0,39,0,-39
23738,1,1,38,1525,1487
23739,1,0,2,0,-2
23740,0,0,7,0,-7
23741,0,0,78,0,-78
23742,1,0,27,0,-27
23743,0,0,162,0,-162
23744,0,0,18,0,-18
23745,1,1,806,1274,468
23746,1,0,47,0,-47
23747,1,1,159,1200,1041
23748,1,1,258,1497,1239
23749,0,0,35,0,-35
23750,0,0,74,0,-74
23751,1,0,39,0,-39
23752,1,0,49,0,-49
23753,0,0,91,0,-91
23754,1,0,27,0,-27
23755,1,1,452,1216,764
23756,1,0,67,0,-67
23757,1,1,962,1204,242
23758,1,0,11,0,-11
23759,0,0,17,0,-17
23760,0,0,56,0,-56
23761,0,0,53,0,-53
23762,0,0,44,0,-44
23763,1,1,612,1636,1024
23764,1,0,106,0,-106
23765,1,1,185,1208,1023
23766,1,0,35,0,-35
23767,0,0,165,0,-165
23768,0,0,28,0,-28
23769,1,1,1100,1338,238
23770,1,0,35,0,-35
23771,0,0,84,0,-84
23772,0,0,66,0,-66
23773,0,0,11,0,-11
23774,1,1,1641,1365,-276
23775,1,0,28,0,-28
23776,1,0,60,0,-60
23777,1,1,262,1504,1242
23778,1,1,621,1533,912
23779,0,0,163,0,-163
23780,0,0,8,0,-8
23781,1,0,15,0,-15
23782,0,0,69,0,-69
23783,1,1,988,1991,1003
23784,0,0,98,0,-98
23785,1,1,321,1505,1184
23786,1,1,346,1249,903
23787,1,0,48,0,-48
23788,1,1,513,1365,852
23789,0,0,20,0,-20
23790,1,1,108,1384,1276
23791,0,0,95,0,-95
23792,1,0,180,0,-180
23793,1,0,3,0,-3
23794,1,0,7,0,-7
23795,1,0,12,0,-12
23796,1,1,123,1219,1096
23797,0,0,65,0,-65
23798,1,0,20,0,-20
23799,1,0,33,0,-33
23800,0,0,38,0,-38
23801,1,0,6,0,-6
23802,0,0,46,0,-46
23803,1,1,1044,1316,272
23804,1,1,72,1335,1263
23805,1,0,77,0,-77
23806,1,1,284,2993,2709
23807,0,0,21,0,-21
23808,0,0,16,0,-16
23809,0,0,31,0,-31
23810,0,0,32,0,-32
23811,1,1,301,1384,1083
23812,1,0,50,0,-50
23813,1,0,222,0,-222
23814,1,0,44,0,-44
23815,1,0,38,0,-38
23816,1,1,643,1391,748
23817,1,0,31,0,-31
23818,1,0,65,0,-65
23819,0,0,14,0,-14
23820,1,1,1399,1288,-111
23821,0,0,155,0,-155
23822,0,0,31,0,-31
23823,1,0,17,0,-17
23824,0,0,4,0,-4
23825,1,0,25,0,-25
23826,1,1,359,2196,1837
23827,1,1,302,1356,1054
23828,0,0,8,0,-8
23829,1,1,1120,1463,343
23830,1,0,24,0,-24
23831,1,0,34,0,-34
23832,1,0,10,0,-10
23833,0,0,2,0,-2
23834,1,0,14,0,-14
23835,1,1,334,1218,884
23836,0,0,106,0,-106
23837,1,0,49,0,-49
23838,1,0,87,0,-87
23839,0,0,152,0,-152
23840,0,0,26,0,-26
23841,1,1,939,1487,548
23842,1,1,445,2817,2372
23843,1,1,387,1516,1129
23844,1,0,53,0,-53
23845,1,1,394,1241,847
23846,1,1,893,1495,602
23847,1,0,46,0,-46
23848,1,0,37,0,-37
23849,0,0,64,0,-64
23850,0,0,42,0,-42
23851,0,0,179,0,-179
23852,1,0,14,0,-14
23853,1,0,10,0,-10
23854,0,0,9,0,-9
23855,1,0,64,0,-64
23856,0,0,36,0,-36
23857,1,1,190,1269,1079
23858,0,0,14,0,-14
23859,0,0,9,0,-9
23860,0,0,30,0,-30
23861,1,1,429,1664,1235
23862,1,0,69,0,-69
23863,0,0,56,0,-56
23864,1,0,23,0,-23
23865,0,0,113,0,-113
23866,1,0,112,0,-112
23867,1,1,349,1354,1005
23868,0,0,0,0,0
23869,1,0,5,0,-5
23870,1,1,254,1317,1063
23871,0,0,81,0,-81
23872,1,1,530,1750,1220
23873,1,1,604,1560,956
23874,1,1,251,1214,963
23875,0,0,102,0,-102
23876,1,0,25,0,-25
23877,0,0,64,0,-64
23878,0,0,49,0,-49
23879,0,0,29,0,-29
23880,0,0,165,0,-165
23881,1,0,30,0,-30
23882,1,1,222,1505,1283
23883,1,0,35,0,-35
23884,1,1,1141,1366,225
23885,1,0,42,0,-42
23886,0,0,70,0,-70
23887,1,1,96,1223,1127
23888,0,0,10,0,-10
23889,1,1,1175,1340,165
23890,0,0,108,0,-108
23891,1,1,47,1327,1280
23892,1,0,18,0,-18
23893,0,0,47,0,-47
23894,0,0,98,0,-98
23895,1,0,131,0,-131
23896,1,0,66,0,-66
23897,1,1,144,1254,1110
23898,1,0,12,0,-12
23899,0,0,49,0,-49
23900,1,0,88,0,-88
23901,1,1,436,1243,807
23902,0,0,9,0,-9
23903,1,1,362,1294,932
23904,0,0,40,0,-40
23905,1,1,3274,1282,-1992
23906,1,1,152,2518,2366
23907,0,0,134,0,-134
23908,1,0,1,0,-1
23909,1,1,201,1607,1406
23910,1,1,465,1889,1424
23911,1,1,371,1243,872
23912,1,0,11,0,-11
23913,0,0,142,0,-142
23914,1,0,10,0,-10
23915,0,0,25,0,-25
23916,0,0,210,0,-210
23917,1,0,11,0,-11
23918,1,0,29,0,-29
23919,1,1,376,1324,948
23920,1,1,278,1200,922
23921,0,0,52,0,-52
23922,1,0,71,0,-71
23923,0,0,16,0,-16
23924,1,0,69,0,-69
23925,1,0,20,0,-20
23926,1,1,394,1386,992
23927,1,1,929,1582,653
23928,0,0,15,0,-15
23929,1,0,23,0,-23
23930,0,0,58,0,-58
23931,0,0,33,0,-33
23932,1,1,1185,1640,455
23933,1,1,1241,1375,134
23934,0,0,34,0,-34
23935,1,0,29,0,-29
23936,0,0,0,0,0
23937,1,1,464,1373,909
23938,0,0,15,0,-15
23939,0,0,28,0,-28
23940,0,0,37,0,-37
23941,1,1,566,1268,702
23942,1,1,207,1276,1069
23943,1,0,62,0,-62
23944,0,0,27,0,-27
23945,1,1,598,1565,967
23946,1,0,57,0,-57
23947,0,0,18,0,-18
23948,1,1,677,1591,914
23949,1,0,184,0,-184
23950,1,0,58,0,-58
23951,0,0,7,0,-7
23952,1,0,13,0,-13
23953,0,0,30,0,-30
23954,1,0,55,0,-55
23955,1,0,13,0,-13
23956,0,0,15,0,-15
23957,0,0,76,0,-76
23958,1,0,8,0,-8
23959,0,0,52,0,-52
23960,0,0,75,0,-75
23961,1,0,0,0,0
23962,0,0,76,0,-76
23963,1,0,107,0,-107
23964,1,0,36,0,-36
23965,1,0,18,0,-18
23966,0,0,65,0,-65
23967,1,0,10,0,-10
23968,1,0,76,0,-76
23969,0,0,44,0,-44
23970,0,0,9,0,-9
23971,1,1,1196,2510,1314
23972,0,0,31,0,-31
23973,0,0,39,0,-39
23974,1,0,5,0,-5
23975,1,0,60,0,-60
23976,0,0,24,0,-24
23977,1,0,7,0,-7
23978,0,0,49,0,-49
23979,0,0,112,0,-112
23980,1,0,3,0,-3
23981,1,1,424,2942,2518
23982,1,0,22,0,-22
23983,1,1,376,1973,1597
23984,1,0,14,0,-14
23985,1,0,116,0,-116
23986,1,0,5,0,-5
23987,1,0,64,0,-64
23988,0,0,29,0,-29
23989,1,0,71,0,-71
23990,1,0,92,0,-92
23991,1,0,31,0,-31
23992,1,1,2387,2061,-326
23993,0,0,17,0,-17
23994,0,0,48,0,-48
23995,1,0,21,0,-21
23996,0,0,152,0,-152
23997,0,0,161,0,-161
23998,0,0,140,0,-140
23999,1,0,76,0,-76
24000,1,1,204,1462,1258
24001,1,0,67,0,-67
24002,1,1,710,1695,985
24003,1,1,745,1809,1064
24004,0,0,35,0,-35
24005,0,0,21,0,-21
24006,1,1,356,2201,1845
24007,1,1,289,1223,934
24008,1,1,635,1210,575
24009,1,1,262,1279,1017
24010,1,0,59,0,-59
24011,1,1,680,1392,712
24012,1,1,1140,1258,118
24013,0,0,19,0,-19
24014,0,0,21,0,-21
24015,1,1,33,1254,1221
24016,1,0,10,0,-10
24017,1,1,507,1254,747
24018,1,0,11,0,-11
24019,0,0,34,0,-34
24020,0,0,15,0,-15
24021,1,1,244,1674,1430
24022,0,0,50,0,-50
24023,0,0,89,0,-89
24024,1,0,29,0,-29
24025,1,0,54,0,-54
24026,1,1,816,1814,998
24027,1,1,1792,1238,-554
24028,0,0,30,0,-30
24029,0,0,88,0,-88
24030,1,0,5,0,-5
24031,1,0,25,0,-25
24032,0,0,0,0,0
24033,1,0,108,0,-108
24034,1,0,22,0,-22
24035,1,1,993,1265,272
24036,0,0,26,0,-26
24037,0,0,86,0,-86
24038,0,0,99,0,-99
24039,0,0,58,0,-58
24040,0,0,31,0,-31
24041,1,0,26,0,-26
24042,0,0,26,0,-26
24043,1,0,26,0,-26
24044,0,0,52,0,-52
24045,0,0,27,0,-27
24046,1,0,48,0,-48
24047,0,0,14,0,-14
24048,0,0,62,0,-62
24049,0,0,42,0,-42
24050,0,0,14,0,-14
24051,1,1,1078,1580,502
24052,1,0,47,0,-47
24053,0,0,53,0,-53
24054,1,1,643,1350,707
24055,1,1,210,1419,1209
24056,0,0,58,0,-58
24057,1,1,612,1591,979
24058,0,0,48,0,-48
24059,1,0,24,0,-24
24060,1,0,13,0,-13
24061,1,1,458,1577,1119
24062,0,0,81,0,-81
24063,0,0,55,0,-55
24064,0,0,17,0,-17
24065,1,0,133,0,-133
24066,0,0,94,0,-94
24067,1,1,143,1681,1538
24068,0,0,5,0,-5
24069,1,1,138,1417,1279
24070,0,0,67,0,-67
24071,1,1,1399,2278,879
24072,1,0,23,0,-23
24073,0,0,60,0,-60
24074,0,0,4,0,-4
24075,1,0,16,0,-16
24076,0,0,16,0,-16
24077,1,1,67,1643,1576
24078,0,0,125,0,-125
24079,1,0,52,0,-52
24080,1,0,76,0,-76
24081,0,0,2,0,-2
24082,0,0,21,0,-21
24083,1,0,59,0,-59
24084,0,0,26,0,-26
24085,0,0,14,0,-14
24086,0,0,4,0,-4
24087,0,0,17,0,-17
24088,0,0,17,0,-17
24089,1,0,63,0,-63
24090,1,0,19,0,-19
24091,1,0,30,0,-30
24092,1,1,879,2645,1766
24093,1,0,72,0,-72
24094,1,0,19,0,-19
24095,0,0,50,0,-50
24096,1,1,450,1254,804
24097,0,0,104,0,-104
24098,0,0,7,0,-7
24099,1,0,53,0,-53
24100,1,0,97,0,-97
24101,1,1,485,2167,1682
24102,1,0,44,0,-44
24103,0,0,169,0,-169
24104,1,0,98,0,-98
24105,1,0,11,0,-11
24106,1,0,18,0,-18
24107,0,0,17,0,-17
24108,0,0,72,0,-72
24109,0,0,61,0,-61
24110,1,0,15,0,-15
24111,1,1,479,1252,773
24112,1,0,53,0,-53
24113,0,0,12,0,-12
24114,1,1,198,1254,1056
24115,0,0,92,0,-92
24116,1,0,30,0,-30
24117,1,1,104,1457,1353
24118,1,0,4,0,-4
24119,1,1,375,1233,858
24120,1,0,148,0,-148
24121,1,1,775,1357,582
24122,0,0,10,0,-10
24123,0,0,64,0,-64
24124,1,0,2,0,-2
24125,1,1,494,1305,811
24126,1,0,51,0,-51
24127,1,0,29,0,-29
24128,1,1,213,1203,990
24129,1,0,158,0,-158
24130,1,1,1305,1228,-77
24131,1,1,552,1221,669
24132,1,0,20,0,-20
24133,0,0,19,0,-19
24134,1,0,17,0,-17
24135,1,0,88,0,-88
24136,0,0,50,0,-50
24137,0,0,68,0,-68
24138,0,0,78,0,-78
24139,1,1,198,1231,1033
24140,1,1,637,1268,631
24141,1,1,334,1663,1329
24142,1,1,769,1215,446
24143,1,1,636,1643,1007
24144,0,0,125,0,-125
24145,1,0,6,0,-6
24146,0,0,138,0,-138
24147,1,0,54,0,-54
24148,0,0,5,0,-5
24149,0,0,4,0,-4
24150,1,0,44,0,-44
24151,0,0,2,0,-2
24152,0,0,72,0,-72
24153,0,0,81,0,-81
24154,0,0,7,0,-7
24155,0,0,45,0,-45
24156,1,1,107,1413,1306
24157,1,1,243,1252,1009
24158,0,0,139,0,-139
24159,1,0,390,0,-390
24160,1,1,250,1249,999
24161,1,0,0,0,0
24162,1,1,898,1225,327
24163,1,1,352,1652,1300
24164,0,0,5,0,-5
24165,1,1,54,1420,1366
24166,1,1,442,1245,803
24167,1,0,9,0,-9
24168,0,0,20,0,-20
24169,0,0,13,0,-13
24170,0,0,221,0,-221
24171,1,1,416,1441,1025
24172,1,0,7,0,-7
24173,1,0,135,0,-135
24174,0,0,26,0,-26
24175,0,0,4,0,-4
24176,0,0,113,0,-113
24177,0,0,43,0,-43
24178,1,1,174,1778,1604
24179,1,1,484,1236,752
24180,0,0,19,0,-19
24181,1,1,349,1728,1379
24182,0,0,144,0,-144
24183,0,0,46,0,-46
24184,1,0,0,0,0
24185,1,1,242,1262,1020
24186,0,0,66,0,-66
24187,1,1,122,3287,3165
24188,0,0,9,0,-9
24189,1,1,343,2582,2239
24190,1,0,20,0,-20
24191,1,1,47,1580,1533
24192,0,0,18,0,-18
24193,1,0,46,0,-46
24194,1,1,161,1430,1269
24195,0,0,4,0,-4
24196,1,0,72,0,-72
24197,0,0,27,0,-27
24198,0,0,60,0,-60
24199,1,0,109,0,-109
24200,0,0,16,0,-16
24201,1,1,99,2009,1910
24202,1,1,26,1519,1493
24203,1,0,117,0,-117
24204,1,1,456,1978,1522
24205,1,1,313,1841,1528
24206,1,1,79,1234,1155
24207,1,1,240,1309,1069
24208,1,1,855,1738,883
24209,1,1,351,1334,983
24210,1,0,2,0,-2
24211,1,0,70,0,-70
24212,1,1,118,1821,1703
24213,1,1,213,1247,1034
24214,0,0,7,0,-7
24215,0,0,214,0,-214
24216,0,0,29,0,-29
24217,1,1,168,1493,1325
24218,1,0,9,0,-9
24219,1,0,4,0,-4
24220,0,0,209,0,-209
24221,1,1,195,1434,1239
24222,1,1,518,1895,1377
24223,1,1,228,1317,1089
24224,1,0,67,0,-67
24225,0,0,93,0,-93
24226,1,0,90,0,-90
24227,1,1,2092,1566,-526
24228,1,0,183,0,-183
24229,1,0,115,0,-115
24230,1,0,32,0,-32
24231,1,1,224,1442,1218
24232,1,0,33,0,-33
24233,1,1,224,1318,1094
24234,0,0,17,0,-17
24235,1,1,665,2273,1608
24236,0,0,70,0,-70
24237,1,1,1305,1593,288
24238,1,0,15,0,-15
24239,0,0,24,0,-24
24240,1,0,10,0,-10
24241,1,0,32,0,-32
24242,1,0,56,0,-56
24243,0,0,154,0,-154
24244,1,1,580,1296,716
24245,1,0,6,0,-6
24246,1,1,253,1379,1126
24247,1,0,9,0,-9
24248,1,0,3,0,-3
24249,1,1,801,1610,809
24250,0,0,46,0,-46
24251,1,0,11,0,-11
24252,0,0,4,0,-4
24253,1,0,173,0,-173
24254,1,0,80,0,-80
24255,0,0,27,0,-27
24256,1,0,24,0,-24
24257,1,0,15,0,-15
24258,1,1,453,1248,795
24259,0,0,174,0,-174
24260,1,1,55,1415,1360
24261,1,1,112,1293,1181
24262,0,0,10,0,-10
24263,1,1,1627,1686,59
24264,0,0,107,0,-107
24265,0,0,41,0,-41
24266,1,1,39,1375,1336
24267,0,0,85,0,-85
24268,1,0,66,0,-66
24269,0,0,3,0,-3
24270,1,0,5,0,-5
24271,1,1,415,1610,1195
24272,1,0,121,0,-121
24273,1,1,1567,1947,380
24274,1,0,73,0,-73
24275,1,0,27,0,-27
24276,0,0,102,0,-102
24277,0,0,13,0,-13
24278,0,0,41,0,-41
24279,1,0,55,0,-55
24280,0,0,23,0,-23
24281,1,1,697,2018,1321
24282,0,0,3,0,-3
24283,1,0,39,0,-39
24284,0,0,94,0,-94
24285,0,0,28,0,-28
24286,1,0,60,0,-60
24287,1,0,108,0,-108
24288,0,0,16,0,-16
24289,1,0,84,0,-84
24290,1,1,32,1569,1537
24291,1,1,404,1751,1347
24292,1,0,24,0,-24
24293,1,1,223,2663,2440
24294,0,0,25,0,-25
24295,0,0,48,0,-48
24296,1,1,195,1961,1766
24297,0,0,110,0,-110
24298,0,0,1,0,-1
24299,0,0,48,0,-48
24300,0,0,66,0,-66
24301,1,1,417,1907,1490
24302,0,0,7,0,-7
24303,0,0,28,0,-28
24304,1,1,632,1309,677
24305,1,1,262,2109,1847
24306,0,0,58,0,-58
24307,1,1,131,2505,2374
24308,0,0,86,0,-86
24309,1,0,10,0,-10
24310,0,0,25,0,-25
24311,1,1,620,1411,791
24312,0,0,59,0,-59
24313,0,0,13,0,-13
24314,1,1,312,3606,3294
24315,0,0,56,0,-56
24316,0,0,131,0,-131
24317,0,0,57,0,-57
24318,0,0,107,0,-107
24319,0,0,68,0,-68
24320,0,0,15,0,-15
24321,0,0,65,0,-65
24322,1,0,2,0,-2
24323,1,0,53,0,-53
24324,1,1,265,1360,1095
24325,0,0,192,0,-192
24326,0,0,183,0,-183
24327,1,1,675,1206,531
24328,1,0,19,0,-19
24329,1,1,48,1487,1439
24330,0,0,68,0,-68
24331,1,1,484,2946,2462
24332,1,0,34,0,-34
24333,0,0,10,0,-10
24334,1,0,33,0,-33
24335,1,1,245,1809,1564
24336,1,1,290,1322,1032
24337,1,1,355,1431,1076
24338,1,0,81,0,-81
24339,0,0,72,0,-72
24340,1,1,283,2419,2136
24341,0,0,29,0,-29
24342,0,0,48,0,-48
24343,1,1,1116,1221,105
24344,0,0,53,0,-53
24345,0,0,10,0,-10
24346,1,0,105,0,-105
24347,1,1,129,1411,1282
24348,1,1,462,1369,907
24349,1,0,108,0,-108
24350,0,0,43,0,-43
24351,1,1,519,1469,950
24352,1,1,1194,2532,1338
24353,0,0,28,0,-28
24354,1,1,380,1236,856
24355,0,0,45,0,-45
24356,1,1,28,1286,1258
24357,0,0,94,0,-94
24358,1,1,107,1432,1325
24359,1,0,38,0,-38
24360,0,0,3,0,-3
24361,1,0,55,0,-55
24362,0,0,23,0,-23
24363,0,0,65,0,-65
24364,1,1,654,1896,1242
24365,0,0,14,0,-14
24366,1,1,183,1391,1208
24367,0,0,26,0,-26
24368,0,0,44,0,-44
24369,1,0,15,0,-15
24370,1,1,643,1487,844
24371,0,0,48,0,-48
24372,0,0,65,0,-65
24373,1,1,76,1498,1422
24374,1,1,109,1497,1388
24375,1,1,394,1305,911
24376,1,1,771,1256,485
24377,1,1,478,1451,973
24378,0,0,1,0,-1
24379,1,0,101,0,-101
24380,1,1,1161,1318,157
24381,1,1,256,1275,1019
24382,1,1,613,2100,1487
24383,0,0,61,0,-61
24384,1,0,25,0,-25
24385,0,0,131,0,-131
24386,1,1,620,1299,679
24387,1,0,21,0,-21
24388,0,0,21,0,-21
24389,1,1,654,1214,560
24390,0,0,18,0,-18
24391,0,0,14,0,-14
24392,0,0,11,0,-11
24393,1,1,711,1234,523
24394,1,0,28,0,-28
24395,1,0,9,0,-9
24396,0,0,14,0,-14
24397,1,0,53,0,-53
24398,1,0,15,0,-15
24399,1,0,32,0,-32
24400,1,0,14,0,-14
24401,1,0,140,0,-140
24402,0,0,2,0,-2
24403,0,0,55,0,-55
24404,0,0,33,0,-33
24405,1,1,444,3407,2963
24406,1,0,69,0,-69
24407,1,1,170,1232,1062
24408,0,0,58,0,-58
24409,0,0,6,0,-6
24410,1,0,15,0,-15
24411,1,1,439,1261,822
24412,0,0,35,0,-35
24413,1,1,902,1393,491
24414,0,0,75,0,-75
24415,0,0,114,0,-114
24416,1,0,69,0,-69
24417,0,0,10,0,-10
24418,0,0,53,0,-53
24419,0,0,35,0,-35
24420,1,1,473,1409,936
24421,1,1,44,1328,1284
24422,1,0,27,0,-27
24423,1,1,1033,2163,1130
24424,1,0,8,0,-8
24425,0,0,13,0,-13
24426,1,1,300,1266,966
24427,0,0,24,0,-24
24428,0,0,140,0,-140
24429,0,0,126,0,-126
24430,1,0,33,0,-33
24431,1,0,31,0,-31
24432,1,1,29,1364,1335
24433,0,0,144,0,-144
24434,0,0,54,0,-54
24435,1,0,55,0,-55
24436,1,1,791,1409,618
24437,1,0,6,0,-6
24438,0,0,37,0,-37
24439,1,1,351,1725,1374
24440,1,0,26,0,-26
24441,1,0,40,0,-40
24442,1,0,52,0,-52
24443,1,0,13,0,-13
24444,1,0,49,0,-49
24445,0,0,13,0,-13
24446,1,0,10,0,-10
24447,1,1,1657,1984,327
24448,1,0,25,0,-25
24449,1,1,222,1444,1222
24450,1,1,851,1373,522
24451,0,0,88,0,-88
24452,0,0,45,0,-45
24453,0,0,39,0,-39
24454,1,1,646,1730,1084
24455,1,0,12,0,-12
24456,1,0,177,0,-177
24457,0,0,48,0,-48
24458,0,0,51,0,-51
24459,1,1,1618,1433,-185
24460,0,0,5,0,-5
24461,1,1,225,1686,1461
24462,1,0,20,0,-20
24463,1,1,566,1452,886
24464,1,1,914,1796,882
24465,1,1,1294,1632,338
24466,0,0,4,0,-4
24467,1,0,60,0,-60
24468,1,0,126,0,-126
24469,1,0,108,0,-108
24470,0,0,14,0,-14
24471,1,0,12,0,-12
24472,1,0,77,0,-77
24473,1,0,8,0,-8
24474,1,0,7,0,-7
24475,0,0,71,0,-71
24476,0,0,36,0,-36
24477,0,0,171,0,-171
24478,0,0,6,0,-6
24479,1,1,636,1771,1135
24480,1,1,46,1387,1341
24481,1,1,284,1240,956
24482,1,0,83,0,-83
24483,1,0,24,0,-24
24484,1,0,108,0,-108
24485,1,1,1605,1947,342
24486,0,0,57,0,-57
24487,1,0,92,0,-92
24488,0,0,64,0,-64
24489,0,0,53,0,-53
24490,1,1,116,1378,1262
24491,1,0,58,0,-58
24492,0,0,140,0,-140
24493,0,0,8,0,-8
24494,1,1,1000,1611,611
24495,1,1,1009,1489,480
24496,1,0,43,0,-43
24497,0,0,96,0,-96
24498,0,0,62,0,-62
24499,1,1,107,1399,1292
24500,1,1,144,1397,1253
24501,0,0,32,0,-32
24502,0,0,60,0,-60
24503,0,0,156,0,-156
24504,1,1,631,1200,569
24505,0,0,7,0,-7
24506,1,0,6,0,-6
24507,1,0,37,0,-37
24508,1,0,243,0,-243
24509,0,0,29,0,-29
24510,0,0,18,0,-18
24511,0,0,83,0,-83
24512,0,0,157,0,-157
24513,0,0,16,0,-16
24514,1,1,1581,1681,100
24515,1,1,583,1244,661
24516,1,1,376,1886,1510
24517,1,1,650,1440,790
24518,1,0,120,0,-120
24519,1,1,185,1607,1422
24520,1,1,149,1214,1065
24521,1,0,39,0,-39
24522,1,0,160,0,-160
24523,0,0,1,0,-1
24524,1,1,193,1263,1070
24525,1,1,238,1767,1529
24526,1,0,7,0,-7
24527,1,0,58,0,-58
24528,1,0,63,0,-63
24529,0,0,8,0,-8
24530,0,0,27,0,-27
24531,1,0,0,0,0
24532,1,1,176,1212,1036
24533,0,0,34,0,-34
24534,1,0,32,0,-32
24535,1,0,55,0,-55
24536,0,0,87,0,-87
24537,0,0,58,0,-58
24538,0,0,9,0,-9
24539,0,0,18,0,-18
24540,1,1,42,1282,1240
24541,0,0,43,0,-43
24542,1,1,167,1277,1110
24543,1,0,12,0,-12
24544,0,0,41,0,-41
24545,1,1,439,1221,782
24546,1,1,232,1652,1420
24547,0,0,95,0,-95
24548,1,0,10,0,-10
24549,0,0,26,0,-26
24550,0,0,7,0,-7
24551,1,1,516,2345,1829
24552,0,0,123,0,-123
24553,1,0,55,0,-55
24554,1,1,2105,1677,-428
24555,0,0,23,0,-23
24556,1,0,16,0,-16
24557,0,0,17,0,-17
24558,1,1,8,1489,1481
24559,1,0,1,0,-1
24560,0,0,15,0,-15
24561,0,0,47,0,-47
24562,0,0,16,0,-16
24563,0,0,84,0,-84
24564,0,0,9,0,-9
24565,1,0,9,0,-9
24566,0,0,3,0,-3
24567,0,0,47,0,-47
24568,1,1,1708,1610,-98
24569,1,0,4,0,-4
24570,1,0,26,0,-26
24571,1,0,1,0,-1
24572,0,0,22,0,-22
24573,0,0,39,0,-39
24574,0,0,150,0,-150
24575,1,0,20,0,-20
24576,1,0,193,0,-193
24577,0,0,5,0,-5
24578,0,0,51,0,-51
24579,1,0,1,0,-1
24580,1,1,490,1852,1362
24581,1,0,86,0,-86
24582,1,1,2120,1318,-802
24583,0,0,5,0,-5
24584,0,0,51,0,-51
24585,0,0,80,0,-80
24586,0,0,43,0,-43
24587,0,0,14,0,-14
24588,0,0,5,0,-5
24589,0,0,22,0,-22
24590,1,1,42,1246,1204
24591,1,0,14,0,-14
24592,1,0,34,0,-34
24593,1,0,40,0,-40
24594,1,0,7,0,-7
24595,1,0,63,0,-63
24596,1,1,412,1338,926
24597,1,1,543,1660,1117
24598,0,0,115,0,-115
24599,1,0,34,0,-34
24600,1,1,418,1827,1409
24601,1,0,10,0,-10
24602,1,0,13,0,-13
24603,0,0,3,0,-3
24604,1,1,315,1243,928
24605,1,1,380,1482,1102
24606,0,0,293,0,-293
24607,0,0,3,0,-3
24608,1,1,275,2057,1782
24609,0,0,8,0,-8
24610,0,0,32,0,-32
24611,1,1,105,1445,1340
24612,0,0,15,0,-15
24613,0,0,22,0,-22
24614,0,0,74,0,-74
24615,1,0,113,0,-113
24616,0,0,6,0,-6
24617,1,1,1764,1329,-435
24618,0,0,24,0,-24
24619,1,1,2178,1372,-806
24620,0,0,17,0,-17
24621,1,1,411,1647,1236
24622,1,0,13,0,-13
24623,0,0,44,0,-44
24624,1,1,584,1726,1142
24625,0,0,4,0,-4
24626,0,0,1,0,-1
24627,1,0,1,0,-1
24628,1,0,164,0,-164
24629,1,0,68,0,-68
24630,1,1,1292,1615,323
24631,1,0,15,0,-15
24632,0,0,46,0,-46
24633,1,1,90,1423,1333
24634,0,0,10,0,-10
24635,1,1,38,1282,1244
24636,1,0,48,0,-48
24637,1,1,542,1508,966
24638,1,0,42,0,-42
24639,0,0,72,0,-72
24640,1,0,118,0,-118
24641,1,0,33,0,-33
24642,0,0,8,0,-8
24643,0,0,18,0,-18
24644,0,0,92,0,-92
24645,0,0,30,0,-30
24646,1,0,230,0,-230
24647,1,0,144,0,-144
24648,1,1,190,1514,1324
24649,1,0,7,0,-7
24650,0,0,38,0,-38
24651,1,0,189,0,-189
24652,1,1,160,1262,1102
24653,1,1,677,2142,1465
24654,0,0,4,0,-4
24655,1,0,3,0,-3
24656,1,1,712,1818,1106
24657,1,0,53,0,-53
24658,1,1,197,1241,1044
24659,0,0,0,0,0
24660,0,0,9,0,-9
24661,0,0,54,0,-54
24662,1,0,35,0,-35
24663,1,1,611,2803,2192
24664,0,0,15,0,-15
24665,0,0,76,0,-76
24666,1,0,80,0,-80
24667,1,1,92,2156,2064
24668,1,0,36,0,-36
24669,1,0,3,0,-3
24670,1,1,466,1465,999
24671,1,1,111,1619,1508
24672,0,0,54,0,-54
24673,1,0,66,0,-66
24674,1,1,519,1576,1057
24675,1,1,2020,1210,-810
24676,1,0,96,0,-96
24677,1,1,872,1603,731
24678,0,0,10,0,-10
24679,0,0,73,0,-73
24680,0,0,27,0,-27
24681,1,0,34,0,-34
24682,1,1,207,1431,1224
24683,1,0,104,0,-104
24684,0,0,80,0,-80
24685,0,0,20,0,-20
24686,1,1,451,1213,762
24687,1,1,96,1443,1347
24688,1,1,51,1311,1260
24689,0,0,125,0,-125
24690,0,0,64,0,-64
24691,0,0,2,0,-2
24692,1,0,28,0,-28
24693,1,1,1250,2510,1260
24694,1,1,255,1357,1102
24695,0,0,22,0,-22
24696,0,0,19,0,-19
24697,0,0,7,0,-7
24698,0,0,37,0,-37
24699,0,0,63,0,-63
24700,0,0,43,0,-43
24701,1,1,677,1664,987
24702,1,1,187,1444,1257
24703,0,0,25,0,-25
24704,1,1,142,1326,1184
24705,1,1,179,2516,2337
24706,1,0,7,0,-7
24707,1,1,134,1661,1527
24708,1,1,525,1472,947
24709,1,0,335,0,-335
24710,1,1,592,2118,1526
24711,1,0,2,0,-2
24712,0,0,31,0,-31
24713,1,1,69,1232,1163
24714,1,0,58,0,-58
24715,1,0,138,0,-138
24716,1,1,252,1306,1054
24717,1,0,90,0,-90
24718,0,0,9,0,-9
24719,1,1,147,1674,1527
24720,1,1,1454,1307,-147
24721,1,1,1225,1429,204
24722,0,0,190,0,-190
24723,0,0,155,0,-155
24724,1,0,113,0,-113
24725,1,0,1,0,-1
24726,1,0,13,0,-13
24727,0,0,137,0,-137
24728,1,0,18,0,-18
24729,0,0,0,0,0
24730,1,1,806,1742,936
24731,0,0,73,0,-73
24732,1,1,132,1311,1179
24733,1,1,314,1296,982
24734,1,1,570,1765,1195
24735,1,1,352,1277,925
24736,0,0,31,0,-31
24737,1,1,272,1365,1093
24738,0,0,15,0,-15
24739,1,0,6,0,-6
24740,0,0,146,0,-146
24741,0,0,96,0,-96
24742,0,0,49,0,-49
24743,1,1,632,2933,2301
24744,0,0,40,0,-40
24745,0,0,34,0,-34
24746,0,0,26,0,-26
24747,1,0,32,0,-32
24748,1,0,110,0,-110
24749,1,1,1506,1341,-165
24750,0,0,95,0,-95
24751,1,0,17,0,-17
24752,1,1,857,1782,925
24753,0,0,21,0,-21
24754,1,0,37,0,-37
24755,1,0,14,0,-14
24756,0,0,36,0,-36
24757,0,0,0,0,0
24758,1,1,943,1252,309
24759,0,0,27,0,-27
24760,0,0,40,0,-40
24761,0,0,33,0,-33
24762,1,0,30,0,-30
24763,0,0,13,0,-13
24764,1,1,393,1299,906
24765,1,1,186,1242,1056
24766,1,0,26,0,-26
24767,0,0,15,0,-15
24768,0,0,44,0,-44
24769,1,0,130,0,-130
24770,1,0,145,0,-145
24771,0,0,22,0,-22
24772,0,0,72,0,-72
24773,1,0,30,0,-30
24774,1,0,9,0,-9
24775,1,1,1159,1384,225
24776,0,0,68,0,-68
24777,1,1,437,1548,1111
24778,0,0,3,0,-3
24779,1,0,0,0,0
24780,0,0,12,0,-12
24781,0,0,30,0,-30
24782,1,0,41,0,-41
24783,1,1,979,1410,431
24784,0,0,13,0,-13
24785,1,1,280,1667,1387
24786,1,0,86,0,-86
24787,0,0,31,0,-31
24788,1,1,261,1817,1556
24789,0,0,26,0,-26
24790,0,0,41,0,-41
24791,1,0,48,0,-48
24792,0,0,9,0,-9
24793,0,0,2,0,-2
24794,0,0,40,0,-40
24795,0,0,142,0,-142
24796,1,0,104,0,-104
24797,0,0,28,0,-28
24798,1,1,155,1266,1111
24799,1,0,55,0,-55
24800,1,1,571,1443,872
24801,1,0,43,0,-43
24802,1,1,307,1745,1438
24803,0,0,30,0,-30
24804,1,1,387,1234,847
24805,1,0,40,0,-40
24806,1,1,387,1231,844
24807,1,0,30,0,-30
24808,1,0,81,0,-81
24809,0,0,4,0,-4
24810,1,1,59,1205,1146
24811,0,0,64,0,-64
24812,0,0,96,0,-96
24813,1,1,616,1516,900
24814,0,0,58,0,-58
24815,1,1,54,1242,1188
24816,0,0,79,0,-79
24817,0,0,17,0,-17
24818,1,0,13,0,-13
24819,0,0,42,0,-42
24820,1,1,693,1319,626
24821,0,0,4,0,-4
24822,1,0,37,0,-37
24823,1,1,1002,1214,212
24824,0,0,361,0,-361
24825,1,1,1552,1709,157
24826,0,0,36,0,-36
24827,1,0,8,0,-8
24828,1,1,1640,1417,-223
24829,0,0,202,0,-202
24830,1,0,8,0,-8
24831,1,1,338,1213,875
24832,0,0,91,0,-91
24833,1,0,187,0,-187
24834,0,0,40,0,-40
24835,0,0,161,0,-161
24836,1,1,281,1514,1233
24837,1,0,5,0,-5
24838,0,0,4,0,-4
24839,0,0,46,0,-46
24840,1,0,51,0,-51
24841,1,0,2,0,-2
24842,1,1,627,1642,1015
24843,1,0,41,0,-41
24844,1,0,17,0,-17
24845,1,0,57,0,-57
24846,1,1,64,3177,3113
24847,1,0,49,0,-49
24848,1,1,311,1272,961
24849,0,0,8,0,-8
24850,0,0,19,0,-19
24851,0,0,53,0,-53
24852,0,0,117,0,-117
24853,1,0,11,0,-11
24854,1,0,1,0,-1
24855,0,0,24,0,-24
24856,0,0,21,0,-21
24857,0,0,119,0,-119
24858,1,1,339,2071,1732
24859,1,1,213,1390,1177
24860,0,0,132,0,-132
24861,1,1,915,1219,304
24862,0,0,1,0,-1
24863,1,1,1262,1377,115
24864,0,0,40,0,-40
24865,1,1,93,1903,1810
24866,1,0,140,0,-140
24867,1,0,76,0,-76
24868,0,0,80,0,-80
24869,0,0,21,0,-21
24870,1,1,643,1423,780
24871,1,1,111,1478,1367
24872,0,0,24,0,-24
24873,0,0,35,0,-35
24874,1,1,937,1225,288
24875,1,1,881,1464,583
24876,1,0,10,0,-10
24877,1,0,221,0,-221
24878,0,0,95,0,-95
24879,1,0,1,0,-1
24880,1,0,38,0,-38
24881,1,0,45,0,-45
24882,0,0,13,0,-13
24883,1,0,8,0,-8
24884,1,0,52,0,-52
24885,1,0,42,0,-42
24886,1,0,165,0,-165
24887,1,0,92,0,-92
24888,1,1,530,2208,1678
24889,1,0,1,0,-1
24890,1,1,392,1233,841
24891,1,0,13,0,-13
24892,1,0,189,0,-189
24893,0,0,31,0,-31
24894,1,1,333,1320,987
24895,0,0,19,0,-19
24896,1,1,93,1334,1241
24897,1,0,166,0,-166
24898,1,1,182,1347,1165
24899,1,0,12,0,-12
24900,0,0,3,0,-3
24901,0,0,30,0,-30
24902,1,1,341,3659,3318
24903,1,1,163,1322,1159
24904,1,1,523,1366,843
24905,1,1,381,1862,1481
24906,0,0,117,0,-117
24907,0,0,31,0,-31
24908,1,1,454,1496,1042
24909,0,0,6,0,-6
24910,1,0,37,0,-37
24911,0,0,2,0,-2
24912,1,1,172,1433,1261
24913,1,1,849,1201,352
24914,0,0,68,0,-68
24915,1,0,201,0,-201
24916,0,0,86,0,-86
24917,0,0,28,0,-28
24918,1,1,466,1321,855
24919,1,0,91,0,-91
24920,0,0,126,0,-126
24921,0,0,181,0,-181
24922,1,0,93,0,-93
24923,1,0,45,0,-45
24924,0,0,106,0,-106
24925,0,0,36,0,-36
24926,0,0,42,0,-42
24927,0,0,43,0,-43
24928,0,0,25,0,-25
24929,1,0,146,0,-146
24930,0,0,4,0,-4
24931,1,1,682,1486,804
24932,1,1,392,1249,857
24933,1,1,237,1492,1255
24934,1,0,6,0,-6
24935,0,0,41,0,-41
24936,1,1,85,1417,1332
24937,1,1,180,1451,1271
24938,1,1,665,1744,1079
24939,1,1,715,1384,669
24940,1,0,25,0,-25
24941,0,0,68,0,-68
24942,1,1,333,1440,1107
24943,1,1,281,1324,1043
24944,0,0,3,0,-3
24945,1,1,255,1630,1375
24946,1,0,20,0,-20
24947,0,0,47,0,-47
24948,1,1,1683,1553,-130
24949,1,0,19,0,-19
24950,1,1,980,1208,228
24951,1,0,25,0,-25
24952,1,0,40,0,-40
24953,1,0,20,0,-20
24954,1,0,4,0,-4
24955,1,0,130,0,-130
24956,1,0,4,0,-4
24957,1,1,181,1536,1355
24958,1,1,1534,1781,247
24959,0,0,7,0,-7
24960,1,0,24,0,-24
24961,1,0,268,0,-268
24962,1,0,27,0,-27
24963,0,0,6,0,-6
24964,1,1,118,2478,2360
24965,0,0,32,0,-32
24966,1,0,21,0,-21
24967,1,0,99,0,-99
24968,0,0,18,0,-18
24969,0,0,109,0,-109
24970,0,0,170,0,-170
24971,0,0,60,0,-60
24972,1,1,80,1571,1491
24973,1,1,301,1729,1428
24974,1,1,1880,1491,-389
24975,1,1,180,1434,1254
24976,1,0,68,0,-68
24977,0,0,36,0,-36
24978,1,0,0,0,0
24979,1,0,2,0,-2
24980,1,0,1,0,-1
24981,1,1,388,1571,1183
24982,1,1,985,1296,311
24983,1,0,121,0,-121
24984,0,0,81,0,-81
24985,1,1,754,1440,686
24986,1,0,20,0,-20
24987,0,0,68,0,-68
24988,0,0,100,0,-100
24989,1,0,10,0,-10
24990,0,0,44,0,-44
24991,1,1,777,1689,912
24992,0,0,208,0,-208
24993,0,0,96,0,-96
24994,1,0,68,0,-68
24995,0,0,35,0,-35
24996,1,1,1661,2345,684
24997,0,0,29,0,-29
24998,1,1,35,1264,1229
24999,1,0,120,0,-120
25000,0,0,2,0,-2
25001,1,0,10,0,-10
25002,0,0,46,0,-46
25003,1,1,244,1336,1092
25004,0,0,1,0,-1
25005,1,0,11,0,-11
25006,1,1,1453,1433,-20
25007,1,1,526,1451,925
25008,1,1,129,1230,1101
25009,0,0,23,0,-23
25010,1,1,998,1414,416
25011,1,0,187,0,-187
25012,1,1,822,1623,801
25013,0,0,15,0,-15
25014,0,0,70,0,-70
25015,0,0,7,0,-7
25016,1,1,657,1797,1140
25017,1,0,36,0,-36
25018,1,0,9,0,-9
25019,1,0,31,0,-31
25020,1,0,22,0,-22
25021,1,1,1135,1584,449
25022,1,1,748,1260,512
25023,0,0,31,0,-31
25024,0,0,3,0,-3
25025,0,0,63,0,-63
25026,0,0,328,0,-328
25027,0,0,52,0,-52
25028,0,0,38,0,-38
25029,0,0,17,0,-17
25030,1,0,23,0,-23
25031,1,1,426,1215,789
25032,1,1,316,1485,1169
25033,0,0,182,0,-182
25034,1,1,256,1264,1008
25035,1,1,510,1915,1405
25036,1,1,196,1360,1164
25037,0,0,51,0,-51
25038,1,0,128,0,-128
25039,1,0,54,0,-54
25040,1,1,338,1315,977
25041,0,0,13,0,-13
25042,1,1,1090,2217,1127
25043,1,1,83,2402,2319
25044,1,0,42,0,-42
25045,0,0,6,0,-6
25046,1,1,260,1966,1706
25047,1,0,17,0,-17
25048,1,0,14,0,-14
25049,0,0,25,0,-25
25050,0,0,262,0,-262
25051,0,0,121,0,-121
25052,1,1,539,1687,1148
25053,1,1,844,1399,555
25054,1,0,25,0,-25
25055,1,1,1481,1223,-258
25056,1,1,1148,1308,160
25057,0,0,1,0,-1
25058,0,0,56,0,-56
25059,1,1,366,1237,871
25060,0,0,105,0,-105
25061,1,0,226,0,-226
25062,1,0,74,0,-74
25063,0,0,95,0,-95
25064,1,0,95,0,-95
25065,0,0,75,0,-75
25066,1,0,20,0,-20
25067,0,0,2,0,-2
25068,1,0,2,0,-2
25069,1,0,1,0,-1
25070,1,1,223,1328,1105
25071,1,1,880,1469,589
25072,0,0,191,0,-191
25073,0,0,8,0,-8
25074,0,0,149,0,-149
25075,0,0,9,0,-9
25076,0,0,14,0,-14
25077,0,0,7,0,-7
25078,1,0,25,0,-25
25079,1,1,222,1464,1242
25080,1,0,16,0,-16
25081,1,0,0,0,0
25082,1,0,51,0,-51
25083,1,1,118,1465,1347
25084,1,0,47,0,-47
25085,1,0,49,0,-49
25086,0,0,33,0,-33
25087,0,0,55,0,-55
25088,0,0,54,0,-54
25089,1,1,865,1315,450
25090,0,0,43,0,-43
25091,1,0,6,0,-6
25092,1,0,3,0,-3
25093,1,0,68,0,-68
25094,1,1,675,1212,537
25095,1,1,149,3333,3184
25096,0,0,139,0,-139
25097,1,1,363,1408,1045
25098,1,0,72,0,-72
25099,0,0,49,0,-49
25100,1,0,13,0,-13
25101,0,0,0,0,0
25102,0,0,34,0,-34
25103,0,0,20,0,-20
25104,1,1,38,1407,1369
25105,1,0,1,0,-1
25106,0,0,20,0,-20
25107,1,0,32,0,-32
25108,1,0,62,0,-62
25109,1,0,66,0,-66
25110,1,0,23,0,-23
25111,1,0,42,0,-42
25112,0,0,10,0,-10
25113,0,0,8,0,-8
25114,1,1,63,1774,1711
25115,1,1,57,1258,1201
25116,0,0,54,0,-54
25117,0,0,182,0,-182
25118,0,0,48,0,-48
25119,0,0,78,0,-78
25120,0,0,0,0,0
25121,1,0,11,0,-11
25122,1,0,142,0,-142
25123,1,1,154,1821,1667
25124,1,0,102,0,-102
25125,0,0,400,0,-400
25126,0,0,153,0,-153
25127,1,0,3,0,-3
25128,1,0,34,0,-34
25129,1,1,123,2835,2712
25130,1,1,900,1350,450
25131,1,0,7,0,-7
25132,1,0,14,0,-14
25133,0,0,18,0,-18
25134,1,0,3,0,-3
25135,0,0,19,0,-19
25136,0,0,3,0,-3
25137,1,0,99,0,-99
25138,1,0,38,0,-38
25139,1,0,10,0,-10
25140,0,0,1,0,-1
25141,0,0,52,0,-52
25142,0,0,20,0,-20
25143,0,0,12,0,-12
25144,1,0,43,0,-43
25145,0,0,14,0,-14
25146,1,1,426,1537,1111
25147,1,1,680,2000,1320
25148,1,1,109,1658,1549
25149,0,0,114,0,-114
25150,1,1,37,1429,1392
25151,1,0,296,0,-296
25152,0,0,75,0,-75
25153,0,0,37,0,-37
25154,1,0,77,0,-77
25155,1,0,20,0,-20
25156,1,1,999,1278,279
25157,1,0,57,0,-57
25158,0,0,52,0,-52
25159,1,1,229,2128,1899
25160,1,0,14,0,-14
25161,1,0,24,0,-24
25162,1,0,88,0,-88
25163,1,1,853,1462,609
25164,0,0,33,0,-33
25165,1,0,30,0,-30
25166,0,0,41,0,-41
25167,0,0,4,0,-4
25168,1,1,986,1324,338
25169,0,0,202,0,-202
25170,1,1,135,1649,1514
25171,1,0,24,0,-24
25172,0,0,4,0,-4
25173,0,0,22,0,-22
25174,0,0,28,0,-28
25175,1,1,835,1638,803
25176,1,0,97,0,-97
25177,0,0,237,0,-237
25178,1,0,8,0,-8
25179,0,0,2,0,-2
25180,1,0,17,0,-17
25181,1,1,348,1224,876
25182,1,1,284,1556,1272
25183,0,0,10,0,-10
25184,1,1,254,1200,946
25185,1,0,32,0,-32
25186,0,0,43,0,-43
25187,0,0,53,0,-53
25188,1,0,35,0,-35
25189,1,1,339,1216,877
25190,0,0,182,0,-182
25191,0,0,4,0,-4
25192,1,1,162,1291,1129
25193,1,1,773,1301,528
25194,0,0,25,0,-25
25195,0,0,228,0,-228
25196,1,1,1601,1329,-272
25197,1,1,768,1601,833
25198,1,0,19,0,-19
25199,1,0,49,0,-49
25200,0,0,12,0,-12
25201,0,0,34,0,-34
25202,1,1,660,1454,794
25203,1,1,173,1501,1328
25204,1,1,1080,1285,205
25205,0,0,17,0,-17
25206,1,1,869,2272,1403
25207,0,0,171,0,-171
25208,0,0,3,0,-3
25209,1,0,33,0,-33
25210,1,0,187,0,-187
25211,1,1,299,1411,1112
25212,1,1,1842,1469,-373
25213,1,0,88,0,-88
25214,1,0,16,0,-16
25215,1,0,78,0,-78
25216,0,0,1,0,-1
25217,1,0,27,0,-27
25218,0,0,158,0,-158
25219,1,0,42,0,-42
25220,0,0,12,0,-12
25221,0,0,66,0,-66
25222,0,0,37,0,-37
25223,1,1,282,3356,3074
25224,1,0,18,0,-18
25225,0,0,161,0,-161
25226,1,1,1241,1227,-14
25227,1,1,349,1248,899
25228,0,0,20,0,-20
25229,1,1,70,1438,1368
25230,1,1,643,1380,737
25231,1,0,87,0,-87
25232,0,0,101,0,-101
25233,1,1,761,1207,446
25234,0,0,182,0,-182
25235,1,1,1856,1772,-84
25236,0,0,2,0,-2
25237,0,0,51,0,-51
25238,1,1,181,1203,1022
25239,0,0,79,0,-79
25240,0,0,45,0,-45
25241,1,1,286,1438,1152
25242,1,1,311,1208,897
25243,1,0,33,0,-33
25244,0,0,30,0,-30
25245,1,1,1093,2174,1081
25246,1,0,17,0,-17
25247,1,0,9,0,-9
25248,1,0,40,0,-40
25249,1,0,11,0,-11
25250,0,0,5,0,-5
25251,1,0,13,0,-13
25252,0,0,23,0,-23
25253,0,0,27,0,-27
25254,0,0,35,0,-35
25255,1,1,757,1321,564
25256,1,1,1480,1575,95
25257,0,0,45,0,-45
25258,0,0,16,0,-16
25259,1,1,605,1384,779
25260,1,1,69,1328,1259
25261,1,1,463,1740,1277
25262,1,1,909,1438,529
25263,1,0,42,0,-42
25264,1,0,188,0,-188
25265,1,0,8,0,-8
25266,0,0,13,0,-13
25267,1,1,533,1354,821
25268,1,0,12,0,-12
25269,0,0,25,0,-25
25270,1,0,127,0,-127
25271,0,0,4,0,-4
25272,0,0,5,0,-5
25273,1,1,361,1385,1024
25274,1,1,486,2864,2378
25275,0,0,40,0,-40
25276,1,1,960,1396,436
25277,1,0,78,0,-78
25278,0,0,3,0,-3
25279,0,0,99,0,-99
25280,1,1,228,1372,1144
25281,0,0,15,0,-15
25282,0,0,13,0,-13
25283,0,0,147,0,-147
25284,1,1,736,1364,628
25285,0,0,7,0,-7
25286,1,0,3,0,-3
25287,1,0,24,0,-24
25288,1,1,104,1367,1263
25289,1,0,37,0,-37
25290,1,0,8,0,-8
25291,0,0,141,0,-141
25292,0,0,65,0,-65
25293,0,0,14,0,-14
25294,0,0,14,0,-14
25295,0,0,36,0,-36
25296,1,1,65,1233,1168
25297,1,1,106,1447,1341
25298,0,0,1,0,-1
25299,0,0,41,0,-41
25300,0,0,15,0,-15
25301,0,0,50,0,-50
25302,1,1,1017,1348,331
25303,0,0,144,0,-144
25304,1,1,1154,1558,404
25305,0,0,93,0,-93
25306,1,0,45,0,-45
25307,1,1,441,1701,1260
25308,1,0,4,0,-4
25309,0,0,79,0,-79
25310,1,0,49,0,-49
25311,0,0,34,0,-34
25312,1,1,520,1572,1052
25313,1,0,13,0,-13
25314,1,1,930,1257,327
25315,1,1,74,1663,1589
25316,0,0,12,0,-12
25317,0,0,75,0,-75
25318,1,0,23,0,-23
25319,1,1,193,1323,1130
25320,0,0,9,0,-9
25321,0,0,15,0,-15
25322,0,0,2,0,-2
25323,1,1,219,2964,2745
25324,1,1,18,1520,1502
25325,0,0,41,0,-41
25326,0,0,17,0,-17
25327,1,0,117,0,-117
25328,1,1,1440,2452,1012
25329,0,0,17,0,-17
25330,1,1,1006,1466,460
25331,1,1,165,2955,2790
25332,1,1,1012,1540,528
25333,1,0,112,0,-112
25334,0,0,14,0,-14
25335,1,0,170,0,-170
25336,0,0,39,0,-39
25337,1,1,421,1273,852
25338,1,0,25,0,-25
25339,1,1,1506,1290,-216
25340,1,1,562,2656,2094
25341,1,1,1045,1441,396
25342,1,0,65,0,-65
25343,0,0,9,0,-9
25344,1,0,31,0,-31
25345,1,1,833,2099,1266
25346,1,1,610,1487,877
25347,0,0,20,0,-20
25348,1,0,26,0,-26
25349,1,1,279,1930,1651
25350,1,1,229,1484,1255
25351,0,0,35,0,-35
25352,0,0,28,0,-28
25353,0,0,20,0,-20
25354,1,1,118,1205,1087
25355,1,1,188,2231,2043
25356,0,0,66,0,-66
25357,0,0,10,0,-10
25358,1,0,1,0,-1
25359,0,0,94,0,-94
25360,1,1,341,1643,1302
25361,1,0,24,0,-24
25362,0,0,257,0,-257
25363,1,1,220,1701,1481
25364,0,0,30,0,-30
25365,1,1,1307,1798,491
25366,1,0,100,0,-100
25367,1,1,45,1496,1451
25368,0,0,68,0,-68
25369,1,0,12,0,-12
25370,0,0,44,0,-44
25371,1,0,15,0,-15
25372,0,0,29,0,-29
25373,0,0,3,0,-3
25374,0,0,39,0,-39
25375,1,0,42,0,-42
25376,0,0,6,0,-6
25377,1,1,739,1744,1005
25378,1,0,29,0,-29
25379,1,0,33,0,-33
25380,1,0,26,0,-26
25381,0,0,22,0,-22
25382,0,0,78,0,-78
25383,0,0,206,0,-206
25384,1,1,465,1505,1040
25385,1,0,30,0,-30
25386,1,1,171,2198,2027
25387,1,0,18,0,-18
25388,1,1,178,1466,1288
25389,1,1,545,1613,1068
25390,0,0,53,0,-53
25391,1,0,57,0,-57
25392,0,0,162,0,-162
25393,0,0,62,0,-62
25394,0,0,51,0,-51
25395,1,1,1098,1675,577
25396,1,1,126,1391,1265
25397,0,0,28,0,-28
25398,1,0,27,0,-27
25399,0,0,83,0,-83
25400,1,1,126,2035,1909
25401,1,1,578,1250,672
25402,0,0,0,0,0
25403,0,0,27,0,-27
25404,0,0,14,0,-14
25405,1,1,1080,1342,262
25406,1,1,262,1708,1446
25407,0,0,13,0,-13
25408,1,0,63,0,-63
25409,0,0,17,0,-17
25410,0,0,171,0,-171
25411,0,0,59,0,-59
25412,1,0,1,0,-1
25413,0,0,35,0,-35
25414,1,0,101,0,-101
25415,0,0,3,0,-3
25416,1,1,85,1305,1220
25417,1,1,1172,1430,258
25418,1,1,112,1392,1280
25419,1,1,183,1746,1563
25420,0,0,19,0,-19
25421,1,1,275,1270,995
25422,0,0,101,0,-101
25423,0,0,13,0,-13
25424,1,1,556,1805,1249
25425,1,1,2480,1527,-953
25426,1,1,323,2871,2548
25427,0,0,103,0,-103
25428,0,0,94,0,-94
25429,0,0,145,0,-145
25430,1,0,6,0,-6
25431,1,1,2556,1534,-1022
25432,1,1,83,1325,1242
25433,0,0,17,0,-17
25434,1,0,140,0,-140
25435,1,1,94,1343,1249
25436,0,0,4,0,-4
25437,1,1,884,1281,397
25438,1,1,149,1266,1117
25439,0,0,25,0,-25
25440,1,1,642,1457,815
25441,0,0,66,0,-66
25442,0,0,7,0,-7
25443,1,0,90,0,-90
25444,1,0,14,0,-14
25445,0,0,126,0,-126
25446,0,0,12,0,-12
25447,1,0,85,0,-85
25448,0,0,103,0,-103
25449,1,0,32,0,-32
25450,1,0,23,0,-23
25451,1,0,91,0,-91
25452,1,1,243,2890,2647
25453,0,0,62,0,-62
25454,0,0,109,0,-109
25455,0,0,124,0,-124
25456,1,0,45,0,-45
25457,0,0,14,0,-14
25458,1,1,278,1420,1142
25459,1,0,11,0,-11
25460,1,0,66,0,-66
25461,1,0,108,0,-108
25462,1,1,1296,1760,464
25463,1,0,8,0,-8
25464,1,0,48,0,-48
25465,1,1,332,1410,1078
25466,0,0,22,0,-22
25467,0,0,8,0,-8
25468,0,0,121,0,-121
25469,0,0,38,0,-38
25470,1,1,465,1242,777
25471,1,1,134,1218,1084
25472,0,0,31,0,-31
25473,1,0,37,0,-37
25474,0,0,22,0,-22
25475,1,0,333,0,-333
25476,1,1,142,1439,1297
25477,0,0,30,0,-30
25478,0,0,58,0,-58
25479,1,1,960,1285,325
25480,0,0,0,0,0
25481,1,0,13,0,-13
25482,1,0,94,0,-94
25483,1,1,1991,2980,989
25484,1,1,396,1287,891
25485,0,0,132,0,-132
25486,1,1,186,1496,1310
25487,1,0,19,0,-19
25488,1,0,21,0,-21
25489,1,1,43,1275,1232
25490,1,0,30,0,-30
25491,1,1,139,1604,1465
25492,0,0,20,0,-20
25493,1,1,465,1260,795
25494,0,0,66,0,-66
25495,0,0,32,0,-32
25496,1,1,1408,1442,34
25497,1,1,100,1476,1376
25498,0,0,42,0,-42
25499,0,0,105,0,-105
25500,1,1,602,1772,1170
25501,0,0,1,0,-1
25502,0,0,163,0,-163
25503,1,0,18,0,-18
25504,1,1,964,1617,653
25505,1,0,231,0,-231
25506,1,0,201,0,-201
25507,1,0,58,0,-58
25508,1,0,1,0,-1
25509,0,0,14,0,-14
25510,1,0,80,0,-80
25511,1,1,444,1245,801
25512,0,0,40,0,-40
25513,1,1,40,1406,1366
25514,0,0,121,0,-121
25515,0,0,128,0,-128
25516,1,1,322,1426,1104
25517,0,0,2,0,-2
25518,1,1,258,1733,1475
25519,1,0,33,0,-33
25520,0,0,29,0,-29
25521,0,0,4,0,-4
25522,1,1,915,1213,298
25523,0,0,55,0,-55
25524,0,0,15,0,-15
25525,0,0,33,0,-33
25526,1,1,846,1591,745
25527,0,0,11,0,-11
25528,1,1,478,1303,825
25529,0,0,69,0,-69
25530,0,0,130,0,-130
25531,1,0,36,0,-36
25532,0,0,32,0,-32
25533,1,1,578,1939,1361
25534,0,0,13,0,-13
25535,0,0,13,0,-13
25536,1,0,16,0,-16
25537,0,0,15,0,-15
25538,0,0,38,0,-38
25539,1,1,71,2461,2390
25540,1,1,146,1219,1073
25541,0,0,7,0,-7
25542,1,0,68,0,-68
25543,0,0,15,0,-15
25544,0,0,67,0,-67
25545,1,1,77,1633,1556
25546,0,0,70,0,-70
25547,1,1,127,1456,1329
25548,1,1,259,1251,992
25549,1,1,135,1560,1425
25550,1,0,7,0,-7
25551,1,0,13,0,-13
25552,0,0,6,0,-6
25553,0,0,195,0,-195
25554,1,0,34,0,-34
25555,0,0,39,0,-39
25556,0,0,213,0,-213
25557,0,0,18,0,-18
25558,1,0,164,0,-164
25559,0,0,6,0,-6
25560,1,1,566,1339,773
25561,0,0,34,0,-34
25562,1,1,1959,1211,-748
25563,1,1,668,1253,585
25564,1,0,112,0,-112
25565,1,1,90,1615,1525
25566,1,1,128,1442,1314
25567,1,0,8,0,-8
25568,1,1,260,1334,1074
25569,1,1,708,1540,832
25570,0,0,58,0,-58
25571,0,0,16,0,-16
25572,1,0,5,0,-5
25573,1,0,183,0,-183
25574,1,1,171,1763,1592
25575,0,0,21,0,-21
25576,1,0,46,0,-46
25577,1,0,15,0,-15
25578,0,0,67,0,-67
25579,0,0,14,0,-14
25580,0,0,57,0,-57
25581,1,0,98,0,-98
25582,0,0,25,0,-25
25583,1,0,45,0,-45
25584,0,0,19,0,-19
25585,1,1,151,1402,1251
25586,0,0,90,0,-90
25587,1,0,4,0,-4
25588,1,1,83,1458,1375
25589,1,0,50,0,-50
25590,1,1,217,1210,993
25591,0,0,7,0,-7
25592,1,0,9,0,-9
25593,1,0,61,0,-61
25594,1,1,660,1462,802
25595,1,1,980,1309,329
25596,0,0,7,0,-7
25597,1,0,62,0,-62
25598,1,0,23,0,-23
25599,1,0,14,0,-14
25600,0,0,67,0,-67
25601,1,1,379,1334,955
25602,0,0,11,0,-11
25603,1,0,17,0,-17
25604,1,1,1652,1683,31
25605,0,0,20,0,-20
25606,0,0,23,0,-23
25607,1,0,194,0,-194
25608,0,0,121,0,-121
25609,1,1,726,1709,983
25610,1,0,26,0,-26
25611,0,0,55,0,-55
25612,1,1,412,1202,790
25613,0,0,63,0,-63
25614,1,0,24,0,-24
25615,0,0,76,0,-76
25616,1,1,681,1304,623
25617,1,1,1345,1986,641
25618,1,1,625,1383,758
25619,1,0,17,0,-17
25620,1,1,919,1614,695
25621,1,1,472,1341,869
25622,1,0,38,0,-38
25623,1,0,27,0,-27
25624,1,0,50,0,-50
25625,0,0,53,0,-53
25626,1,0,97,0,-97
25627,1,1,26,1303,1277
25628,1,1,191,1273,1082
25629,1,1,595,1403,808
25630,0,0,181,0,-181
25631,0,0,78,0,-78
25632,0,0,51,0,-51
25633,0,0,22,0,-22
25634,1,1,199,1226,1027
25635,0,0,25,0,-25
25636,1,0,108,0,-108
25637,0,0,5,0,-5
25638,1,0,0,0,0
25639,1,1,1496,1997,501
25640,1,0,7,0,-7
25641,0,0,2,0,-2
25642,1,0,14,0,-14
25643,1,1,874,2070,1196
25644,1,0,118,0,-118
25645,1,0,78,0,-78
25646,0,0,65,0,-65
25647,0,0,27,0,-27
25648,1,0,70,0,-70
25649,0,0,32,0,-32
25650,1,0,31,0,-31
25651,0,0,141,0,-141
25652,1,0,23,0,-23
25653,1,1,164,1222,1058
25654,1,1,161,2053,1892
25655,1,1,476,1762,1286
25656,1,0,48,0,-48
25657,0,0,75,0,-75
25658,1,0,46,0,-46
25659,0,0,3,0,-3
25660,1,1,851,1275,424
25661,1,0,65,0,-65
25662,1,1,225,1203,978
25663,1,0,13,0,-13
25664,1,1,99,1605,1506
25665,1,0,79,0,-79
25666,1,0,149,0,-149
25667,1,1,329,1500,1171
25668,0,0,10,0,-10
25669,0,0,16,0,-16
25670,0,0,20,0,-20
25671,0,0,18,0,-18
25672,0,0,17,0,-17
25673,0,0,7,0,-7
25674,0,0,18,0,-18
25675,1,0,21,0,-21
25676,0,0,3,0,-3
25677,1,0,84,0,-84
25678,1,1,456,1277,821
25679,1,1,581,2729,2148
25680,1,0,204,0,-204
25681,1,1,181,1398,1217
25682,0,0,43,0,-43
25683,1,1,280,1416,1136
25684,1,1,53,1246,1193
25685,1,0,83,0,-83
25686,1,1,708,1470,762
25687,0,0,16,0,-16
25688,0,0,23,0,-23
25689,1,0,87,0,-87
25690,1,1,1355,1567,212
25691,0,0,114,0,-114
25692,0,0,3,0,-3
25693,1,0,32,0,-32
25694,0,0,37,0,-37
25695,1,1,143,1203,1060
25696,0,0,54,0,-54
25697,1,1,1252,1341,89
25698,1,0,153,0,-153
25699,1,1,371,1769,1398
25700,0,0,16,0,-16
25701,1,0,64,0,-64
25702,1,1,151,1250,1099
25703,0,0,32,0,-32
25704,1,1,164,1889,1725
25705,0,0,61,0,-61
25706,1,0,24,0,-24
25707,1,1,204,1613,1409
25708,1,0,4,0,-4
25709,1,0,24,0,-24
25710,0,0,229,0,-229
25711,1,1,163,1399,1236
25712,1,0,0,0,0
25713,0,0,74,0,-74
25714,1,1,1311,1626,315
25715,1,1,415,1257,842
25716,1,1,113,1377,1264
25717,1,1,464,1369,905
25718,1,0,27,0,-27
25719,1,0,20,0,-20
25720,0,0,24,0,-24
25721,1,0,66,0,-66
25722,0,0,2,0,-2
25723,1,0,69,0,-69
25724,0,0,48,0,-48
25725,1,1,225,1323,1098
25726,0,0,168,0,-168
25727,0,0,24,0,-24
25728,0,0,40,0,-40
25729,1,1,659,1370,711
25730,1,0,17,0,-17
25731,1,0,108,0,-108
25732,0,0,16,0,-16
25733,0,0,29,0,-29
25734,1,0,54,0,-54
25735,0,0,9,0,-9
25736,1,0,24,0,-24
25737,1,1,78,1248,1170
25738,0,0,35,0,-35
25739,0,0,12,0,-12
25740,0,0,29,0,-29
25741,1,1,302,2186,1884
25742,0,0,3,0,-3
25743,1,0,11,0,-11
25744,0,0,2,0,-2
25745,1,0,76,0,-76
25746,1,0,20,0,-20
25747,0,0,12,0,-12
25748,1,0,122,0,-122
25749,1,0,5,0,-5
25750,0,0,49,0,-49
25751,1,1,165,1250,1085
25752,1,1,746,1265,519
25753,1,1,106,1879,1773
25754,1,1,153,1584,1431
25755,1,0,34,0,-34
25756,0,0,46,0,-46
25757,0,0,21,0,-21
25758,1,0,31,0,-31
25759,1,0,58,0,-58
25760,1,0,19,0,-19
25761,0,0,43,0,-43
25762,0,0,109,0,-109
25763,0,0,12,0,-12
25764,0,0,13,0,-13
25765,1,0,1,0,-1
25766,1,1,734,1697,963
25767,0,0,40,0,-40
25768,0,0,113,0,-113
25769,0,0,123,0,-123
25770,1,1,118,1238,1120
25771,1,1,854,1302,448
25772,1,1,43,1514,1471
25773,1,0,30,0,-30
25774,1,0,24,0,-24
25775,0,0,22,0,-22
25776,1,1,1573,1395,-178
25777,1,0,0,0,0
25778,1,0,24,0,-24
25779,0,0,7,0,-7
25780,1,1,313,1236,923
25781,1,0,54,0,-54
25782,0,0,143,0,-143
25783,1,0,3,0,-3
25784,1,1,560,1207,647
25785,1,1,469,1413,944
25786,1,1,165,1860,1695
25787,1,0,31,0,-31
25788,1,1,455,1294,839
25789,1,0,31,0,-31
25790,1,0,48,0,-48
25791,0,0,15,0,-15
25792,1,0,7,0,-7
25793,1,0,52,0,-52
25794,1,1,329,1510,1181
25795,1,1,959,2416,1457
25796,0,0,71,0,-71
25797,1,0,56,0,-56
25798,1,1,414,1716,1302
25799,1,0,82,0,-82
25800,1,1,915,1459,544
25801,0,0,70,0,-70
25802,1,1,1522,1540,18
25803,1,1,386,1661,1275
25804,1,1,899,2231,1332
25805,1,0,57,0,-57
25806,0,0,193,0,-193
25807,1,1,245,1709,1464
25808,1,1,42,1267,1225
25809,0,0,29,0,-29
25810,0,0,120,0,-120
25811,1,0,177,0,-177
25812,0,0,2,0,-2
25813,1,0,63,0,-63
25814,1,0,27,0,-27
25815,0,0,113,0,-113
25816,0,0,17,0,-17
25817,1,0,5,0,-5
25818,1,0,66,0,-66
25819,1,1,132,1431,1299
25820,1,0,56,0,-56
25821,0,0,72,0,-72
25822,1,1,371,1362,991
25823,1,0,6,0,-6
25824,1,0,28,0,-28
25825,1,0,42,0,-42
25826,1,0,48,0,-48
25827,0,0,245,0,-245
25828,1,1,273,1455,1182
25829,0,0,197,0,-197
25830,1,1,667,2259,1592
25831,1,1,221,1376,1155
25832,1,1,387,3066,2679
25833,1,1,245,1529,1284
25834,0,0,10,0,-10
25835,0,0,14,0,-14
25836,0,0,137,0,-137
25837,0,0,9,0,-9
25838,1,0,102,0,-102
25839,0,0,44,0,-44
25840,1,0,0,0,0
25841,1,0,5,0,-5
25842,0,0,31,0,-31
25843,1,0,36,0,-36
25844,0,0,24,0,-24
25845,0,0,31,0,-31
25846,1,1,890,1236,346
25847,1,0,16,0,-16
25848,1,0,50,0,-50
25849,0,0,37,0,-37
25850,0,0,113,0,-113
25851,1,1,1888,1330,-558
25852,1,0,21,0,-21
25853,0,0,37,0,-37
25854,1,1,315,1466,1151
25855,1,0,81,0,-81
25856,1,0,54,0,-54
25857,1,0,108,0,-108
25858,1,0,29,0,-29
25859,1,1,514,1333,819
25860,1,0,52,0,-52
25861,1,0,73,0,-73
25862,1,0,46,0,-46
25863,1,1,25,1370,1345
25864,1,1,460,1214,754
25865,1,0,18,0,-18
25866,1,0,37,0,-37
25867,0,0,92,0,-92
25868,1,1,203,1213,1010
25869,1,1,833,1328,495
25870,0,0,38,0,-38
25871,1,1,2549,1422,-1127
25872,1,1,144,1208,1064
25873,1,0,25,0,-25
25874,0,0,148,0,-148
25875,0,0,25,0,-25
25876,1,1,240,1873,1633
25877,1,0,33,0,-33
25878,0,0,70,0,-70
25879,0,0,12,0,-12
25880,0,0,45,0,-45
25881,0,0,30,0,-30
25882,0,0,23,0,-23
25883,0,0,51,0,-51
25884,0,0,32,0,-32
25885,0,0,115,0,-115
25886,1,1,840,1267,427
25887,0,0,43,0,-43
25888,0,0,24,0,-24
25889,1,1,525,1304,779
25890,0,0,16,0,-16
25891,1,1,1258,1532,274
25892,0,0,37,0,-37
25893,0,0,1,0,-1
25894,1,0,28,0,-28
25895,0,0,83,0,-83
25896,1,1,1622,1245,-377
25897,1,0,77,0,-77
25898,1,0,35,0,-35
25899,1,0,1,0,-1
25900,0,0,34,0,-34
25901,0,0,33,0,-33
25902,1,0,57,0,-57
25903,0,0,58,0,-58
25904,1,0,29,0,-29
25905,1,1,350,2846,2496
25906,0,0,17,0,-17
25907,1,1,13,1763,1750
25908,1,1,274,1360,1086
25909,1,0,36,0,-36
25910,1,0,14,0,-14
25911,1,0,36,0,-36
25912,0,0,31,0,-31
25913,0,0,9,0,-9
25914,1,0,42,0,-42
25915,1,1,101,1228,1127
25916,1,0,48,0,-48
25917,1,1,687,1802,1115
25918,1,0,106,0,-106
25919,0,0,40,0,-40
25920,1,0,52,0,-52
25921,0,0,55,0,-55
25922,0,0,44,0,-44
25923,1,0,23,0,-23
25924,1,0,10,0,-10
25925,1,0,49,0,-49
25926,0,0,79,0,-79
25927,0,0,9,0,-9
25928,1,1,103,1316,1213
25929,1,1,131,1528,1397
25930,1,1,186,1413,1227
25931,1,1,242,1435,1193
25932,1,1,1285,1289,4
25933,0,0,160,0,-160
25934,0,0,20,0,-20
25935,0,0,53,0,-53
25936,1,1,15,1282,1267
25937,1,0,136,0,-136
25938,0,0,105,0,-105
25939,1,1,985,1238,253
25940,1,0,43,0,-43
25941,0,0,42,0,-42
25942,0,0,124,0,-124
25943,1,1,610,2433,1823
25944,1,1,347,1717,1370
25945,0,0,140,0,-140
25946,0,0,55,0,-55
25947,0,0,17,0,-17
25948,1,0,2,0,-2
25949,0,0,11,0,-11
25950,0,0,11,0,-11
25951,0,0,4,0,-4
25952,0,0,81,0,-81
25953,0,0,46,0,-46
25954,1,0,26,0,-26
25955,1,1,125,1358,1233
25956,0,0,52,0,-52
25957,1,1,166,1375,1209
25958,1,1,325,1330,1005
25959,0,0,81,0,-81
25960,0,0,5,0,-5
25961,1,0,203,0,-203
25962,0,0,142,0,-142
25963,0,0,5,0,-5
25964,0,0,96,0,-96
25965,0,0,54,0,-54
25966,0,0,122,0,-122
25967,0,0,53,0,-53
25968,1,1,417,1435,1018
25969,1,0,92,0,-92
25970,1,0,1,0,-1
25971,0,0,47,0,-47
25972,1,0,47,0,-47
25973,1,0,136,0,-136
25974,1,0,34,0,-34
25975,0,0,58,0,-58
25976,1,1,342,1893,1551
25977,0,0,69,0,-69
25978,1,1,223,1588,1365
25979,1,0,156,0,-156
25980,1,1,811,1615,804
25981,0,0,40,0,-40
25982,1,1,534,1562,1028
25983,1,1,269,1578,1309
25984,0,0,11,0,-11
25985,1,0,18,0,-18
25986,1,0,13,0,-13
25987,1,0,1,0,-1
25988,1,1,334,1282,948
25989,1,0,17,0,-17
25990,1,0,18,0,-18
25991,1,1,370,1232,862
25992,0,0,25,0,-25
25993,0,0,14,0,-14
25994,0,0,17,0,-17
25995,0,0,88,0,-88
25996,0,0,22,0,-22
25997,1,1,919,1351,432
25998,1,1,87,1990,1903
25999,1,1,112,2887,2775
26000,1,0,61,0,-61
26001,1,1,349,1317,968
26002,1,1,1072,1748,676
26003,1,0,25,0,-25
26004,0,0,106,0,-106
26005,1,0,22,0,-22
26006,0,0,3,0,-3
26007,1,1,1143,1713,570
26008,1,0,17,0,-17
26009,1,0,18,0,-18
26010,1,1,55,1903,1848
26011,1,0,2,0,-2
26012,0,0,124,0,-124
26013,0,0,72,0,-72
26014,1,1,272,1239,967
26015,1,1,152,1602,1450
26016,1,1,973,1205,232
26017,0,0,213,0,-213
26018,1,1,1896,1336,-560
26019,0,0,1,0,-1
26020,1,1,1294,1547,253
26021,1,1,425,1386,961
26022,1,1,483,1370,887
26023,1,0,20,0,-20
26024,0,0,280,0,-280
26025,0,0,18,0,-18
26026,1,1,441,1247,806
26027,1,1,1681,1477,-204
26028,1,1,305,1285,980
26029,0,0,56,0,-56
26030,0,0,1,0,-1
26031,0,0,102,0,-102
26032,0,0,7,0,-7
26033,0,0,14,0,-14
26034,0,0,27,0,-27
26035,0,0,25,0,-25
26036,1,0,19,0,-19
26037,1,0,51,0,-51
26038,1,1,598,1326,728
26039,1,1,1239,1624,385
26040,1,0,28,0,-28
26041,1,1,35,2269,2234
26042,1,1,302,1234,932
26043,1,0,30,0,-30
26044,1,0,14,0,-14
26045,0,0,55,0,-55
26046,0,0,47,0,-47
26047,1,0,1,0,-1
26048,0,0,50,0,-50
26049,0,0,113,0,-113
26050,0,0,6,0,-6
26051,1,1,45,2097,2052
26052,0,0,30,0,-30
26053,1,0,58,0,-58
26054,0,0,33,0,-33
26055,0,0,88,0,-88
26056,0,0,18,0,-18
26057,0,0,177,0,-177
26058,0,0,3,0,-3
26059,1,1,1084,1266,182
26060,0,0,60,0,-60
26061,1,0,35,0,-35
26062,0,0,137,0,-137
26063,0,0,71,0,-71
26064,1,1,2015,1320,-695
26065,0,0,40,0,-40
26066,0,0,45,0,-45
26067,1,0,24,0,-24
26068,1,0,95,0,-95
26069,1,0,3,0,-3
26070,1,0,160,0,-160
26071,0,0,138,0,-138
26072,1,0,47,0,-47
26073,1,1,718,1241,523
26074,1,0,17,0,-17
26075,0,0,6,0,-6
26076,1,0,19,0,-19
26077,1,0,10,0,-10
26078,1,1,369,1540,1171
26079,1,0,75,0,-75
26080,1,0,50,0,-50
26081,1,0,20,0,-20
26082,1,1,134,1261,1127
26083,0,0,192,0,-192
26084,0,0,9,0,-9
26085,0,0,20,0,-20
26086,0,0,50,0,-50
26087,1,0,12,0,-12
26088,1,0,54,0,-54
26089,1,1,9,1254,1245
26090,0,0,6,0,-6
26091,1,1,460,1222,762
26092,0,0,5,0,-5
26093,0,0,75,0,-75
26094,1,1,852,1433,581
26095,1,0,79,0,-79
26096,0,0,26,0,-26
26097,0,0,27,0,-27
26098,1,1,82,1374,1292
26099,1,0,13,0,-13
26100,0,0,1,0,-1
26101,1,0,127,0,-127
26102,1,0,51,0,-51
26103,1,0,59,0,-59
26104,1,0,6,0,-6
26105,1,0,43,0,-43
26106,0,0,11,0,-11
26107,1,1,258,1881,1623
26108,1,1,196,1439,1243
26109,0,0,65,0,-65
26110,1,1,363,1724,1361
26111,1,0,39,0,-39
26112,1,0,10,0,-10
26113,0,0,9,0,-9
26114,1,1,126,1464,1338
26115,1,1,21,1242,1221
26116,0,0,110,0,-110
26117,1,0,33,0,-33
26118,1,0,48,0,-48
26119,1,1,41,1335,1294
26120,0,0,106,0,-106
26121,1,1,97,1210,1113
26122,1,0,41,0,-41
26123,1,0,1,0,-1
26124,0,0,66,0,-66
26125,0,0,17,0,-17
26126,1,1,1265,1299,34
26127,1,1,805,1552,747
26128,1,0,12,0,-12
26129,1,1,209,2129,1920
26130,1,1,261,2541,2280
26131,0,0,6,0,-6
26132,0,0,50,0,-50
26133,0,0,4,0,-4
26134,1,1,2364,2006,-358
26135,0,0,0,0,0
26136,0,0,46,0,-46
26137,1,1,1917,2290,373
26138,0,0,16,0,-16
26139,0,0,71,0,-71
26140,1,1,617,1523,906
26141,1,0,46,0,-46
26142,0,0,64,0,-64
26143,1,1,861,1433,572
26144,1,0,80,0,-80
26145,0,0,12,0,-12
26146,1,1,212,1271,1059
26147,1,0,52,0,-52
26148,1,1,492,1821,1329
26149,0,0,53,0,-53
26150,1,0,33,0,-33
26151,1,1,240,1239,999
26152,0,0,44,0,-44
26153,1,0,22,0,-22
26154,0,0,65,0,-65
26155,0,0,31,0,-31
26156,0,0,6,0,-6
26157,1,1,216,1376,1160
26158,0,0,149,0,-149
26159,1,1,739,1287,548
26160,1,1,96,1248,1152
26161,0,0,17,0,-17
26162,0,0,7,0,-7
26163,1,0,46,0,-46
26164,0,0,74,0,-74
26165,0,0,40,0,-40
26166,0,0,33,0,-33
26167,1,1,25,1234,1209
26168,1,1,69,1550,1481
26169,0,0,54,0,-54
26170,0,0,49,0,-49
26171,1,0,48,0,-48
26172,1,0,33,0,-33
26173,1,1,274,1491,1217
26174,1,1,115,1566,1451
26175,0,0,1,0,-1
26176,1,0,23,0,-23
26177,0,0,125,0,-125
26178,1,1,1381,1358,-23
26179,0,0,12,0,-12
26180,0,0,23,0,-23
26181,1,0,41,0,-41
26182,1,0,78,0,-78
26183,0,0,11,0,-11
26184,0,0,1,0,-1
26185,1,0,41,0,-41
26186,1,1,197,1436,1239
26187,0,0,30,0,-30
26188,1,0,67,0,-67
26189,1,0,0,0,0
26190,1,1,182,1272,1090
26191,1,1,987,1291,304
26192,0,0,52,0,-52
26193,1,0,48,0,-48
26194,1,0,51,0,-51
26195,1,0,79,0,-79
26196,0,0,70,0,-70
26197,0,0,106,0,-106
26198,0,0,12,0,-12
26199,1,1,1357,2185,828
26200,1,1,342,2419,2077
26201,1,0,3,0,-3
26202,1,0,0,0,0
26203,1,0,72,0,-72
26204,0,0,34,0,-34
26205,1,0,129,0,-129
26206,1,1,231,1549,1318
26207,1,1,655,1347,692
26208,0,0,9,0,-9
26209,0,0,84,0,-84
26210,0,0,69,0,-69
26211,0,0,12,0,-12
26212,1,0,56,0,-56
26213,1,0,100,0,-100
26214,1,0,14,0,-14
26215,1,0,65,0,-65
26216,1,0,53,0,-53
26217,1,0,92,0,-92
26218,1,0,6,0,-6
26219,0,0,18,0,-18
26220,1,1,817,1569,752
26221,0,0,16,0,-16
26222,0,0,3,0,-3
26223,1,0,9,0,-9
26224,1,1,558,1262,704
26225,1,1,653,1220,567
26226,1,0,101,0,-101
26227,1,1,413,1798,1385
26228,1,0,178,0,-178
26229,1,0,11,0,-11
26230,0,0,75,0,-75
26231,1,0,24,0,-24
26232,1,1,66,1403,1337
26233,0,0,7,0,-7
26234,0,0,20,0,-20
26235,1,0,27,0,-27
26236,0,0,16,0,-16
26237,0,0,89,0,-89
26238,1,1,22,1451,1429
26239,1,0,64,0,-64
26240,1,1,82,1384,1302
26241,0,0,15,0,-15
26242,0,0,169,0,-169
26243,1,0,29,0,-29
26244,1,1,363,2143,1780
26245,1,1,211,1349,1138
26246,0,0,143,0,-143
26247,1,1,295,1249,954
26248,0,0,13,0,-13
26249,1,1,139,1368,1229
26250,0,0,2,0,-2
26251,1,0,98,0,-98
26252,1,0,76,0,-76
26253,0,0,21,0,-21
26254,1,0,41,0,-41
26255,1,0,36,0,-36
26256,0,0,143,0,-143
26257,1,0,17,0,-17
26258,0,0,5,0,-5
26259,1,1,85,1661,1576
26260,1,0,72,0,-72
26261,1,1,557,1705,1148
26262,1,0,109,0,-109
26263,1,1,193,5797,5604
26264,0,0,117,0,-117
26265,0,0,5,0,-5
26266,1,1,318,1848,1530
26267,1,0,70,0,-70
26268,1,1,1044,1221,177
26269,1,0,6,0,-6
26270,0,0,148,0,-148
26271,1,0,72,0,-72
26272,0,0,36,0,-36
26273,1,0,46,0,-46
26274,1,0,57,0,-57
26275,1,1,90,1683,1593
26276,1,0,27,0,-27
26277,1,0,92,0,-92
26278,0,0,16,0,-16
26279,1,1,193,1262,1069
26280,1,1,419,1366,947
26281,0,0,0,0,0
26282,0,0,62,0,-62
26283,0,0,11,0,-11
26284,1,0,17,0,-17
26285,1,0,39,0,-39
26286,1,0,20,0,-20
26287,1,1,1956,1349,-607
26288,0,0,50,0,-50
26289,1,0,79,0,-79
26290,1,1,814,1338,524
26291,1,1,253,1218,965
26292,0,0,31,0,-31
26293,1,0,71,0,-71
26294,0,0,7,0,-7
26295,0,0,10,0,-10
26296,1,1,356,1778,1422
26297,1,0,0,0,0
26298,0,0,4,0,-4
26299,0,0,8,0,-8
26300,1,0,8,0,-8
26301,1,1,1473,1245,-228
26302,1,0,32,0,-32
26303,0,0,95,0,-95
26304,0,0,237,0,-237
26305,1,1,233,1275,1042
26306,1,1,456,1249,793
26307,0,0,25,0,-25
26308,1,1,390,2072,1682
26309,1,1,637,2145,1508
26310,0,0,91,0,-91
26311,0,0,4,0,-4
26312,0,0,28,0,-28
26313,0,0,54,0,-54
26314,1,0,39,0,-39
26315,1,1,648,1595,947
26316,1,1,921,1407,486
26317,1,1,823,1548,725
26318,0,0,21,0,-21
26319,1,1,1393,1232,-161
26320,1,1,788,1243,455
26321,1,0,27,0,-27
26322,1,1,539,1954,1415
26323,1,0,38,0,-38
26324,1,1,424,1694,1270
26325,1,0,17,0,-17
26326,0,0,31,0,-31
26327,0,0,43,0,-43
26328,0,0,6,0,-6
26329,1,0,39,0,-39
26330,1,0,1,0,-1
26331,0,0,102,0,-102
26332,1,1,2006,1309,-697
26333,1,0,82,0,-82
26334,1,1,839,1265,426
26335,1,0,52,0,-52
26336,0,0,118,0,-118
26337,0,0,91,0,-91
26338,1,1,317,1362,1045
26339,0,0,64,0,-64
26340,0,0,7,0,-7
26341,1,1,230,1795,1565
26342,1,0,7,0,-7
26343,0,0,48,0,-48
26344,0,0,29,0,-29
26345,0,0,114,0,-114
26346,0,0,54,0,-54
26347,1,0,84,0,-84
26348,1,0,1,0,-1
26349,0,0,25,0,-25
26350,1,1,165,1316,1151
26351,1,1,268,1791,1523
26352,1,0,19,0,-19
26353,0,0,88,0,-88
26354,0,0,98,0,-98
26355,0,0,43,0,-43
26356,1,1,515,1219,704
26357,1,0,1,0,-1
26358,1,1,2756,1214,-1542
26359,1,1,558,1897,1339
26360,1,1,586,1211,625
26361,0,0,27,0,-27
26362,0,0,4,0,-4
26363,1,1,50,1252,1202
26364,1,1,1029,1732,703
26365,1,1,297,1647,1350
26366,0,0,9,0,-9
26367,0,0,15,0,-15
26368,0,0,23,0,-23
26369,1,1,37,1476,1439
26370,0,0,16,0,-16
26371,0,0,50,0,-50
26372,1,1,836,1321,485
26373,1,0,19,0,-19
26374,1,1,396,1245,849
26375,1,1,247,1220,973
26376,0,0,3,0,-3
26377,1,0,46,0,-46
26378,1,0,22,0,-22
26379,1,0,74,0,-74
26380,1,0,11,0,-11
26381,0,0,20,0,-20
26382,1,1,700,1435,735
26383,1,1,1423,1238,-185
26384,0,0,3,0,-3
26385,0,0,7,0,-7
26386,0,0,45,0,-45
26387,1,1,163,1462,1299
26388,1,0,57,0,-57
26389,1,1,317,1316,999
26390,0,0,23,0,-23
26391,0,0,17,0,-17
26392,0,0,9,0,-9
26393,0,0,115,0,-115
26394,1,1,539,1321,782
26395,1,1,808,1253,445
26396,0,0,17,0,-17
26397,1,0,1,0,-1
26398,1,1,347,1270,923
26399,0,0,15,0,-15
26400,0,0,1,0,-1
26401,0,0,1,0,-1
26402,0,0,17,0,-17
26403,1,0,107,0,-107
26404,0,0,74,0,-74
26405,1,1,386,1762,1376
26406,0,0,53,0,-53
26407,1,0,6,0,-6
26408,1,0,36,0,-36
26409,1,1,58,1472,1414
26410,1,0,46,0,-46
26411,1,1,366,3420,3054
26412,0,0,77,0,-77
26413,0,0,12,0,-12
26414,1,0,2,0,-2
26415,0,0,17,0,-17
26416,0,0,8,0,-8
26417,1,1,398,1296,898
26418,1,1,1106,1208,102
26419,1,1,432,1844,1412
26420,0,0,79,0,-79
26421,0,0,42,0,-42
26422,0,0,52,0,-52
26423,1,0,26,0,-26
26424,0,0,1,0,-1
26425,1,0,15,0,-15
26426,1,1,689,1592,903
26427,1,0,114,0,-114
26428,0,0,15,0,-15
26429,0,0,25,0,-25
26430,1,0,6,0,-6
26431,1,1,19,1320,1301
26432,1,0,33,0,-33
26433,1,1,171,2175,2004
26434,1,1,727,1535,808
26435,1,0,72,0,-72
26436,1,1,149,4303,4154
26437,1,1,43,1610,1567
26438,0,0,154,0,-154
26439,0,0,20,0,-20
26440,0,0,0,0,0
26441,0,0,6,0,-6
26442,0,0,32,0,-32
26443,1,0,9,0,-9
26444,0,0,22,0,-22
26445,0,0,1,0,-1
26446,0,0,73,0,-73
26447,0,0,5,0,-5
26448,0,0,5,0,-5
26449,0,0,3,0,-3
26450,0,0,8,0,-8
26451,0,0,59,0,-59
26452,1,0,17,0,-17
26453,1,0,48,0,-48
26454,0,0,37,0,-37
26455,1,1,941,1796,855
26456,1,1,282,1288,1006
26457,0,0,1,0,-1
26458,1,1,218,1361,1143
26459,0,0,38,0,-38
26460,1,0,16,0,-16
26461,0,0,9,0,-9
26462,1,0,12,0,-12
26463,1,0,10,0,-10
26464,0,0,9,0,-9
26465,0,0,15,0,-15
26466,1,0,47,0,-47
26467,1,1,230,1668,1438
26468,0,0,9,0,-9
26469,0,0,106,0,-106
26470,1,0,67,0,-67
26471,1,0,4,0,-4
26472,1,0,58,0,-58
26473,0,0,45,0,-45
26474,1,0,53,0,-53
26475,1,1,50,1929,1879
26476,0,0,57,0,-57
26477,0,0,73,0,-73
26478,0,0,54,0,-54
26479,1,0,21,0,-21
26480,0,0,39,0,-39
26481,1,1,338,1882,1544
26482,0,0,38,0,-38
26483,0,0,0,0,0
26484,1,1,209,1273,1064
26485,1,0,41,0,-41
26486,1,1,1294,1336,42
26487,1,1,279,1246,967
26488,1,0,99,0,-99
26489,0,0,124,0,-124
26490,0,0,99,0,-99
26491,1,1,658,1325,667
26492,1,0,12,0,-12
26493,1,0,102,0,-102
26494,1,0,88,0,-88
26495,1,1,1567,1394,-173
26496,0,0,32,0,-32
26497,0,0,79,0,-79
26498,1,0,15,0,-15
26499,1,0,1,0,-1
26500,0,0,31,0,-31
26501,1,0,66,0,-66
26502,1,0,74,0,-74
26503,1,0,88,0,-88
26504,0,0,7,0,-7
26505,0,0,1,0,-1
26506,1,0,23,0,-23
26507,1,1,103,1235,1132
26508,1,1,190,1209,1019
26509,1,1,2037,1284,-753
26510,0,0,8,0,-8
26511,1,1,308,1326,1018
26512,0,0,42,0,-42
26513,0,0,141,0,-141
26514,1,1,318,1211,893
26515,1,0,18,0,-18
26516,0,0,18,0,-18
26517,0,0,7,0,-7
26518,1,0,11,0,-11
26519,1,1,424,1358,934
26520,1,0,176,0,-176
26521,1,1,1008,1487,479
26522,1,1,91,1440,1349
26523,0,0,46,0,-46
26524,0,0,84,0,-84
26525,1,1,1029,1308,279
26526,0,0,135,0,-135
26527,1,1,908,1203,295
26528,0,0,180,0,-180
26529,1,0,75,0,-75
26530,0,0,17,0,-17
26531,1,0,210,0,-210
26532,1,0,8,0,-8
26533,0,0,18,0,-18
26534,1,1,791,1367,576
26535,0,0,112,0,-112
26536,0,0,45,0,-45
26537,0,0,4,0,-4
26538,0,0,85,0,-85
26539,0,0,37,0,-37
26540,1,0,29,0,-29
26541,0,0,2,0,-2
26542,0,0,41,0,-41
26543,1,0,2,0,-2
26544,1,1,382,2287,1905
26545,0,0,17,0,-17
26546,1,1,765,1528,763
26547,1,1,203,2184,1981
26548,0,0,62,0,-62
26549,1,0,22,0,-22
26550,0,0,113,0,-113
26551,1,0,10,0,-10
26552,0,0,21,0,-21
26553,0,0,5,0,-5
26554,1,0,8,0,-8
26555,1,1,256,1253,997
26556,1,0,92,0,-92
26557,1,1,196,1233,1037
26558,0,0,74,0,-74
26559,0,0,88,0,-88
26560,1,1,141,1487,1346
26561,0,0,68,0,-68
26562,1,0,8,0,-8
26563,1,0,1,0,-1
26564,0,0,203,0,-203
26565,1,1,322,1272,950
26566,1,0,103,0,-103
26567,0,0,92,0,-92
26568,1,1,118,1247,1129
26569,1,1,739,1891,1152
26570,0,0,90,0,-90
26571,0,0,112,0,-112
26572,1,1,93,1685,1592
26573,1,0,10,0,-10
26574,1,0,8,0,-8
26575,1,1,120,1722,1602
26576,1,0,51,0,-51
26577,1,0,36,0,-36
26578,1,0,47,0,-47
26579,0,0,41,0,-41
26580,1,0,96,0,-96
26581,1,0,21,0,-21
26582,0,0,86,0,-86
26583,0,0,23,0,-23
26584,0,0,13,0,-13
26585,1,1,44,1477,1433
26586,1,1,1371,1715,344
26587,1,1,91,1452,1361
26588,1,0,40,0,-40
26589,0,0,11,0,-11
26590,0,0,25,0,-25
26591,1,1,748,1900,1152
26592,1,0,47,0,-47
26593,0,0,5,0,-5
26594,1,0,5,0,-5
26595,1,0,92,0,-92
26596,1,1,59,1336,1277
26597,0,0,116,0,-116
26598,1,0,17,0,-17
26599,1,0,131,0,-131
26600,0,0,12,0,-12
26601,1,1,147,1690,1543
26602,0,0,103,0,-103
26603,0,0,142,0,-142
26604,0,0,50,0,-50
26605,0,0,19,0,-19
26606,0,0,33,0,-33
26607,1,0,24,0,-24
26608,0,0,8,0,-8
26609,1,1,402,1660,1258
26610,1,0,86,0,-86
26611,1,0,1,0,-1
26612,0,0,17,0,-17
26613,1,0,36,0,-36
26614,1,0,55,0,-55
26615,1,0,45,0,-45
26616,1,1,577,1391,814
26617,0,0,5,0,-5
26618,0,0,140,0,-140
26619,1,0,6,0,-6
26620,1,1,188,1501,1313
26621,0,0,28,0,-28
26622,0,0,36,0,-36
26623,0,0,3,0,-3
26624,1,1,2162,1328,-834
26625,0,0,25,0,-25
26626,1,1,560,1838,1278
26627,0,0,39,0,-39
26628,0,0,73,0,-73
26629,1,0,35,0,-35
26630,1,0,55,0,-55
26631,0,0,29,0,-29
26632,1,0,19,0,-19
26633,1,0,87,0,-87
26634,0,0,90,0,-90
26635,0,0,64,0,-64
26636,1,1,80,1440,1360
26637,0,0,61,0,-61
26638,1,1,903,2159,1256
26639,0,0,92,0,-92
26640,1,0,14,0,-14
26641,1,1,535,1541,1006
26642,0,0,156,0,-156
26643,1,1,560,1299,739
26644,1,0,123,0,-123
26645,1,0,16,0,-16
26646,1,0,29,0,-29
26647,1,1,1854,1611,-243
26648,0,0,85,0,-85
26649,0,0,86,0,-86
26650,0,0,27,0,-27
26651,0,0,82,0,-82
26652,1,1,1713,1417,-296
26653,1,1,1261,2663,1402
26654,1,0,4,0,-4
26655,1,0,6,0,-6
26656,1,0,10,0,-10
26657,0,0,19,0,-19
26658,0,0,71,0,-71
26659,1,0,50,0,-50
26660,1,0,145,0,-145
26661,0,0,13,0,-13
26662,1,0,341,0,-341
26663,1,1,114,1201,1087
26664,1,1,821,2331,1510
26665,0,0,73,0,-73
26666,1,0,47,0,-47
26667,1,0,19,0,-19
26668,1,0,33,0,-33
26669,1,0,87,0,-87
26670,1,0,2,0,-2
26671,1,1,137,1351,1214
26672,1,1,185,1203,1018
26673,1,1,255,1525,1270
26674,0,0,24,0,-24
26675,0,0,26,0,-26
26676,0,0,7,0,-7
26677,0,0,44,0,-44
26678,0,0,21,0,-21
26679,0,0,21,0,-21
26680,1,0,126,0,-126
26681,1,1,1315,1249,-66
26682,1,0,21,0,-21
26683,0,0,12,0,-12
26684,1,1,407,2766,2359
26685,1,1,336,1470,1134
26686,1,1,919,1443,524
26687,1,0,69,0,-69
26688,1,1,33,1388,1355
26689,0,0,75,0,-75
26690,1,0,29,0,-29
26691,0,0,141,0,-141
26692,1,1,484,1656,1172
26693,0,0,136,0,-136
26694,1,1,507,1224,717
26695,1,0,18,0,-18
26696,1,1,291,1263,972
26697,0,0,44,0,-44
26698,1,0,40,0,-40
26699,0,0,22,0,-22
26700,0,0,23,0,-23
26701,1,0,27,0,-27
26702,1,0,51,0,-51
26703,0,0,135,0,-135
26704,1,1,239,1312,1073
26705,0,0,40,0,-40
26706,1,0,102,0,-102
26707,0,0,60,0,-60
26708,1,0,52,0,-52
26709,0,0,22,0,-22
26710,0,0,9,0,-9
26711,0,0,8,0,-8
26712,1,0,5,0,-5
26713,0,0,14,0,-14
26714,0,0,10,0,-10
26715,1,1,538,1316,778
26716,1,1,823,1535,712
26717,1,0,102,0,-102
26718,1,1,193,1440,1247
26719,1,1,374,1280,906
26720,1,1,121,1830,1709
26721,0,0,22,0,-22
26722,0,0,125,0,-125
26723,1,0,106,0,-106
26724,1,0,14,0,-14
26725,1,0,5,0,-5
26726,1,1,200,1463,1263
26727,0,0,1,0,-1
26728,1,0,41,0,-41
26729,0,0,24,0,-24
26730,1,1,141,2279,2138
26731,1,0,17,0,-17
26732,0,0,148,0,-148
26733,1,0,38,0,-38
26734,1,0,2,0,-2
26735,0,0,6,0,-6
26736,0,0,143,0,-143
26737,1,1,648,1822,1174
26738,1,1,183,1390,1207
26739,1,0,24,0,-24
26740,1,1,696,3577,2881
26741,1,1,266,1362,1096
26742,1,0,14,0,-14
26743,1,0,10,0,-10
26744,0,0,131,0,-131
26745,0,0,205,0,-205
26746,1,0,5,0,-5
26747,1,1,960,1398,438
26748,1,0,37,0,-37
26749,1,1,32,1204,1172
26750,0,0,35,0,-35
26751,1,0,25,0,-25
26752,1,0,8,0,-8
26753,0,0,24,0,-24
26754,0,0,18,0,-18
26755,0,0,75,0,-75
26756,1,1,452,1238,786
26757,1,1,545,2422,1877
26758,0,0,74,0,-74
26759,0,0,42,0,-42
26760,1,0,38,0,-38
26761,1,0,153,0,-153
26762,1,0,0,0,0
26763,1,1,418,1316,898
26764,0,0,110,0,-110
26765,1,1,96,1225,1129
26766,1,0,17,0,-17
26767,1,0,41,0,-41
26768,1,1,986,1645,659
26769,0,0,9,0,-9
26770,0,0,56,0,-56
26771,1,0,3,0,-3
26772,0,0,18,0,-18
26773,0,0,45,0,-45
26774,1,0,94,0,-94
26775,1,1,22,1346,1324
26776,1,1,564,1431,867
26777,1,0,35,0,-35
26778,0,0,71,0,-71
26779,1,0,39,0,-39
26780,1,1,249,1211,962
26781,1,1,347,1278,931
26782,1,1,866,1475,609
26783,0,0,34,0,-34
26784,1,1,686,1935,1249
26785,1,1,105,1307,1202
26786,1,0,173,0,-173
26787,1,1,1015,1669,654
26788,0,0,146,0,-146
26789,0,0,10,0,-10
26790,1,1,837,1273,436
26791,1,0,64,0,-64
26792,1,0,51,0,-51
26793,0,0,138,0,-138
26794,1,1,179,2023,1844
26795,1,1,915,2393,1478
26796,0,0,12,0,-12
26797,0,0,20,0,-20
26798,0,0,28,0,-28
26799,1,1,474,2165,1691
26800,1,1,93,1345,1252
26801,1,0,1,0,-1
26802,1,1,108,1314,1206
26803,1,0,3,0,-3
26804,0,0,45,0,-45
26805,0,0,50,0,-50
26806,1,0,0,0,0
26807,1,0,28,0,-28
26808,0,0,18,0,-18
26809,0,0,12,0,-12
26810,1,0,117,0,-117
26811,1,1,362,2174,1812
26812,1,0,2,0,-2
26813,1,0,95,0,-95
26814,1,1,335,1325,990
26815,1,1,250,1241,991
26816,1,0,97,0,-97
26817,1,1,801,1347,546
26818,0,0,68,0,-68
26819,1,0,24,0,-24
26820,1,1,1797,1252,-545
26821,1,1,581,1347,766
26822,0,0,3,0,-3
26823,1,0,17,0,-17
26824,0,0,48,0,-48
26825,1,1,121,1230,1109
26826,0,0,21,0,-21
26827,1,1,1485,1918,433
26828,1,1,164,1277,1113
26829,1,0,4,0,-4
26830,1,1,1041,1988,947
26831,0,0,21,0,-21
26832,0,0,0,0,0
26833,1,1,1909,1310,-599
26834,1,0,71,0,-71
26835,1,1,1825,1421,-404
26836,0,0,33,0,-33
26837,1,0,180,0,-180
26838,1,0,48,0,-48
26839,0,0,25,0,-25
26840,1,0,24,0,-24
26841,0,0,38,0,-38
26842,1,0,10,0,-10
26843,1,1,237,1285,1048
26844,1,0,4,0,-4
26845,1,0,66,0,-66
26846,0,0,25,0,-25
26847,1,0,3,0,-3
26848,1,1,310,1299,989
26849,0,0,1,0,-1
26850,0,0,211,0,-211
26851,1,0,4,0,-4
26852,0,0,34,0,-34
26853,0,0,3,0,-3
26854,0,0,118,0,-118
26855,0,0,156,0,-156
26856,0,0,22,0,-22
26857,1,1,81,2516,2435
26858,1,1,397,1447,1050
26859,1,0,105,0,-105
26860,0,0,1,0,-1
26861,0,0,29,0,-29
26862,1,1,310,2892,2582
26863,1,1,239,1651,1412
26864,1,0,80,0,-80
26865,1,0,71,0,-71
26866,1,1,2585,1471,-1114
26867,0,0,122,0,-122
26868,0,0,4,0,-4
26869,0,0,19,0,-19
26870,1,0,110,0,-110
26871,0,0,50,0,-50
26872,0,0,189,0,-189
26873,0,0,0,0,0
26874,1,1,524,1212,688
26875,1,0,9,0,-9
26876,1,1,551,1594,1043
26877,1,1,235,2581,2346
26878,0,0,95,0,-95
26879,1,0,5,0,-5
26880,1,1,482,1381,899
26881,1,1,1975,1267,-708
26882,0,0,59,0,-59
26883,0,0,22,0,-22
26884,0,0,7,0,-7
26885,1,0,51,0,-51
26886,1,1,24,1847,1823
26887,1,1,421,1792,1371
26888,1,1,253,1473,1220
26889,0,0,3,0,-3
26890,1,0,81,0,-81
26891,1,1,266,1281,1015
26892,0,0,49,0,-49
26893,1,1,512,1679,1167
26894,1,1,794,1933,1139
26895,1,1,155,1238,1083
26896,1,1,483,1425,942
26897,1,1,557,1244,687
26898,1,1,803,1310,507
26899,1,1,847,1591,744
26900,0,0,10,0,-10
26901,1,1,155,2971,2816
26902,0,0,71,0,-71
26903,1,1,682,3370,2688
26904,0,0,25,0,-25
26905,1,1,134,1287,1153
26906,1,0,68,0,-68
26907,1,0,23,0,-23
26908,0,0,52,0,-52
26909,0,0,58,0,-58
26910,1,1,222,1818,1596
26911,1,1,2264,1394,-870
26912,0,0,128,0,-128
26913,1,0,214,0,-214
26914,1,1,1153,1418,265
26915,0,0,124,0,-124
26916,0,0,2,0,-2
26917,0,0,123,0,-123
26918,0,0,60,0,-60
26919,1,0,3,0,-3
26920,0,0,14,0,-14
26921,1,1,432,1982,1550
26922,1,1,582,1633,1051
26923,0,0,34,0,-34
26924,1,1,1106,1292,186
26925,1,0,118,0,-118
26926,0,0,18,0,-18
26927,1,0,67,0,-67
26928,0,0,39,0,-39
26929,1,0,89,0,-89
26930,0,0,18,0,-18
26931,0,0,20,0,-20
26932,1,1,270,1232,962
26933,0,0,162,0,-162
26934,1,1,674,1621,947
26935,0,0,24,0,-24
26936,1,1,149,1388,1239
26937,0,0,80,0,-80
26938,1,0,163,0,-163
26939,1,1,813,1662,849
26940,1,0,26,0,-26
26941,1,1,2490,1209,-1281
26942,0,0,11,0,-11
26943,0,0,2,0,-2
26944,1,0,115,0,-115
26945,1,0,30,0,-30
26946,1,1,147,2107,1960
26947,0,0,8,0,-8
26948,1,0,33,0,-33
26949,0,0,133,0,-133
26950,1,0,2,0,-2
26951,1,0,7,0,-7
26952,0,0,23,0,-23
26953,1,1,17,1437,1420
26954,0,0,209,0,-209
26955,1,1,170,1746,1576
26956,0,0,18,0,-18
26957,1,1,508,1317,809
26958,1,1,38,1417,1379
26959,1,1,433,1664,1231
26960,0,0,2,0,-2
26961,0,0,1,0,-1
26962,1,0,107,0,-107
26963,1,1,226,1258,1032
26964,1,1,127,1271,1144
26965,1,1,449,1298,849
26966,1,1,506,1454,948
26967,0,0,56,0,-56
26968,1,1,253,2505,2252
26969,1,1,238,2191,1953
26970,0,0,80,0,-80
26971,1,1,466,1238,772
26972,0,0,17,0,-17
26973,0,0,65,0,-65
26974,0,0,82,0,-82
26975,1,1,578,1398,820
26976,1,1,1718,1370,-348
26977,0,0,7,0,-7
26978,1,0,17,0,-17
26979,0,0,15,0,-15
26980,0,0,281,0,-281
26981,0,0,14,0,-14
26982,1,1,162,2386,2224
26983,0,0,107,0,-107
26984,0,0,75,0,-75
26985,0,0,142,0,-142
26986,0,0,71,0,-71
26987,1,1,1157,1559,402
26988,0,0,123,0,-123
26989,1,1,437,1508,1071
26990,1,1,299,1305,1006
26991,0,0,106,0,-106
26992,1,0,3,0,-3
26993,0,0,34,0,-34
26994,1,1,567,1381,814
26995,0,0,70,0,-70
26996,1,0,22,0,-22
26997,1,1,674,1279,605
26998,1,0,6,0,-6
26999,1,1,519,1221,702
27000,1,1,365,1354,989
27001,1,0,0,0,0
27002,1,1,264,2149,1885
27003,0,0,7,0,-7
27004,1,0,65,0,-65
27005,1,0,37,0,-37
27006,0,0,5,0,-5
27007,0,0,4,0,-4
27008,1,0,8,0,-8
27009,1,1,77,1653,1576
27010,1,0,50,0,-50
27011,0,0,152,0,-152
27012,1,0,123,0,-123
27013,1,0,45,0,-45
27014,0,0,15,0,-15
27015,1,1,385,2604,2219
27016,1,1,477,2367,1890
27017,0,0,24,0,-24
27018,0,0,57,0,-57
27019,0,0,96,0,-96
27020,0,0,254,0,-254
27021,1,0,6,0,-6
27022,1,1,110,1232,1122
27023,1,0,135,0,-135
27024,0,0,74,0,-74
27025,1,1,1446,1584,138
27026,1,1,844,1283,439
27027,1,0,80,0,-80
27028,0,0,9,0,-9
27029,1,0,68,0,-68
27030,1,1,1733,1383,-350
27031,1,0,74,0,-74
27032,1,0,52,0,-52
27033,1,0,70,0,-70
27034,1,1,507,1316,809
27035,1,1,1801,1473,-328
27036,1,1,95,1336,1241
27037,0,0,27,0,-27
27038,1,1,717,1232,515
27039,0,0,0,0,0
27040,1,0,23,0,-23
27041,1,1,78,1725,1647
27042,1,0,26,0,-26
27043,0,0,78,0,-78
27044,0,0,116,0,-116
27045,1,1,301,2415,2114
27046,1,0,230,0,-230
27047,1,0,37,0,-37
27048,1,1,395,1285,890
27049,1,1,178,1510,1332
27050,0,0,47,0,-47
27051,0,0,89,0,-89
27052,0,0,52,0,-52
27053,1,1,46,1332,1286
27054,1,0,28,0,-28
27055,1,0,1,0,-1
27056,0,0,36,0,-36
27057,1,0,8,0,-8
27058,1,1,561,1227,666
27059,0,0,135,0,-135
27060,0,0,136,0,-136
27061,1,1,153,1339,1186
27062,1,0,44,0,-44
27063,1,1,849,1432,583
27064,0,0,17,0,-17
27065,1,1,566,1240,674
27066,1,1,747,1252,505
27067,0,0,16,0,-16
27068,0,0,19,0,-19
27069,1,1,509,1550,1041
27070,1,1,1682,1923,241
27071,1,0,16,0,-16
27072,1,0,36,0,-36
27073,1,1,1226,1503,277
27074,1,0,75,0,-75
27075,1,0,56,0,-56
27076,0,0,50,0,-50
27077,0,0,26,0,-26
27078,0,0,29,0,-29
27079,1,1,711,2101,1390
27080,0,0,16,0,-16
27081,1,1,846,1304,458
27082,1,0,69,0,-69
27083,0,0,17,0,-17
27084,0,0,26,0,-26
27085,1,0,70,0,-70
27086,0,0,18,0,-18
27087,1,0,49,0,-49
27088,1,1,188,3612,3424
27089,1,0,18,0,-18
27090,0,0,32,0,-32
27091,1,1,77,1376,1299
27092,0,0,13,0,-13
27093,0,0,0,0,0
27094,1,0,103,0,-103
27095,0,0,29,0,-29
27096,1,0,53,0,-53
27097,0,0,58,0,-58
27098,1,0,137,0,-137
27099,0,0,146,0,-146
27100,1,1,389,2507,2118
27101,1,1,226,1737,1511
27102,1,1,598,1487,889
27103,1,0,34,0,-34
27104,0,0,69,0,-69
27105,0,0,80,0,-80
27106,0,0,159,0,-159
27107,1,0,27,0,-27
27108,1,0,55,0,-55
27109,0,0,25,0,-25
27110,1,0,3,0,-3
27111,0,0,12,0,-12
27112,0,0,83,0,-83
27113,1,0,18,0,-18
27114,0,0,67,0,-67
27115,1,0,21,0,-21
27116,0,0,33,0,-33
27117,1,0,24,0,-24
27118,1,1,778,1573,795
27119,0,0,0,0,0
27120,1,1,186,1295,1109
27121,0,0,62,0,-62
27122,1,0,2,0,-2
27123,0,0,5,0,-5
27124,0,0,56,0,-56
27125,1,0,224,0,-224
27126,0,0,217,0,-217
27127,1,0,4,0,-4
27128,1,1,1186,2061,875
27129,1,0,4,0,-4
27130,1,1,649,1254,605
27131,0,0,26,0,-26
27132,0,0,136,0,-136
27133,0,0,51,0,-51
27134,0,0,54,0,-54
27135,1,0,55,0,-55
27136,0,0,65,0,-65
27137,1,0,40,0,-40
27138,0,0,34,0,-34
27139,1,1,1016,1352,336
27140,1,0,27,0,-27
27141,1,1,504,1322,818
27142,0,0,93,0,-93
27143,1,0,7,0,-7
27144,1,0,78,0,-78
27145,1,1,262,2486,2224
27146,0,0,90,0,-90
27147,1,0,28,0,-28
27148,0,0,6,0,-6
27149,0,0,93,0,-93
27150,0,0,3,0,-3
27151,1,1,1183,2120,937
27152,1,0,92,0,-92
27153,1,0,18,0,-18
27154,1,1,77,1362,1285
27155,1,1,276,1788,1512
27156,1,1,181,1487,1306
27157,0,0,5,0,-5
27158,0,0,75,0,-75
27159,1,1,1125,1260,135
27160,0,0,96,0,-96
27161,0,0,18,0,-18
27162,1,0,52,0,-52
27163,1,1,397,2665,2268
27164,1,0,26,0,-26
27165,1,0,4,0,-4
27166,0,0,58,0,-58
27167,1,1,69,1998,1929
27168,1,0,31,0,-31
27169,0,0,115,0,-115
27170,1,1,279,1574,1295
27171,0,0,40,0,-40
27172,1,1,1048,2064,1016
27173,1,0,48,0,-48
27174,1,1,413,1218,805
27175,0,0,0,0,0
27176,1,0,13,0,-13
27177,1,1,164,1236,1072
27178,0,0,8,0,-8
27179,0,0,13,0,-13
27180,0,0,2,0,-2
27181,1,1,467,1888,1421
27182,1,1,29,1298,1269
27183,0,0,31,0,-31
27184,0,0,73,0,-73
27185,0,0,53,0,-53
27186,0,0,20,0,-20
27187,0,0,16,0,-16
27188,0,0,128,0,-128
27189,1,1,461,1716,1255
27190,0,0,190,0,-190
27191,0,0,20,0,-20
27192,0,0,27,0,-27
27193,1,0,5,0,-5
27194,1,0,34,0,-34
27195,0,0,79,0,-79
27196,1,1,655,2115,1460
27197,1,1,533,1289,756
27198,0,0,19,0,-19
27199,1,0,39,0,-39
27200,1,1,261,3161,2900
27201,0,0,67,0,-67
27202,0,0,5,0,-5
27203,1,1,144,1310,1166
27204,1,0,7,0,-7
27205,1,0,155,0,-155
27206,0,0,101,0,-101
27207,1,1,221,1495,1274
27208,0,0,22,0,-22
27209,0,0,38,0,-38
27210,0,0,235,0,-235
27211,1,1,35,2035,2000
27212,1,0,10,0,-10
27213,0,0,63,0,-63
27214,1,1,957,1237,280
27215,0,0,8,0,-8
27216,1,1,1208,1341,133
27217,1,0,54,0,-54
27218,0,0,335,0,-335
27219,1,0,5,0,-5
27220,0,0,84,0,-84
27221,0,0,60,0,-60
27222,1,1,482,1960,1478
27223,0,0,41,0,-41
27224,0,0,28,0,-28
27225,1,0,64,0,-64
27226,0,0,53,0,-53
27227,1,1,1543,2088,545
27228,0,0,38,0,-38
27229,0,0,1,0,-1
27230,1,0,46,0,-46
27231,1,1,175,2259,2084
27232,1,1,133,1340,1207
27233,1,1,605,3104,2499
27234,0,0,47,0,-47
27235,1,0,0,0,0
27236,1,0,5,0,-5
27237,1,0,3,0,-3
27238,1,1,438,2142,1704
27239,1,0,2,0,-2
27240,1,1,249,2395,2146
27241,0,0,55,0,-55
27242,0,0,3,0,-3
27243,1,1,302,2517,2215
27244,1,1,352,1951,1599
27245,1,1,272,1325,1053
27246,1,1,423,1229,806
27247,0,0,22,0,-22
27248,1,1,284,2618,2334
27249,1,1,58,1358,1300
27250,1,1,201,1968,1767
27251,0,0,102,0,-102
27252,1,0,44,0,-44
27253,0,0,133,0,-133
27254,0,0,125,0,-125
27255,0,0,166,0,-166
27256,0,0,80,0,-80
27257,1,0,2,0,-2
27258,0,0,22,0,-22
27259,1,1,434,1329,895
27260,0,0,127,0,-127
27261,1,1,117,1218,1101
27262,0,0,10,0,-10
27263,0,0,0,0,0
27264,1,0,9,0,-9
27265,0,0,3,0,-3
27266,1,1,28,1257,1229
27267,0,0,25,0,-25
27268,1,1,515,1499,984
27269,0,0,27,0,-27
27270,1,1,275,1628,1353
27271,0,0,5,0,-5
27272,1,0,87,0,-87
27273,1,0,19,0,-19
27274,1,0,25,0,-25
27275,1,0,138,0,-138
27276,1,1,993,1409,416
27277,0,0,54,0,-54
27278,1,0,20,0,-20
27279,1,1,1015,1206,191
27280,1,0,7,0,-7
27281,1,1,1859,1779,-80
27282,1,0,34,0,-34
27283,0,0,61,0,-61
27284,1,0,30,0,-30
27285,1,0,82,0,-82
27286,0,0,20,0,-20
27287,0,0,16,0,-16
27288,1,0,60,0,-60
27289,1,1,465,1595,1130
27290,0,0,41,0,-41
27291,1,0,77,0,-77
27292,1,0,58,0,-58
27293,1,0,45,0,-45
27294,1,0,25,0,-25
27295,1,1,238,1448,1210
27296,1,0,103,0,-103
27297,1,1,17,1403,1386
27298,0,0,33,0,-33
27299,0,0,7,0,-7
27300,1,0,49,0,-49
27301,1,0,423,0,-423
27302,0,0,3,0,-3
27303,0,0,29,0,-29
27304,0,0,112,0,-112
27305,0,0,28,0,-28
27306,0,0,54,0,-54
27307,0,0,127,0,-127
27308,1,1,48,1391,1343
27309,0,0,36,0,-36
27310,0,0,218,0,-218
27311,1,1,153,1667,1514
27312,0,0,28,0,-28
27313,1,1,188,1517,1329
27314,0,0,73,0,-73
27315,0,0,51,0,-51
27316,1,0,9,0,-9
27317,0,0,8,0,-8
27318,0,0,11,0,-11
27319,0,0,14,0,-14
27320,1,1,84,1363,1279
27321,1,1,316,1291,975
27322,1,0,15,0,-15
27323,0,0,48,0,-48
27324,1,0,8,0,-8
27325,1,0,25,0,-25
27326,0,0,37,0,-37
27327,0,0,65,0,-65
27328,0,0,133,0,-133
27329,1,1,827,2192,1365
27330,0,0,1,0,-1
27331,1,0,108,0,-108
27332,0,0,39,0,-39
27333,0,0,1,0,-1
27334,1,1,1039,2175,1136
27335,1,1,62,1585,1523
27336,0,0,64,0,-64
27337,0,0,108,0,-108
27338,1,1,228,1376,1148
27339,1,0,8,0,-8
27340,0,0,176,0,-176
27341,0,0,40,0,-40
27342,1,1,646,1470,824
27343,0,0,14,0,-14
27344,1,0,7,0,-7
27345,0,0,5,0,-5
27346,0,0,9,0,-9
27347,1,1,79,1390,1311
27348,0,0,10,0,-10
27349,1,0,24,0,-24
27350,1,0,70,0,-70
27351,1,1,552,1312,760
27352,1,0,41,0,-41
27353,1,0,6,0,-6
27354,1,0,38,0,-38
27355,0,0,3,0,-3
27356,1,0,112,0,-112
27357,0,0,84,0,-84
27358,1,0,22,0,-22
27359,1,0,73,0,-73
27360,1,0,54,0,-54
27361,0,0,94,0,-94
27362,1,0,26,0,-26
27363,0,0,35,0,-35
27364,0,0,194,0,-194
27365,0,0,80,0,-80
27366,0,0,6,0,-6
27367,0,0,53,0,-53
27368,0,0,174,0,-174
27369,1,1,1233,1307,74
27370,1,0,47,0,-47
27371,0,0,48,0,-48
27372,0,0,350,0,-350
27373,0,0,11,0,-11
27374,0,0,178,0,-178
27375,0,0,84,0,-84
27376,1,0,29,0,-29
27377,1,1,66,1392,1326
27378,1,0,60,0,-60
27379,1,1,855,1518,663
27380,1,1,248,1303,1055
27381,0,0,1,0,-1
27382,1,1,237,1246,1009
27383,1,0,68,0,-68
27384,0,0,35,0,-35
27385,1,0,126,0,-126
27386,0,0,66,0,-66
27387,1,1,139,1289,1150
27388,0,0,11,0,-11
27389,1,1,119,1397,1278
27390,0,0,19,0,-19
27391,1,1,43,1310,1267
27392,1,1,964,4489,3525
27393,0,0,51,0,-51
27394,0,0,9,0,-9
27395,0,0,0,0,0
27396,0,0,5,0,-5
27397,0,0,32,0,-32
27398,0,0,2,0,-2
27399,1,1,323,2042,1719
27400,0,0,94,0,-94
27401,1,0,52,0,-52
27402,1,0,34,0,-34
27403,1,0,4,0,-4
27404,1,1,118,1898,1780
27405,1,0,39,0,-39
27406,1,0,22,0,-22
27407,1,0,45,0,-45
27408,0,0,4,0,-4
27409,1,0,72,0,-72
27410,1,1,443,1512,1069
27411,1,1,286,2461,2175
27412,1,1,302,1684,1382
27413,0,0,38,0,-38
27414,0,0,34,0,-34
27415,0,0,37,0,-37
27416,0,0,52,0,-52
27417,1,0,25,0,-25
27418,0,0,80,0,-80
27419,1,1,1095,1283,188
27420,1,0,109,0,-109
27421,0,0,1,0,-1
27422,1,0,120,0,-120
27423,1,1,387,1511,1124
27424,0,0,25,0,-25
27425,1,0,16,0,-16
27426,0,0,50,0,-50
27427,1,0,65,0,-65
27428,1,1,1124,1871,747
27429,0,0,10,0,-10
27430,1,1,174,1422,1248
27431,1,0,141,0,-141
27432,0,0,23,0,-23
27433,1,0,60,0,-60
27434,0,0,64,0,-64
27435,1,1,188,1249,1061
27436,1,0,46,0,-46
27437,0,0,6,0,-6
27438,1,0,0,0,0
27439,0,0,0,0,0
27440,0,0,30,0,-30
27441,1,0,16,0,-16
27442,1,1,715,1923,1208
27443,1,1,18,1704,1686
27444,1,1,251,1514,1263
27445,1,0,24,0,-24
27446,1,0,4,0,-4
27447,1,0,123,0,-123
27448,0,0,20,0,-20
27449,1,0,40,0,-40
27450,0,0,63,0,-63
27451,0,0,16,0,-16
27452,1,0,9,0,-9
27453,0,0,55,0,-55
27454,0,0,72,0,-72
27455,0,0,56,0,-56
27456,1,1,884,2370,1486
27457,0,0,51,0,-51
27458,1,0,25,0,-25
27459,1,1,729,1512,783
27460,1,1,468,1233,765
27461,0,0,264,0,-264
27462,1,1,453,1204,751
27463,1,1,246,2765,2519
27464,0,0,86,0,-86
27465,0,0,94,0,-94
27466,0,0,79,0,-79
27467,1,1,1417,1245,-172
27468,1,1,1349,1330,-19
27469,0,0,0,0,0
27470,1,0,101,0,-101
27471,1,0,59,0,-59
27472,0,0,13,0,-13
27473,0,0,41,0,-41
27474,1,0,57,0,-57
27475,0,0,51,0,-51
27476,1,1,1231,1232,1
27477,0,0,48,0,-48
27478,0,0,7,0,-7
27479,1,1,776,1747,971
27480,1,0,6,0,-6
27481,0,0,6,0,-6
27482,1,1,261,1422,1161
27483,1,0,24,0,-24
27484,1,1,152,1365,1213
27485,1,0,120,0,-120
27486,1,0,17,0,-17
27487,1,1,354,1404,1050
27488,0,0,71,0,-71
27489,1,0,24,0,-24
27490,0,0,28,0,-28
27491,1,1,744,1706,962
27492,0,0,4,0,-4
27493,1,1,341,1615,1274
27494,0,0,31,0,-31
27495,0,0,98,0,-98
27496,0,0,3,0,-3
27497,0,0,13,0,-13
27498,1,1,91,2036,1945
27499,1,1,634,1202,568
27500,1,1,605,1204,599
27501,1,1,258,1224,966
27502,0,0,66,0,-66
27503,0,0,66,0,-66
27504,1,1,42,1445,1403
27505,0,0,9,0,-9
27506,0,0,20,0,-20
27507,1,1,35,1621,1586
27508,1,1,118,1916,1798
27509,1,0,30,0,-30
27510,1,0,3,0,-3
27511,0,0,66,0,-66
27512,0,0,37,0,-37
27513,0,0,6,0,-6
27514,1,0,43,0,-43
27515,1,0,50,0,-50
27516,1,1,63,1353,1290
27517,0,0,166,0,-166
27518,1,1,840,1410,570
27519,0,0,53,0,-53
27520,0,0,17,0,-17
27521,1,0,13,0,-13
27522,1,0,59,0,-59
27523,1,1,2281,1286,-995
27524,0,0,33,0,-33
27525,1,1,147,1244,1097
27526,1,1,226,1215,989
27527,1,1,253,1450,1197
27528,0,0,12,0,-12
27529,1,0,27,0,-27
27530,0,0,56,0,-56
27531,1,1,1431,1406,-25
27532,1,1,140,1868,1728
27533,0,0,4,0,-4
27534,0,0,37,0,-37
27535,1,1,926,1763,837
27536,0,0,98,0,-98
27537,0,0,42,0,-42
27538,1,1,221,1863,1642
27539,1,1,270,1231,961
27540,1,0,71,0,-71
27541,0,0,96,0,-96
27542,1,1,190,1282,1092
27543,1,1,49,1336,1287
27544,0,0,178,0,-178
27545,1,1,39,1461,1422
27546,1,1,293,1258,965
27547,1,1,2717,1725,-992
27548,1,0,33,0,-33
27549,1,0,168,0,-168
27550,1,0,48,0,-48
27551,1,0,9,0,-9
27552,1,1,621,1207,586
27553,1,1,736,1888,1152
27554,0,0,1,0,-1
27555,0,0,39,0,-39
27556,0,0,68,0,-68
27557,1,1,341,1476,1135
27558,1,0,46,0,-46
27559,0,0,88,0,-88
27560,1,1,1276,1218,-58
27561,1,1,939,1200,261
27562,1,0,26,0,-26
27563,1,0,21,0,-21
27564,0,0,42,0,-42
27565,1,1,566,1261,695
27566,1,1,667,1545,878
27567,0,0,43,0,-43
27568,1,0,87,0,-87
27569,1,0,29,0,-29
27570,0,0,43,0,-43
27571,0,0,46,0,-46
27572,0,0,54,0,-54
27573,1,0,6,0,-6
27574,0,0,25,0,-25
27575,1,0,39,0,-39
27576,0,0,16,0,-16
27577,0,0,22,0,-22
27578,1,1,424,1310,886
27579,1,1,141,1349,1208
27580,1,0,75,0,-75
27581,0,0,73,0,-73
27582,1,1,41,1573,1532
27583,0,0,75,0,-75
27584,1,1,1042,1247,205
27585,1,0,23,0,-23
27586,1,0,72,0,-72
27587,1,0,36,0,-36
27588,1,1,340,1411,1071
27589,1,0,20,0,-20
27590,0,0,60,0,-60
27591,1,1,318,1257,939
27592,0,0,144,0,-144
27593,1,1,50,1204,1154
27594,1,0,3,0,-3
27595,1,1,649,1402,753
27596,1,1,933,1763,830
27597,1,0,4,0,-4
27598,1,1,298,1437,1139
27599,0,0,72,0,-72
27600,0,0,50,0,-50
27601,1,1,84,1274,1190
27602,0,0,14,0,-14
27603,1,0,41,0,-41
27604,1,0,70,0,-70
27605,1,1,205,1462,1257
27606,1,1,826,1400,574
27607,1,1,592,1609,1017
27608,1,0,97,0,-97
27609,1,1,1702,1669,-33
27610,1,0,39,0,-39
27611,0,0,17,0,-17
27612,1,1,581,3261,2680
27613,0,0,133,0,-133
27614,0,0,37,0,-37
27615,0,0,83,0,-83
27616,0,0,2,0,-2
27617,1,1,510,1280,770
27618,1,1,497,2688,2191
27619,0,0,4,0,-4
27620,0,0,107,0,-107
27621,0,0,57,0,-57
27622,1,0,68,0,-68
27623,1,0,85,0,-85
27624,1,1,539,1450,911
27625,1,0,67,0,-67
27626,0,0,12,0,-12
27627,0,0,29,0,-29
27628,1,1,110,1320,1210
27629,1,1,1388,1348,-40
27630,0,0,73,0,-73
27631,1,1,260,1436,1176
27632,0,0,120,0,-120
27633,1,0,3,0,-3
27634,1,1,58,2075,2017
27635,0,0,34,0,-34
27636,1,1,775,1238,463
27637,1,0,31,0,-31
27638,1,1,765,1324,559
27639,1,1,134,1313,1179
27640,0,0,301,0,-301
27641,0,0,10,0,-10
27642,1,1,238,4145,3907
27643,1,1,1290,2084,794
27644,1,0,70,0,-70
27645,0,0,2,0,-2
27646,1,0,43,0,-43
27647,0,0,53,0,-53
27648,0,0,55,0,-55
27649,0,0,49,0,-49
27650,0,0,111,0,-111
27651,0,0,16,0,-16
27652,1,1,435,2401,1966
27653,0,0,137,0,-137
27654,1,0,8,0,-8
27655,1,0,5,0,-5
27656,1,0,25,0,-25
27657,0,0,7,0,-7
27658,1,1,88,1668,1580
27659,0,0,77,0,-77
27660,0,0,8,0,-8
27661,0,0,153,0,-153
27662,0,0,21,0,-21
27663,0,0,104,0,-104
27664,0,0,113,0,-113
27665,1,1,305,1245,940
27666,1,0,29,0,-29
27667,1,1,550,1352,802
27668,1,0,95,0,-95
27669,0,0,37,0,-37
27670,0,0,55,0,-55
27671,0,0,37,0,-37
27672,1,0,52,0,-52
27673,1,1,196,2240,2044
27674,0,0,34,0,-34
27675,1,0,32,0,-32
27676,1,1,288,1600,1312
27677,1,0,29,0,-29
27678,0,0,4,0,-4
27679,1,1,201,1227,1026
27680,1,0,49,0,-49
27681,0,0,20,0,-20
27682,1,1,264,1546,1282
27683,1,1,196,1420,1224
27684,0,0,31,0,-31
27685,1,1,102,3501,3399
27686,0,0,87,0,-87
27687,1,1,346,1228,882
27688,1,1,262,2137,1875
27689,0,0,64,0,-64
27690,0,0,9,0,-9
27691,1,1,254,1413,1159
27692,1,1,370,1340,970
27693,1,0,82,0,-82
27694,1,1,296,1640,1344
27695,1,1,212,1505,1293
27696,1,0,15,0,-15
27697,1,0,101,0,-101
27698,1,1,113,1376,1263
27699,1,1,359,2972,2613
27700,0,0,38,0,-38
27701,1,0,46,0,-46
27702,1,1,1548,1419,-129
27703,1,1,426,1448,1022
27704,1,0,33,0,-33
27705,1,0,46,0,-46
27706,0,0,74,0,-74
27707,0,0,7,0,-7
27708,1,1,549,1422,873
27709,1,1,334,3024,2690
27710,1,0,19,0,-19
27711,0,0,37,0,-37
27712,1,1,858,1343,485
27713,1,0,24,0,-24
27714,1,0,129,0,-129
27715,1,1,175,1979,1804
27716,1,0,5,0,-5
27717,1,0,7,0,-7
27718,1,0,32,0,-32
27719,0,0,154,0,-154
27720,1,1,1358,1309,-49
27721,1,0,68,0,-68
27722,1,0,63,0,-63
27723,0,0,21,0,-21
27724,0,0,158,0,-158
27725,1,0,256,0,-256
27726,1,0,18,0,-18
27727,1,0,82,0,-82
27728,1,0,81,0,-81
27729,1,0,117,0,-117
27730,0,0,9,0,-9
27731,0,0,141,0,-141
27732,1,1,537,1364,827
27733,0,0,19,0,-19
27734,1,1,315,1408,1093
27735,0,0,78,0,-78
27736,1,1,57,2799,2742
27737,1,0,24,0,-24
27738,1,0,62,0,-62
27739,1,1,1877,1377,-500
27740,1,1,631,1420,789
27741,1,1,1324,1859,535
27742,0,0,55,0,-55
27743,1,1,360,1487,1127
27744,0,0,5,0,-5
27745,0,0,109,0,-109
27746,1,1,14,1410,1396
27747,1,0,15,0,-15
27748,1,0,30,0,-30
27749,1,0,143,0,-143
27750,0,0,42,0,-42
27751,1,1,768,1228,460
27752,0,0,121,0,-121
27753,1,1,888,1450,562
27754,1,1,187,1571,1384
27755,1,1,456,1315,859
27756,0,0,16,0,-16
27757,0,0,19,0,-19
27758,1,1,497,1888,1391
27759,1,0,17,0,-17
27760,0,0,64,0,-64
27761,1,1,645,1274,629
27762,0,0,93,0,-93
27763,1,1,733,1212,479
27764,0,0,97,0,-97
27765,1,1,315,1283,968
27766,0,0,23,0,-23
27767,1,1,397,1828,1431
27768,0,0,54,0,-54
27769,1,0,22,0,-22
27770,0,0,55,0,-55
27771,0,0,83,0,-83
27772,0,0,9,0,-9
27773,1,0,38,0,-38
27774,0,0,5,0,-5
27775,0,0,1,0,-1
27776,0,0,18,0,-18
27777,1,0,16,0,-16
27778,1,0,71,0,-71
27779,0,0,62,0,-62
27780,1,0,13,0,-13
27781,0,0,5,0,-5
27782,0,0,58,0,-58
27783,1,0,29,0,-29
27784,1,0,28,0,-28
27785,1,0,62,0,-62
27786,0,0,50,0,-50
27787,0,0,126,0,-126
27788,0,0,41,0,-41
27789,1,0,30,0,-30
27790,0,0,1,0,-1
27791,1,1,151,1686,1535
27792,1,1,61,1205,1144
27793,1,0,149,0,-149
27794,0,0,120,0,-120
27795,0,0,164,0,-164
27796,1,1,542,1410,868
27797,0,0,149,0,-149
27798,1,1,735,1781,1046
27799,0,0,22,0,-22
27800,1,1,173,2513,2340
27801,1,1,390,2004,1614
27802,1,1,592,1220,628
27803,0,0,24,0,-24
27804,1,1,1039,1264,225
27805,1,1,447,1217,770
27806,0,0,35,0,-35
27807,1,1,1001,1682,681
27808,0,0,45,0,-45
27809,1,0,105,0,-105
27810,0,0,23,0,-23
27811,1,1,107,1876,1769
27812,0,0,89,0,-89
27813,0,0,29,0,-29
27814,1,1,840,1311,471
27815,0,0,78,0,-78
27816,1,1,513,1623,1110
27817,1,0,3,0,-3
27818,1,1,275,1613,1338
27819,0,0,21,0,-21
27820,1,0,32,0,-32
27821,0,0,51,0,-51
27822,0,0,38,0,-38
27823,1,1,359,1208,849
27824,1,0,3,0,-3
27825,1,0,50,0,-50
27826,0,0,60,0,-60
27827,1,1,450,1470,1020
27828,0,0,61,0,-61
27829,0,0,12,0,-12
27830,1,0,4,0,-4
27831,1,1,1160,1614,454
27832,0,0,11,0,-11
27833,0,0,189,0,-189
27834,0,0,0,0,0
27835,1,0,101,0,-101
27836,1,1,321,1978,1657
27837,0,0,29,0,-29
27838,1,0,6,0,-6
27839,0,0,70,0,-70
27840,0,0,53,0,-53
27841,0,0,42,0,-42
27842,0,0,59,0,-59
27843,0,0,54,0,-54
27844,0,0,180,0,-180
27845,1,1,810,1267,457
27846,0,0,30,0,-30
27847,0,0,24,0,-24
27848,1,0,20,0,-20
27849,1,0,132,0,-132
27850,0,0,35,0,-35
27851,0,0,42,0,-42
27852,0,0,21,0,-21
27853,1,1,653,1871,1218
27854,1,0,28,0,-28
27855,1,1,241,2106,1865
27856,0,0,84,0,-84
27857,0,0,130,0,-130
27858,0,0,16,0,-16
27859,0,0,31,0,-31
27860,1,0,3,0,-3
27861,1,0,81,0,-81
27862,1,0,242,0,-242
27863,1,0,169,0,-169
27864,1,1,417,1508,1091
27865,0,0,42,0,-42
27866,1,0,8,0,-8
27867,0,0,111,0,-111
27868,1,1,61,1202,1141
27869,0,0,0,0,0
27870,1,0,56,0,-56
27871,1,1,234,1374,1140
27872,0,0,30,0,-30
27873,1,1,301,1720,1419
27874,0,0,38,0,-38
27875,1,0,68,0,-68
27876,1,0,54,0,-54
27877,0,0,20,0,-20
27878,1,1,237,1268,1031
27879,1,0,14,0,-14
27880,1,1,355,2842,2487
27881,1,1,116,1233,1117
27882,0,0,5,0,-5
27883,0,0,22,0,-22
27884,1,0,123,0,-123
27885,1,1,384,1920,1536
27886,0,0,7,0,-7
27887,1,1,459,2054,1595
27888,1,1,183,1602,1419
27889,1,0,20,0,-20
27890,0,0,12,0,-12
27891,0,0,72,0,-72
27892,1,0,1,0,-1
27893,1,1,1063,2738,1675
27894,0,0,3,0,-3
27895,0,0,210,0,-210
27896,0,0,36,0,-36
27897,1,0,182,0,-182
27898,1,1,567,1378,811
27899,1,0,18,0,-18
27900,0,0,93,0,-93
27901,1,1,1122,1390,268
27902,0,0,52,0,-52
27903,1,1,549,1227,678
27904,1,0,19,0,-19
27905,1,0,27,0,-27
27906,0,0,58,0,-58
27907,0,0,20,0,-20
27908,1,0,98,0,-98
27909,0,0,31,0,-31
27910,1,0,0,0,0
27911,0,0,21,0,-21
27912,0,0,70,0,-70
27913,1,0,68,0,-68
27914,1,0,14,0,-14
27915,0,0,12,0,-12
27916,0,0,29,0,-29
27917,0,0,14,0,-14
27918,1,1,251,1252,1001
27919,1,0,65,0,-65
27920,1,1,214,1243,1029
27921,1,0,8,0,-8
27922,1,1,678,1202,524
27923,0,0,16,0,-16
27924,0,0,33,0,-33
27925,1,1,11,1423,1412
27926,0,0,10,0,-10
27927,1,1,243,2431,2188
27928,0,0,5,0,-5
27929,1,0,66,0,-66
27930,0,0,102,0,-102
27931,0,0,4,0,-4
27932,0,0,61,0,-61
27933,0,0,44,0,-44
27934,0,0,43,0,-43
27935,0,0,4,0,-4
27936,0,0,28,0,-28
27937,1,0,34,0,-34
27938,1,0,23,0,-23
27939,0,0,3,0,-3
27940,0,0,27,0,-27
27941,0,0,30,0,-30
27942,1,0,1,0,-1
27943,1,1,111,1323,1212
27944,0,0,9,0,-9
27945,0,0,26,0,-26
27946,1,0,0,0,0
27947,0,0,36,0,-36
27948,1,0,12,0,-12
27949,1,0,65,0,-65
27950,1,1,380,1379,999
27951,1,1,721,1247,526
27952,1,0,38,0,-38
27953,0,0,77,0,-77
27954,1,1,574,1493,919
27955,1,1,501,1715,1214
27956,1,1,267,2399,2132
27957,0,0,3,0,-3
27958,0,0,69,0,-69
27959,0,0,19,0,-19
27960,1,1,364,1496,1132
27961,1,0,43,0,-43
27962,1,0,26,0,-26
27963,1,0,34,0,-34
27964,0,0,154,0,-154
27965,0,0,47,0,-47
27966,1,0,114,0,-114
27967,1,1,43,1405,1362
27968,0,0,19,0,-19
27969,1,1,536,1260,724
27970,0,0,69,0,-69
27971,0,0,17,0,-17
27972,0,0,107,0,-107
27973,0,0,17,0,-17
27974,1,0,7,0,-7
27975,1,0,39,0,-39
27976,1,0,49,0,-49
27977,1,0,87,0,-87
27978,1,1,900,1332,432
27979,0,0,58,0,-58
27980,1,0,25,0,-25
27981,1,0,106,0,-106
27982,0,0,37,0,-37
27983,1,1,233,1626,1393
27984,0,0,50,0,-50
27985,0,0,11,0,-11
27986,1,1,731,1265,534
27987,1,0,80,0,-80
27988,1,1,213,1330,1117
27989,0,0,2,0,-2
27990,0,0,16,0,-16
27991,0,0,0,0,0
27992,0,0,36,0,-36
27993,0,0,14,0,-14
27994,1,0,173,0,-173
27995,1,0,13,0,-13
27996,1,0,16,0,-16
27997,0,0,89,0,-89
27998,0,0,125,0,-125
27999,0,0,9,0,-9
28000,0,0,35,0,-35
28001,1,1,240,1592,1352
28002,1,1,165,1239,1074
28003,0,0,0,0,0
28004,1,0,33,0,-33
28005,0,0,72,0,-72
28006,1,1,842,1382,540
28007,0,0,46,0,-46
28008,1,0,8,0,-8
28009,1,0,126,0,-126
28010,0,0,3,0,-3
28011,1,0,70,0,-70
28012,1,1,157,1247,1090
28013,0,0,3,0,-3
28014,1,1,1675,1815,140
28015,1,0,3,0,-3
28016,1,0,40,0,-40
28017,1,0,28,0,-28
28018,1,1,879,1385,506
28019,0,0,92,0,-92
28020,0,0,42,0,-42
28021,1,1,230,1358,1128
28022,1,0,122,0,-122
28023,0,0,5,0,-5
28024,1,1,1763,1412,-351
28025,1,1,1157,1848,691
28026,0,0,65,0,-65
28027,1,0,141,0,-141
28028,1,0,39,0,-39
28029,1,1,193,1734,1541
28030,0,0,54,0,-54
28031,1,1,240,2245,2005
28032,1,1,98,1592,1494
28033,1,1,328,1457,1129
28034,1,1,502,1244,742
28035,1,1,698,1260,562
28036,0,0,107,0,-107
28037,1,1,457,1452,995
28038,0,0,128,0,-128
28039,1,0,11,0,-11
28040,0,0,108,0,-108
28041,1,1,538,1653,1115
28042,0,0,15,0,-15
28043,1,0,8,0,-8
28044,1,0,39,0,-39
28045,1,0,22,0,-22
28046,1,0,0,0,0
28047,0,0,13,0,-13
28048,1,0,1,0,-1
28049,0,0,25,0,-25
28050,0,0,16,0,-16
28051,0,0,51,0,-51
28052,0,0,93,0,-93
28053,1,0,31,0,-31
28054,0,0,0,0,0
28055,1,1,89,1938,1849
28056,0,0,43,0,-43
28057,1,1,1497,5620,4123
28058,1,0,86,0,-86
28059,1,0,15,0,-15
28060,1,0,21,0,-21
28061,1,0,98,0,-98
28062,1,1,2011,2317,306
28063,1,1,1134,1371,237
28064,0,0,15,0,-15
28065,1,0,26,0,-26
28066,1,0,56,0,-56
28067,1,1,609,1862,1253
28068,1,0,69,0,-69
28069,0,0,16,0,-16
28070,0,0,84,0,-84
28071,0,0,130,0,-130
28072,1,0,50,0,-50
28073,0,0,103,0,-103
28074,0,0,50,0,-50
28075,1,1,558,1813,1255
28076,0,0,36,0,-36
28077,1,0,3,0,-3
28078,0,0,167,0,-167
28079,0,0,29,0,-29
28080,1,0,5,0,-5
28081,1,0,26,0,-26
28082,0,0,28,0,-28
28083,0,0,88,0,-88
28084,0,0,108,0,-108
28085,0,0,10,0,-10
28086,0,0,98,0,-98
28087,0,0,4,0,-4
28088,1,0,6,0,-6
28089,0,0,28,0,-28
28090,1,1,117,1326,1209
28091,1,1,318,2609,2291
28092,1,1,2864,1202,-1662
28093,1,0,18,0,-18
28094,1,0,42,0,-42
28095,0,0,117,0,-117
28096,0,0,61,0,-61
28097,1,1,52,1405,1353
28098,0,0,41,0,-41
28099,1,0,23,0,-23
28100,0,0,220,0,-220
28101,0,0,84,0,-84
28102,0,0,20,0,-20
28103,0,0,0,0,0
28104,0,0,19,0,-19
28105,0,0,2,0,-2
28106,1,0,111,0,-111
28107,1,0,44,0,-44
28108,0,0,77,0,-77
28109,0,0,7,0,-7
28110,1,1,47,1989,1942
28111,1,0,47,0,-47
28112,1,0,90,0,-90
28113,0,0,28,0,-28
28114,1,0,0,0,0
28115,1,1,159,1213,1054
28116,0,0,14,0,-14
28117,1,1,1369,1988,619
28118,0,0,7,0,-7
28119,1,0,8,0,-8
28120,1,1,1334,1998,664
28121,1,1,90,1285,1195
28122,1,1,2085,1237,-848
28123,0,0,3,0,-3
28124,0,0,10,0,-10
28125,1,1,248,1337,1089
28126,1,0,42,0,-42
28127,1,0,44,0,-44
28128,1,1,1612,2039,427
28129,1,0,77,0,-77
28130,0,0,85,0,-85
28131,0,0,57,0,-57
28132,0,0,190,0,-190
28133,1,0,11,0,-11
28134,0,0,22,0,-22
28135,0,0,33,0,-33
28136,1,0,42,0,-42
28137,1,0,37,0,-37
28138,0,0,2,0,-2
28139,0,0,38,0,-38
28140,1,0,26,0,-26
28141,0,0,49,0,-49
28142,0,0,16,0,-16
28143,1,0,7,0,-7
28144,1,0,28,0,-28
28145,0,0,8,0,-8
28146,1,0,39,0,-39
28147,0,0,24,0,-24
28148,1,0,41,0,-41
28149,1,0,206,0,-206
28150,1,1,211,1313,1102
28151,1,0,38,0,-38
28152,1,0,18,0,-18
28153,0,0,11,0,-11
28154,0,0,47,0,-47
28155,1,0,69,0,-69
28156,1,0,72,0,-72
28157,0,0,105,0,-105
28158,1,0,53,0,-53
28159,1,1,385,3301,2916
28160,0,0,8,0,-8
28161,1,0,99,0,-99
28162,1,0,2,0,-2
28163,1,0,59,0,-59
28164,1,1,1196,1257,61
28165,1,1,1338,1685,347
28166,1,1,129,1272,1143
28167,0,0,82,0,-82
28168,1,1,251,1337,1086
28169,0,0,9,0,-9
28170,0,0,18,0,-18
28171,1,0,25,0,-25
28172,0,0,44,0,-44
28173,1,0,53,0,-53
28174,0,0,14,0,-14
28175,1,0,6,0,-6
28176,0,0,16,0,-16
28177,0,0,62,0,-62
28178,1,1,182,1423,1241
28179,0,0,118,0,-118
28180,0,0,58,0,-58
28181,0,0,70,0,-70
28182,1,0,79,0,-79
28183,1,0,16,0,-16
28184,0,0,57,0,-57
28185,1,0,123,0,-123
28186,1,0,169,0,-169
28187,0,0,9,0,-9
28188,1,1,148,1834,1686
28189,1,1,60,1429,1369
28190,0,0,6,0,-6
28191,0,0,13,0,-13
28192,0,0,53,0,-53
28193,0,0,63,0,-63
28194,0,0,128,0,-128
28195,1,1,60,1493,1433
28196,1,0,16,0,-16
28197,0,0,35,0,-35
28198,1,1,1267,1752,485
28199,1,1,283,1392,1109
28200,1,0,167,0,-167
28201,1,1,876,1460,584
28202,1,0,5,0,-5
28203,1,0,11,0,-11
28204,0,0,6,0,-6
28205,0,0,43,0,-43
28206,0,0,0,0,0
28207,0,0,20,0,-20
28208,1,0,10,0,-10
28209,1,0,7,0,-7
28210,1,1,561,1247,686
28211,1,1,113,1635,1522
28212,0,0,3,0,-3
28213,1,1,937,2833,1896
28214,1,1,204,2667,2463
28215,0,0,48,0,-48
28216,1,1,163,1321,1158
28217,1,0,0,0,0
28218,0,0,33,0,-33
28219,0,0,19,0,-19
28220,1,0,14,0,-14
28221,1,0,33,0,-33
28222,1,1,662,2561,1899
28223,0,0,23,0,-23
28224,1,0,201,0,-201
28225,1,1,587,2595,2008
28226,1,1,347,1266,919
28227,0,0,135,0,-135
28228,0,0,8,0,-8
28229,0,0,53,0,-53
28230,0,0,45,0,-45
28231,0,0,9,0,-9
28232,1,0,81,0,-81
28233,0,0,9,0,-9
28234,0,0,32,0,-32
28235,0,0,19,0,-19
28236,1,1,237,1476,1239
28237,1,1,67,1564,1497
28238,0,0,34,0,-34
28239,1,0,50,0,-50
28240,1,1,717,1204,487
28241,1,0,134,0,-134
28242,1,1,144,1320,1176
28243,1,1,178,1558,1380
28244,1,1,350,1710,1360
28245,1,1,346,1300,954
28246,1,0,111,0,-111
28247,0,0,30,0,-30
28248,0,0,118,0,-118
28249,1,1,1660,1273,-387
28250,1,0,13,0,-13
28251,1,0,30,0,-30
28252,0,0,46,0,-46
28253,0,0,2,0,-2
28254,1,1,36,5188,5152
28255,0,0,43,0,-43
28256,0,0,15,0,-15
28257,1,1,117,1526,1409
28258,1,0,58,0,-58
28259,0,0,0,0,0
28260,0,0,9,0,-9
28261,0,0,21,0,-21
28262,1,1,733,1259,526
28263,1,0,24,0,-24
28264,0,0,76,0,-76
28265,0,0,182,0,-182
28266,1,1,1037,1296,259
28267,1,1,173,1903,1730
28268,0,0,73,0,-73
28269,1,1,2400,1422,-978
28270,0,0,76,0,-76
28271,1,0,50,0,-50
28272,0,0,101,0,-101
28273,1,1,479,1320,841
28274,1,0,7,0,-7
28275,0,0,80,0,-80
28276,0,0,77,0,-77
28277,1,1,470,1311,841
28278,1,1,176,1619,1443
28279,1,0,110,0,-110
28280,0,0,18,0,-18
28281,0,0,6,0,-6
28282,1,1,249,1890,1641
28283,0,0,25,0,-25
28284,1,0,42,0,-42
28285,0,0,48,0,-48
28286,0,0,6,0,-6
28287,1,0,1,0,-1
28288,1,0,60,0,-60
28289,1,1,860,1238,378
28290,1,0,39,0,-39
28291,1,1,208,1294,1086
28292,0,0,108,0,-108
28293,1,1,638,2068,1430
28294,1,0,39,0,-39
28295,1,1,351,2192,1841
28296,1,1,75,1814,1739
28297,1,0,65,0,-65
28298,1,0,30,0,-30
28299,1,1,1080,1362,282
28300,0,0,29,0,-29
28301,1,1,532,1916,1384
28302,1,1,1400,2631,1231
28303,0,0,44,0,-44
28304,1,1,873,1512,639
28305,0,0,27,0,-27
28306,0,0,57,0,-57
28307,1,0,18,0,-18
28308,1,1,901,1271,370
28309,1,0,100,0,-100
28310,0,0,27,0,-27
28311,1,1,139,4485,4346
28312,0,0,51,0,-51
28313,0,0,22,0,-22
28314,0,0,41,0,-41
28315,1,0,16,0,-16
28316,1,1,266,1247,981
28317,1,1,248,1251,1003
28318,1,0,34,0,-34
28319,0,0,15,0,-15
28320,1,1,547,1325,778
28321,0,0,101,0,-101
28322,1,0,32,0,-32
28323,0,0,92,0,-92
28324,1,1,741,3357,2616
28325,1,1,440,2105,1665
28326,0,0,128,0,-128
28327,1,1,1290,1860,570
28328,0,0,2,0,-2
28329,1,0,5,0,-5
28330,1,1,313,1799,1486
28331,0,0,2,0,-2
28332,1,1,362,1632,1270
28333,0,0,48,0,-48
28334,1,1,504,1417,913
28335,1,1,228,1370,1142
28336,0,0,13,0,-13
28337,1,1,157,1985,1828
28338,1,1,62,1217,1155
28339,1,0,75,0,-75
28340,1,0,3,0,-3
28341,1,1,347,1286,939
28342,0,0,32,0,-32
28343,1,0,25,0,-25
28344,0,0,133,0,-133
28345,1,0,14,0,-14
28346,1,0,2,0,-2
28347,1,1,995,1973,978
28348,1,0,93,0,-93
28349,0,0,34,0,-34
28350,1,1,945,1622,677
28351,1,1,408,2226,1818
28352,0,0,6,0,-6
28353,1,1,442,1555,1113
28354,0,0,67,0,-67
28355,1,0,168,0,-168
28356,0,0,71,0,-71
28357,1,1,920,1385,465
28358,0,0,9,0,-9
28359,0,0,42,0,-42
28360,0,0,85,0,-85
28361,0,0,27,0,-27
28362,0,0,53,0,-53
28363,0,0,13,0,-13
28364,0,0,14,0,-14
28365,0,0,28,0,-28
28366,0,0,1,0,-1
28367,1,0,174,0,-174
28368,0,0,0,0,0
28369,1,1,156,2028,1872
28370,0,0,56,0,-56
28371,1,1,1655,1768,113
28372,1,1,797,1642,845
28373,1,1,1669,1526,-143
28374,1,1,101,1397,1296
28375,0,0,44,0,-44
28376,1,1,588,1297,709
28377,1,0,27,0,-27
28378,0,0,90,0,-90
28379,1,0,13,0,-13
28380,1,0,48,0,-48
28381,1,0,48,0,-48
28382,0,0,28,0,-28
28383,1,1,577,1513,936
28384,1,1,624,1738,1114
28385,0,0,16,0,-16
28386,0,0,64,0,-64
28387,0,0,46,0,-46
28388,1,0,14,0,-14
28389,1,1,160,1403,1243
28390,1,1,354,1565,1211
28391,0,0,10,0,-10
28392,1,0,40,0,-40
28393,0,0,24,0,-24
28394,0,0,94,0,-94
28395,0,0,20,0,-20
28396,0,0,51,0,-51
28397,0,0,173,0,-173
28398,1,0,27,0,-27
28399,1,0,11,0,-11
28400,1,1,370,1402,1032
28401,0,0,2,0,-2
28402,1,0,17,0,-17
28403,1,0,2,0,-2
28404,0,0,80,0,-80
28405,1,0,2,0,-2
28406,1,0,7,0,-7
28407,0,0,69,0,-69
28408,1,1,1285,1312,27
28409,1,1,183,2081,1898
28410,1,1,603,1477,874
28411,1,0,0,0,0
28412,0,0,74,0,-74
28413,1,0,16,0,-16
28414,1,0,38,0,-38
28415,0,0,107,0,-107
28416,1,1,144,1257,1113
28417,0,0,13,0,-13
28418,1,1,78,1963,1885
28419,0,0,126,0,-126
28420,1,1,653,1308,655
28421,0,0,27,0,-27
28422,1,0,13,0,-13
28423,1,1,211,1775,1564
28424,1,0,4,0,-4
28425,1,1,660,1460,800
28426,0,0,0,0,0
28427,0,0,36,0,-36
28428,1,1,420,2062,1642
28429,1,1,1590,1224,-366
28430,1,0,21,0,-21
28431,1,0,79,0,-79
28432,1,0,58,0,-58
28433,0,0,43,0,-43
28434,1,1,233,1809,1576
28435,1,0,85,0,-85
28436,0,0,2,0,-2
28437,0,0,66,0,-66
28438,0,0,16,0,-16
28439,0,0,193,0,-193
28440,0,0,73,0,-73
28441,1,0,16,0,-16
28442,1,0,12,0,-12
28443,0,0,65,0,-65
28444,1,1,199,1589,1390
28445,0,0,136,0,-136
28446,1,0,144,0,-144
28447,1,1,36,1533,1497
28448,0,0,81,0,-81
28449,1,1,109,1393,1284
28450,1,1,1165,1368,203
28451,1,1,163,1391,1228
28452,0,0,0,0,0
28453,1,0,142,0,-142
28454,1,1,358,1236,878
28455,1,1,702,1321,619
28456,1,1,168,1247,1079
28457,1,1,321,1453,1132
28458,1,0,15,0,-15
28459,1,1,556,1489,933
28460,1,1,1096,1444,348
28461,1,1,615,1624,1009
28462,0,0,57,0,-57
28463,1,0,16,0,-16
28464,1,1,94,1449,1355
28465,1,1,1729,1310,-419
28466,0,0,67,0,-67
28467,0,0,15,0,-15
28468,1,1,1105,1510,405
28469,1,1,50,1695,1645
28470,0,0,33,0,-33
28471,0,0,29,0,-29
28472,1,0,2,0,-2
28473,1,1,207,1557,1350
28474,1,0,88,0,-88
28475,0,0,157,0,-157
28476,1,0,109,0,-109
28477,1,1,812,1503,691
28478,0,0,87,0,-87
28479,1,1,145,1267,1122
28480,1,1,223,1389,1166
28481,1,1,569,1300,731
28482,1,1,1518,1320,-198
28483,1,1,124,2514,2390
28484,1,1,697,1218,521
28485,0,0,32,0,-32
28486,1,0,25,0,-25
28487,0,0,11,0,-11
28488,0,0,44,0,-44
28489,0,0,136,0,-136
28490,1,1,1413,1369,-44
28491,1,1,381,1204,823
28492,0,0,27,0,-27
28493,1,0,234,0,-234
28494,1,0,56,0,-56
28495,1,1,1080,6452,5372
28496,1,1,53,1702,1649
28497,0,0,222,0,-222
28498,0,0,18,0,-18
28499,0,0,116,0,-116
28500,1,0,34,0,-34
28501,0,0,64,0,-64
28502,0,0,54,0,-54
28503,0,0,7,0,-7
28504,1,1,502,1330,828
28505,0,0,79,0,-79
28506,1,1,370,1575,1205
28507,1,0,8,0,-8
28508,1,1,133,1421,1288
28509,1,0,44,0,-44
28510,1,0,46,0,-46
28511,0,0,8,0,-8
28512,1,0,17,0,-17
28513,1,1,115,1241,1126
28514,0,0,24,0,-24
28515,1,1,46,1399,1353
28516,1,1,367,1588,1221
28517,0,0,17,0,-17
28518,1,1,1002,1449,447
28519,1,1,341,1774,1433
28520,1,1,164,1623,1459
28521,1,1,669,1565,896
28522,1,1,581,1601,1020
28523,0,0,86,0,-86
28524,1,0,14,0,-14
28525,0,0,67,0,-67
28526,0,0,91,0,-91
28527,1,0,79,0,-79
28528,1,0,4,0,-4
28529,0,0,53,0,-53
28530,0,0,29,0,-29
28531,0,0,36,0,-36
28532,0,0,40,0,-40
28533,0,0,15,0,-15
28534,0,0,87,0,-87
28535,1,1,109,2379,2270
28536,1,1,209,1279,1070
28537,0,0,39,0,-39
28538,1,0,61,0,-61
28539,1,1,1502,2096,594
28540,1,1,352,1606,1254
28541,0,0,10,0,-10
28542,0,0,29,0,-29
28543,0,0,7,0,-7
28544,0,0,1,0,-1
28545,0,0,107,0,-107
28546,0,0,10,0,-10
28547,0,0,5,0,-5
28548,1,1,118,1395,1277
28549,1,0,30,0,-30
28550,0,0,29,0,-29
28551,1,1,435,2829,2394
28552,0,0,46,0,-46
28553,1,0,31,0,-31
28554,1,1,289,1224,935
28555,0,0,49,0,-49
28556,1,0,8,0,-8
28557,1,1,445,1276,831
28558,1,0,56,0,-56
28559,1,0,30,0,-30
28560,0,0,25,0,-25
28561,0,0,95,0,-95
28562,1,1,244,2672,2428
28563,1,1,446,1448,1002
28564,0,0,30,0,-30
28565,1,1,443,1370,927
28566,1,0,3,0,-3
28567,1,0,59,0,-59
28568,1,1,1694,1305,-389
28569,1,1,72,1591,1519
28570,1,1,620,1573,953
28571,1,1,930,1460,530
28572,1,0,59,0,-59
28573,0,0,26,0,-26
28574,0,0,48,0,-48
28575,1,0,16,0,-16
28576,0,0,39,0,-39
28577,0,0,90,0,-90
28578,1,1,837,1431,594
28579,0,0,184,0,-184
28580,0,0,51,0,-51
28581,0,0,7,0,-7
28582,0,0,34,0,-34
28583,0,0,73,0,-73
28584,0,0,14,0,-14
28585,1,0,102,0,-102
28586,0,0,64,0,-64
28587,0,0,44,0,-44
28588,0,0,77,0,-77
28589,0,0,50,0,-50
28590,1,0,17,0,-17
28591,1,1,164,1880,1716
28592,1,1,385,1400,1015
28593,1,1,923,1395,472
28594,0,0,24,0,-24
28595,1,1,2301,1378,-923
28596,1,1,476,1260,784
28597,1,0,164,0,-164
28598,0,0,90,0,-90
28599,0,0,17,0,-17
28600,0,0,1,0,-1
28601,0,0,8,0,-8
28602,1,1,1030,1353,323
28603,1,0,72,0,-72
28604,1,1,204,1762,1558
28605,0,0,57,0,-57
28606,1,1,308,1287,979
28607,1,1,1878,1242,-636
28608,1,0,19,0,-19
28609,0,0,42,0,-42
28610,0,0,14,0,-14
28611,0,0,20,0,-20
28612,1,0,70,0,-70
28613,1,1,210,1260,1050
28614,1,1,77,1466,1389
28615,0,0,59,0,-59
28616,0,0,14,0,-14
28617,1,1,355,1216,861
28618,1,0,32,0,-32
28619,1,1,197,1656,1459
28620,1,1,1274,1221,-53
28621,0,0,162,0,-162
28622,0,0,9,0,-9
28623,0,0,8,0,-8
28624,0,0,34,0,-34
28625,0,0,96,0,-96
28626,1,1,300,1267,967
28627,0,0,16,0,-16
28628,0,0,12,0,-12
28629,1,0,13,0,-13
28630,1,1,338,1965,1627
28631,0,0,90,0,-90
28632,1,0,5,0,-5
28633,1,1,163,1600,1437
28634,1,1,611,2433,1822
28635,1,0,35,0,-35
28636,1,1,934,1459,525
28637,0,0,34,0,-34
28638,0,0,93,0,-93
28639,1,0,0,0,0
28640,0,0,58,0,-58
28641,0,0,64,0,-64
28642,0,0,60,0,-60
28643,1,1,161,1695,1534
28644,0,0,11,0,-11
28645,0,0,83,0,-83
28646,1,0,49,0,-49
28647,1,1,274,2649,2375
28648,0,0,218,0,-218
28649,1,0,32,0,-32
28650,1,1,562,1288,726
28651,1,1,1196,1622,426
28652,0,0,17,0,-17
28653,0,0,312,0,-312
28654,0,0,87,0,-87
28655,1,1,463,1883,1420
28656,1,0,19,0,-19
28657,1,1,125,1215,1090
28658,1,0,7,0,-7
28659,1,1,601,1253,652
28660,1,0,58,0,-58
28661,0,0,24,0,-24
28662,0,0,25,0,-25
28663,1,0,0,0,0
28664,0,0,115,0,-115
28665,1,1,12,1395,1383
28666,1,1,462,1365,903
28667,0,0,13,0,-13
28668,1,1,883,1332,449
28669,1,0,17,0,-17
28670,0,0,55,0,-55
28671,1,1,1197,2022,825
28672,0,0,104,0,-104
28673,1,0,201,0,-201
28674,0,0,10,0,-10
28675,0,0,98,0,-98
28676,1,0,8,0,-8
28677,1,0,41,0,-41
28678,1,1,152,1249,1097
28679,0,0,51,0,-51
28680,1,1,406,1468,1062
28681,1,1,481,1438,957
28682,1,0,24,0,-24
28683,0,0,23,0,-23
28684,0,0,36,0,-36
28685,1,0,4,0,-4
28686,0,0,33,0,-33
28687,0,0,15,0,-15
28688,0,0,91,0,-91
28689,1,1,166,1226,1060
28690,0,0,20,0,-20
28691,1,0,80,0,-80
28692,0,0,8,0,-8
28693,0,0,36,0,-36
28694,1,1,640,1200,560
28695,1,1,94,1233,1139
28696,0,0,2,0,-2
28697,1,0,46,0,-46
28698,0,0,6,0,-6
28699,1,0,103,0,-103
28700,0,0,37,0,-37
28701,0,0,42,0,-42
28702,0,0,1,0,-1
28703,1,0,34,0,-34
28704,1,0,35,0,-35
28705,0,0,106,0,-106
28706,1,1,189,1272,1083
28707,1,1,226,1446,1220
28708,0,0,3,0,-3
28709,1,1,358,1697,1339
28710,1,1,694,1567,873
28711,1,0,46,0,-46
28712,0,0,67,0,-67
28713,1,1,1918,1505,-413
28714,0,0,1,0,-1
28715,1,0,47,0,-47
28716,1,0,5,0,-5
28717,0,0,104,0,-104
28718,0,0,4,0,-4
28719,0,0,67,0,-67
28720,1,0,8,0,-8
28721,1,0,2,0,-2
28722,0,0,11,0,-11
28723,0,0,27,0,-27
28724,0,0,26,0,-26
28725,1,1,193,1243,1050
28726,0,0,1,0,-1
28727,0,0,228,0,-228
28728,1,1,49,1384,1335
28729,0,0,25,0,-25
28730,1,1,574,1273,699
28731,0,0,50,0,-50
28732,1,1,137,2330,2193
28733,1,1,745,1519,774
28734,1,0,8,0,-8
28735,1,1,139,1818,1679
28736,0,0,18,0,-18
28737,1,1,239,1882,1643
28738,0,0,20,0,-20
28739,0,0,54,0,-54
28740,0,0,35,0,-35
28741,1,1,1370,1204,-166
28742,1,1,681,1394,713
28743,0,0,100,0,-100
28744,0,0,72,0,-72
28745,0,0,85,0,-85
28746,1,1,816,2281,1465
28747,0,0,2,0,-2
28748,0,0,43,0,-43
28749,0,0,93,0,-93
28750,1,1,265,1483,1218
28751,1,1,1891,1616,-275
28752,1,1,177,1305,1128
28753,1,0,121,0,-121
28754,1,0,13,0,-13
28755,1,0,36,0,-36
28756,0,0,24,0,-24
28757,1,0,101,0,-101
28758,1,0,30,0,-30
28759,0,0,21,0,-21
28760,0,0,86,0,-86
28761,1,1,1034,1644,610
28762,0,0,1,0,-1
28763,1,0,47,0,-47
28764,1,0,62,0,-62
28765,0,0,11,0,-11
28766,0,0,97,0,-97
28767,1,1,232,1293,1061
28768,0,0,43,0,-43
28769,1,1,1593,1727,134
28770,1,0,12,0,-12
28771,0,0,16,0,-16
28772,0,0,109,0,-109
28773,0,0,38,0,-38
28774,1,1,258,1746,1488
28775,0,0,27,0,-27
28776,1,1,160,1235,1075
28777,1,1,115,1344,1229
28778,1,1,442,1223,781
28779,1,1,76,1206,1130
28780,1,0,25,0,-25
28781,1,1,35,1539,1504
28782,0,0,173,0,-173
28783,1,1,90,1331,1241
28784,1,1,568,1512,944
28785,0,0,43,0,-43
28786,1,1,459,1205,746
28787,0,0,11,0,-11
28788,1,1,105,1523,1418
28789,1,1,215,1522,1307
28790,0,0,46,0,-46
28791,0,0,175,0,-175
28792,0,0,114,0,-114
28793,1,1,1060,1237,177
28794,0,0,14,0,-14
28795,1,0,49,0,-49
28796,0,0,58,0,-58
28797,1,1,92,1511,1419
28798,0,0,6,0,-6
28799,1,0,11,0,-11
28800,1,0,6,0,-6
28801,1,0,14,0,-14
28802,0,0,59,0,-59
28803,0,0,5,0,-5
28804,0,0,6,0,-6
28805,1,0,6,0,-6
28806,0,0,52,0,-52
28807,0,0,50,0,-50
28808,1,1,226,1316,1090
28809,1,0,3,0,-3
28810,1,0,56,0,-56
28811,1,1,197,2140,1943
28812,1,0,12,0,-12
28813,0,0,47,0,-47
28814,0,0,25,0,-25
28815,1,1,740,1232,492
28816,1,1,189,1293,1104
28817,1,0,6,0,-6
28818,1,0,14,0,-14
28819,1,0,128,0,-128
28820,0,0,88,0,-88
28821,1,0,11,0,-11
28822,0,0,47,0,-47
28823,1,1,85,1265,1180
28824,0,0,60,0,-60
28825,1,1,1146,1537,391
28826,0,0,22,0,-22
28827,1,0,2,0,-2
28828,0,0,12,0,-12
28829,0,0,123,0,-123
28830,0,0,35,0,-35
28831,1,0,18,0,-18
28832,0,0,7,0,-7
28833,1,1,185,1505,1320
28834,0,0,7,0,-7
28835,1,0,20,0,-20
28836,0,0,12,0,-12
28837,1,0,8,0,-8
28838,1,1,432,2216,1784
28839,1,0,33,0,-33
28840,0,0,23,0,-23
28841,1,0,55,0,-55
28842,1,0,31,0,-31
28843,1,0,91,0,-91
28844,1,1,597,1537,940
28845,0,0,4,0,-4
28846,0,0,45,0,-45
28847,1,1,333,1246,913
28848,0,0,5,0,-5
28849,0,0,238,0,-238
28850,0,0,112,0,-112
28851,0,0,111,0,-111
28852,1,0,38,0,-38
28853,1,1,454,1679,1225
28854,0,0,15,0,-15
28855,1,1,466,1266,800
28856,1,0,89,0,-89
28857,0,0,176,0,-176
28858,1,0,46,0,-46
28859,0,0,52,0,-52
28860,0,0,113,0,-113
28861,0,0,6,0,-6
28862,1,0,16,0,-16
28863,0,0,0,0,0
28864,1,0,83,0,-83
28865,0,0,133,0,-133
28866,0,0,17,0,-17
28867,1,1,380,1265,885
28868,0,0,78,0,-78
28869,1,0,90,0,-90
28870,0,0,40,0,-40
28871,0,0,4,0,-4
28872,1,1,117,1521,1404
28873,0,0,148,0,-148
28874,1,1,1007,1756,749
28875,1,0,48,0,-48
28876,0,0,17,0,-17
28877,1,0,64,0,-64
28878,1,0,59,0,-59
28879,1,0,11,0,-11
28880,1,1,2260,1705,-555
28881,1,1,227,2193,1966
28882,0,0,268,0,-268
28883,0,0,161,0,-161
28884,1,0,11,0,-11
28885,1,1,58,1708,1650
28886,0,0,3,0,-3
28887,0,0,6,0,-6
28888,1,1,332,1214,882
28889,1,1,25,1222,1197
28890,0,0,108,0,-108
28891,1,0,72,0,-72
28892,1,0,84,0,-84
28893,0,0,32,0,-32
28894,1,0,41,0,-41
28895,1,1,74,1254,1180
28896,0,0,39,0,-39
28897,1,0,26,0,-26
28898,0,0,15,0,-15
28899,0,0,14,0,-14
28900,1,0,24,0,-24
28901,1,1,98,1203,1105
28902,1,1,113,1218,1105
28903,0,0,65,0,-65
28904,0,0,57,0,-57
28905,0,0,43,0,-43
28906,1,1,579,1342,763
28907,1,1,1110,1411,301
28908,0,0,57,0,-57
28909,0,0,13,0,-13
28910,1,0,55,0,-55
28911,0,0,7,0,-7
28912,1,1,807,1374,567
28913,1,1,1467,1586,119
28914,0,0,13,0,-13
28915,1,1,1346,1397,51
28916,1,1,453,2211,1758
28917,1,0,19,0,-19
28918,0,0,54,0,-54
28919,0,0,20,0,-20
28920,0,0,95,0,-95
28921,0,0,34,0,-34
28922,1,0,4,0,-4
28923,0,0,25,0,-25
28924,1,1,2056,1432,-624
28925,1,1,350,1699,1349
28926,0,0,83,0,-83
28927,1,0,27,0,-27
28928,1,1,851,1378,527
28929,1,0,3,0,-3
28930,0,0,31,0,-31
28931,1,1,287,1515,1228
28932,1,0,43,0,-43
28933,0,0,66,0,-66
28934,1,0,18,0,-18
28935,1,1,1191,1348,157
28936,1,1,158,1264,1106
28937,0,0,44,0,-44
28938,0,0,98,0,-98
28939,1,0,142,0,-142
28940,0,0,38,0,-38
28941,0,0,32,0,-32
28942,1,0,239,0,-239
28943,0,0,132,0,-132
28944,1,0,41,0,-41
28945,1,0,88,0,-88
28946,1,0,42,0,-42
28947,0,0,19,0,-19
28948,0,0,12,0,-12
28949,1,0,15,0,-15
28950,0,0,47,0,-47
28951,0,0,6,0,-6
28952,1,0,20,0,-20
28953,1,0,105,0,-105
28954,0,0,10,0,-10
28955,1,0,41,0,-41
28956,1,1,349,1292,943
28957,0,0,34,0,-34
28958,1,0,35,0,-35
28959,0,0,56,0,-56
28960,1,1,1253,1278,25
28961,1,1,854,1278,424
28962,1,0,3,0,-3
28963,0,0,27,0,-27
28964,0,0,0,0,0
28965,0,0,52,0,-52
28966,1,0,114,0,-114
28967,0,0,100,0,-100
28968,1,0,31,0,-31
28969,1,1,60,1248,1188
28970,1,1,144,1293,1149
28971,0,0,34,0,-34
28972,1,1,335,3879,3544
28973,0,0,60,0,-60
28974,0,0,36,0,-36
28975,1,0,33,0,-33
28976,0,0,3,0,-3
28977,1,0,12,0,-12
28978,1,1,350,1431,1081
28979,0,0,90,0,-90
28980,1,0,41,0,-41
28981,1,0,8,0,-8
28982,1,0,17,0,-17
28983,1,1,46,1382,1336
28984,1,1,135,1592,1457
28985,1,0,1,0,-1
28986,1,1,260,1341,1081
28987,1,1,279,1353,1074
28988,0,0,5,0,-5
28989,1,0,72,0,-72
28990,1,1,172,1833,1661
28991,1,1,431,1370,939
28992,1,1,740,1342,602
28993,1,0,16,0,-16
28994,0,0,100,0,-100
28995,0,0,167,0,-167
28996,1,0,23,0,-23
28997,1,0,27,0,-27
28998,0,0,3,0,-3
28999,1,0,52,0,-52
