ID,Флаг дозвона,Флаг продажи,Расходы,PV,NPV
0,1,0,27,0,-27
1,1,1,303,1406,1103
2,0,0,2,0,-2
3,1,1,1001,1266,265
4,1,1,406,1675,1269
5,1,1,370,1798,1428
6,0,0,135,0,-135
7,1,1,1390,1313,-77
8,1,0,49,0,-49
9,0,0,77,0,-77
10,1,0,61,0,-61
11,0,0,4,0,-4
12,1,0,20,0,-20
13,0,0,51,0,-51
14,1,1,694,1451,757
15,1,1,379,1263,884
16,0,0,45,0,-45
17,0,0,19,0,-19
18,1,0,119,0,-119
19,0,0,29,0,-29
20,1,1,554,1284,730
21,1,1,77,1778,1701
22,1,0,0,0,0
23,0,0,22,0,-22
24,1,0,37,0,-37
25,1,1,718,1218,500
26,0,0,18,0,-18
27,1,0,37,0,-37
28,1,1,1225,1663,438
29,1,0,22,0,-22
30,0,0,29,0,-29
31,1,1,1053,1765,712
32,0,0,47,0,-47
33,1,1,76,1251,1175
34,0,0,70,0,-70
35,1,0,26,0,-26
36,0,0,6,0,-6
37,1,0,71,0,-71
38,1,1,294,1247,953
39,1,0,88,0,-88
40,0,0,19,0,-19
41,0,0,126,0,-126
42,1,1,153,1622,1469
43,1,0,14,0,-14
44,0,0,8,0,-8
45,1,0,26,0,-26
46,0,0,58,0,-58
47,0,0,61,0,-61
48,1,0,9,0,-9
49,1,1,695,1211,516
50,1,1,337,1842,1505
51,0,0,7,0,-7
52,1,0,169,0,-169
53,1,0,33,0,-33
54,1,0,25,0,-25
55,0,0,45,0,-45
56,0,0,42,0,-42
57,0,0,0,0,0
58,0,0,63,0,-63
59,1,0,38,0,-38
60,0,0,74,0,-74
61,0,0,86,0,-86
62,1,1,424,1729,1305
63,0,0,12,0,-12
64,1,0,131,0,-131
65,1,0,5,0,-5
66,0,0,265,0,-265
67,0,0,3,0,-3
68,1,1,212,1363,1151
69,0,0,4,0,-4
70,1,0,28,0,-28
71,1,1,2076,1362,-714
72,0,0,24,0,-24
73,0,0,159,0,-159
74,1,1,63,1588,1525
75,0,0,5,0,-5
76,0,0,14,0,-14
77,0,0,11,0,-11
78,1,0,83,0,-83
79,0,0,24,0,-24
80,0,0,38,0,-38
81,0,0,61,0,-61
82,1,1,364,1659,1295
83,0,0,4,0,-4
84,1,0,41,0,-41
85,1,0,5,0,-5
86,0,0,44,0,-44
87,1,1,406,1331,925
88,1,0,18,0,-18
89,1,1,432,4400,3968
90,1,1,155,2070,1915
91,0,0,7,0,-7
92,1,0,172,0,-172
93,1,0,32,0,-32
94,1,1,717,1579,862
95,1,1,1092,1435,343
96,0,0,120,0,-120
97,0,0,26,0,-26
98,1,1,977,1334,357
99,1,0,56,0,-56
100,0,0,36,0,-36
101,0,0,98,0,-98
102,0,0,34,0,-34
103,1,1,897,1957,1060
104,1,1,121,1444,1323
105,1,1,246,1658,1412
106,1,1,307,1208,901
107,0,0,21,0,-21
108,1,1,49,1759,1710
109,0,0,34,0,-34
110,0,0,79,0,-79
111,0,0,0,0,0
112,1,1,71,1491,1420
113,1,1,243,1536,1293
114,1,0,219,0,-219
115,0,0,32,0,-32
116,1,1,102,1206,1104
117,1,1,110,1213,1103
118,1,1,783,1202,419
119,1,0,2,0,-2
120,1,1,37,1792,1755
121,0,0,8,0,-8
122,1,0,10,0,-10
123,0,0,0,0,0
124,1,0,12,0,-12
125,0,0,117,0,-117
126,1,1,730,1313,583
127,0,0,13,0,-13
128,0,0,9,0,-9
129,1,0,54,0,-54
130,1,1,450,1383,933
131,0,0,72,0,-72
132,1,1,1115,1229,114
133,0,0,61,0,-61
134,1,1,353,1286,933
135,0,0,60,0,-60
136,1,1,385,1457,1072
137,1,1,412,2656,2244
138,1,0,14,0,-14
139,1,0,25,0,-25
140,1,1,457,1332,875
141,0,0,1,0,-1
142,0,0,49,0,-49
143,0,0,50,0,-50
144,0,0,17,0,-17
145,0,0,16,0,-16
146,0,0,68,0,-68
147,1,1,439,1312,873
148,1,0,26,0,-26
149,1,1,1329,1462,133
150,1,1,256,1453,1197
151,0,0,11,0,-11
152,1,1,477,3371,2894
153,1,1,182,1342,1160
154,1,0,143,0,-143
155,0,0,13,0,-13
156,0,0,68,0,-68
157,1,0,9,0,-9
158,1,0,96,0,-96
159,1,0,8,0,-8
160,1,0,26,0,-26
161,0,0,16,0,-16
162,1,1,36,1545,1509
163,1,1,427,1951,1524
164,0,0,30,0,-30
165,1,0,26,0,-26
166,1,0,124,0,-124
167,0,0,3,0,-3
168,0,0,26,0,-26
169,1,1,294,1230,936
170,0,0,37,0,-37
171,0,0,68,0,-68
172,1,1,158,1684,1526
173,1,0,9,0,-9
174,1,1,25,2031,2006
175,0,0,5,0,-5
176,1,1,791,1595,804
177,1,1,1079,1212,133
178,0,0,41,0,-41
179,1,1,794,1665,871
180,1,1,785,1201,416
181,0,0,89,0,-89
182,1,1,1028,1281,253
183,1,1,630,1224,594
184,0,0,16,0,-16
185,0,0,53,0,-53
186,1,0,15,0,-15
187,1,1,1715,1529,-186
188,0,0,65,0,-65
189,1,0,34,0,-34
190,1,1,709,1256,547
191,0,0,76,0,-76
192,0,0,59,0,-59
193,0,0,41,0,-41
194,0,0,15,0,-15
195,1,0,136,0,-136
196,0,0,1,0,-1
197,1,0,38,0,-38
198,1,0,54,0,-54
199,0,0,20,0,-20
200,1,1,842,1936,1094
201,1,0,2,0,-2
202,0,0,85,0,-85
203,1,1,181,1473,1292
204,1,1,534,1220,686
205,1,0,49,0,-49
206,1,0,6,0,-6
207,0,0,73,0,-73
208,0,0,4,0,-4
209,0,0,27,0,-27
210,1,1,365,3460,3095
211,1,1,353,1254,901
212,1,0,10,0,-10
213,0,0,56,0,-56
214,1,0,34,0,-34
215,0,0,77,0,-77
216,0,0,17,0,-17
217,1,0,34,0,-34
218,0,0,5,0,-5
219,1,0,60,0,-60
220,1,1,243,1506,1263
221,1,0,75,0,-75
222,0,0,35,0,-35
223,1,1,58,1282,1224
224,0,0,0,0,0
225,1,0,23,0,-23
226,0,0,35,0,-35
227,1,0,20,0,-20
228,0,0,56,0,-56
229,1,1,136,1406,1270
230,0,0,158,0,-158
231,1,1,590,1343,753
232,0,0,7,0,-7
233,1,0,6,0,-6
234,0,0,33,0,-33
235,1,1,189,1443,1254
236,0,0,4,0,-4
237,1,1,420,1352,932
238,0,0,18,0,-18
239,1,1,101,1528,1427
240,1,0,168,0,-168
241,0,0,9,0,-9
242,1,1,1118,1314,196
243,0,0,0,0,0
244,1,0,16,0,-16
245,1,0,68,0,-68
246,0,0,29,0,-29
247,1,0,87,0,-87
248,1,1,777,1607,830
249,0,0,97,0,-97
250,0,0,2,0,-2
251,0,0,81,0,-81
252,1,0,45,0,-45
253,1,1,22,2432,2410
254,0,0,63,0,-63
255,1,1,117,1414,1297
256,1,0,9,0,-9
257,1,1,390,1323,933
258,0,0,163,0,-163
259,1,1,312,1423,1111
260,0,0,27,0,-27
261,0,0,211,0,-211
262,0,0,16,0,-16
263,0,0,13,0,-13
264,0,0,1,0,-1
265,0,0,65,0,-65
266,1,1,32,2290,2258
267,0,0,19,0,-19
268,1,0,107,0,-107
269,1,0,73,0,-73
270,1,1,397,1713,1316
271,1,1,877,1615,738
272,1,0,48,0,-48
273,0,0,130,0,-130
274,1,0,91,0,-91
275,1,1,893,1447,554
276,1,0,12,0,-12
277,1,1,706,1522,816
278,1,1,577,1636,1059
279,0,0,65,0,-65
280,1,0,15,0,-15
281,0,0,95,0,-95
282,1,0,5,0,-5
283,1,0,114,0,-114
284,1,0,0,0,0
285,0,0,2,0,-2
286,0,0,5,0,-5
287,0,0,173,0,-173
288,1,0,66,0,-66
289,1,0,3,0,-3
290,0,0,14,0,-14
291,1,0,17,0,-17
292,1,0,1,0,-1
293,0,0,79,0,-79
294,0,0,15,0,-15
295,0,0,45,0,-45
296,1,1,60,1326,1266
297,0,0,8,0,-8
298,1,1,714,1309,595
299,1,0,40,0,-40
300,1,1,531,1668,1137
301,0,0,60,0,-60
302,0,0,87,0,-87
303,1,1,327,1339,1012
304,1,1,256,1517,1261
305,0,0,18,0,-18
306,1,1,206,1291,1085
307,0,0,13,0,-13
308,0,0,1,0,-1
309,0,0,125,0,-125
310,1,1,580,1654,1074
311,1,0,27,0,-27
312,0,0,24,0,-24
313,1,0,25,0,-25
314,1,0,100,0,-100
315,1,0,28,0,-28
316,1,0,13,0,-13
317,0,0,16,0,-16
318,1,0,95,0,-95
319,0,0,63,0,-63
320,0,0,31,0,-31
321,1,1,151,1714,1563
322,1,0,28,0,-28
323,1,1,241,1261,1020
324,1,0,290,0,-290
325,0,0,27,0,-27
326,1,1,220,2075,1855
327,1,1,391,2775,2384
328,0,0,27,0,-27
329,0,0,109,0,-109
330,1,1,134,1546,1412
331,0,0,205,0,-205
332,0,0,111,0,-111
333,1,0,40,0,-40
334,0,0,80,0,-80
335,1,0,174,0,-174
336,1,1,173,1863,1690
337,0,0,111,0,-111
338,1,0,22,0,-22
339,0,0,74,0,-74
340,0,0,105,0,-105
341,1,0,14,0,-14
342,0,0,23,0,-23
343,0,0,9,0,-9
344,0,0,181,0,-181
345,0,0,58,0,-58
346,0,0,1,0,-1
347,1,0,42,0,-42
348,1,1,894,2344,1450
349,1,1,209,1334,1125
350,0,0,0,0,0
351,1,0,19,0,-19
352,1,0,78,0,-78
353,1,1,270,1924,1654
354,0,0,10,0,-10
355,0,0,67,0,-67
356,1,1,104,1628,1524
357,0,0,0,0,0
358,1,0,81,0,-81
359,0,0,46,0,-46
360,1,0,121,0,-121
361,1,0,45,0,-45
362,0,0,57,0,-57
363,1,1,1061,1569,508
364,1,0,39,0,-39
365,1,1,364,1224,860
366,1,0,52,0,-52
367,1,1,382,1439,1057
368,0,0,35,0,-35
369,1,0,22,0,-22
370,0,0,153,0,-153
371,1,1,1109,1204,95
372,0,0,115,0,-115
373,1,1,354,1545,1191
374,1,1,304,1482,1178
375,1,1,1131,1527,396
376,0,0,7,0,-7
377,1,0,13,0,-13
378,1,0,119,0,-119
379,1,1,202,1256,1054
380,0,0,0,0,0
381,0,0,12,0,-12
382,1,0,22,0,-22
383,1,0,5,0,-5
384,0,0,0,0,0
385,1,1,1559,1280,-279
386,0,0,45,0,-45
387,1,1,229,1337,1108
388,0,0,16,0,-16
389,0,0,66,0,-66
390,1,1,567,1789,1222
391,1,0,33,0,-33
392,0,0,44,0,-44
393,0,0,29,0,-29
394,1,1,834,1285,451
395,0,0,50,0,-50
396,0,0,2,0,-2
397,0,0,71,0,-71
398,1,1,1197,1384,187
399,0,0,3,0,-3
400,1,1,837,1426,589
401,0,0,58,0,-58
402,1,0,71,0,-71
403,0,0,26,0,-26
404,0,0,20,0,-20
405,1,1,322,1259,937
406,0,0,98,0,-98
407,0,0,45,0,-45
408,1,1,315,1644,1329
409,1,0,24,0,-24
410,1,0,15,0,-15
411,1,1,322,1393,1071
412,1,1,155,1848,1693
413,1,0,7,0,-7
414,1,1,482,1711,1229
415,1,0,46,0,-46
416,0,0,57,0,-57
417,1,0,7,0,-7
418,0,0,59,0,-59
419,1,1,143,1579,1436
420,0,0,76,0,-76
421,1,0,63,0,-63
422,0,0,32,0,-32
423,1,1,238,1795,1557
424,1,1,805,1325,520
425,1,1,723,2119,1396
426,1,0,21,0,-21
427,1,1,927,1918,991
428,0,0,29,0,-29
429,0,0,79,0,-79
430,1,1,49,1345,1296
431,0,0,16,0,-16
432,1,0,19,0,-19
433,0,0,13,0,-13
434,1,1,186,1233,1047
435,1,1,145,1443,1298
436,1,0,18,0,-18
437,0,0,6,0,-6
438,1,0,190,0,-190
439,0,0,129,0,-129
440,0,0,53,0,-53
441,0,0,34,0,-34
442,0,0,35,0,-35
443,1,0,0,0,0
444,1,0,45,0,-45
445,1,1,1110,1426,316
446,1,1,345,3529,3184
447,0,0,54,0,-54
448,0,0,44,0,-44
449,1,0,181,0,-181
450,0,0,15,0,-15
451,1,0,3,0,-3
452,0,0,51,0,-51
453,1,1,1049,1572,523
454,1,1,744,1405,661
455,1,1,981,1812,831
456,0,0,35,0,-35
457,1,0,69,0,-69
458,1,0,36,0,-36
459,0,0,20,0,-20
460,0,0,149,0,-149
461,0,0,69,0,-69
462,1,0,164,0,-164
463,0,0,5,0,-5
464,1,0,22,0,-22
465,1,0,0,0,0
466,1,1,409,1345,936
467,0,0,4,0,-4
468,1,1,254,1260,1006
469,0,0,26,0,-26
470,0,0,1,0,-1
471,1,0,55,0,-55
472,1,0,4,0,-4
473,1,1,516,1275,759
474,1,1,316,1237,921
475,0,0,6,0,-6
476,0,0,68,0,-68
477,0,0,80,0,-80
478,1,1,498,1673,1175
479,0,0,34,0,-34
480,1,1,111,1389,1278
481,0,0,12,0,-12
482,0,0,37,0,-37
483,0,0,21,0,-21
484,1,0,4,0,-4
485,1,0,165,0,-165
486,1,0,23,0,-23
487,0,0,2,0,-2
488,0,0,78,0,-78
489,0,0,50,0,-50
490,1,1,149,2447,2298
491,0,0,114,0,-114
492,0,0,4,0,-4
493,1,1,215,1381,1166
494,1,1,1838,1326,-512
495,1,1,490,1359,869
496,0,0,0,0,0
497,1,1,112,1258,1146
498,1,1,125,2010,1885
499,0,0,16,0,-16
500,0,0,37,0,-37
501,1,0,2,0,-2
502,1,1,204,1558,1354
503,1,1,547,1256,709
504,1,1,125,1305,1180
505,1,0,35,0,-35
506,0,0,94,0,-94
507,1,0,66,0,-66
508,0,0,52,0,-52
509,1,1,882,2272,1390
510,1,1,264,1268,1004
511,1,1,876,1513,637
512,0,0,10,0,-10
513,1,1,227,1956,1729
514,1,0,5,0,-5
515,1,0,141,0,-141
516,1,0,3,0,-3
517,0,0,18,0,-18
518,0,0,57,0,-57
519,1,1,823,1218,395
520,0,0,11,0,-11
521,0,0,26,0,-26
522,1,1,976,1692,716
523,0,0,161,0,-161
524,1,0,7,0,-7
525,1,0,68,0,-68
526,1,0,27,0,-27
527,1,0,284,0,-284
528,1,0,16,0,-16
529,1,1,404,2150,1746
530,0,0,41,0,-41
531,0,0,9,0,-9
532,0,0,25,0,-25
533,1,1,483,1789,1306
534,1,0,176,0,-176
535,1,0,50,0,-50
536,0,0,32,0,-32
537,1,1,1877,1657,-220
538,0,0,132,0,-132
539,0,0,0,0,0
540,0,0,40,0,-40
541,0,0,216,0,-216
542,1,0,63,0,-63
543,1,0,81,0,-81
544,1,0,15,0,-15
545,0,0,30,0,-30
546,1,0,9,0,-9
547,0,0,61,0,-61
548,1,0,124,0,-124
549,0,0,100,0,-100
550,0,0,6,0,-6
551,1,1,261,1399,1138
552,0,0,4,0,-4
553,1,1,552,1633,1081
554,0,0,39,0,-39
555,0,0,7,0,-7
556,1,0,31,0,-31
557,1,0,166,0,-166
558,1,1,44,1349,1305
559,0,0,41,0,-41
560,1,1,1046,1232,186
561,1,1,769,1572,803
562,0,0,25,0,-25
563,1,1,1391,1985,594
564,0,0,57,0,-57
565,1,0,69,0,-69
566,0,0,21,0,-21
567,1,0,13,0,-13
568,1,0,168,0,-168
569,1,0,31,0,-31
570,1,0,28,0,-28
571,1,1,896,1412,516
572,1,0,204,0,-204
573,1,1,911,1208,297
574,0,0,6,0,-6
575,0,0,71,0,-71
576,1,0,22,0,-22
577,0,0,5,0,-5
578,1,1,295,1317,1022
579,0,0,19,0,-19
580,1,0,103,0,-103
581,1,1,378,1485,1107
582,1,1,374,1310,936
583,1,1,200,1825,1625
584,1,0,35,0,-35
585,0,0,36,0,-36
586,0,0,57,0,-57
587,1,1,1278,1596,318
588,1,1,667,1225,558
589,1,1,125,1311,1186
590,0,0,9,0,-9
591,1,1,347,1330,983
592,0,0,31,0,-31
593,1,0,34,0,-34
594,1,1,109,1217,1108
595,0,0,70,0,-70
596,1,1,581,1248,667
597,1,1,289,1275,986
598,0,0,1,0,-1
599,1,1,30,1330,1300
600,0,0,90,0,-90
601,1,1,150,1308,1158
602,0,0,35,0,-35
603,0,0,26,0,-26
604,1,1,980,1341,361
605,0,0,112,0,-112
606,1,0,117,0,-117
607,1,1,418,1368,950
608,0,0,21,0,-21
609,0,0,19,0,-19
610,1,1,91,1425,1334
611,0,0,21,0,-21
612,1,0,13,0,-13
613,1,0,35,0,-35
614,1,1,726,1242,516
615,1,1,217,2048,1831
616,0,0,19,0,-19
617,1,1,92,1391,1299
618,1,1,192,2018,1826
619,0,0,135,0,-135
620,1,1,330,1895,1565
621,1,0,61,0,-61
622,1,0,9,0,-9
623,1,0,31,0,-31
624,1,0,3,0,-3
625,1,0,66,0,-66
626,1,0,18,0,-18
627,0,0,12,0,-12
628,1,1,1245,2186,941
629,1,1,358,1875,1517
630,0,0,37,0,-37
631,1,0,125,0,-125
632,1,1,634,1397,763
633,1,0,26,0,-26
634,1,0,154,0,-154
635,1,0,150,0,-150
636,0,0,83,0,-83
637,0,0,0,0,0
638,1,1,148,1410,1262
639,0,0,111,0,-111
640,0,0,22,0,-22
641,1,1,296,1729,1433
642,1,1,472,1229,757
643,1,0,22,0,-22
644,1,1,139,1244,1105
645,1,0,7,0,-7
646,0,0,59,0,-59
647,1,0,1,0,-1
648,1,0,138,0,-138
649,1,0,52,0,-52
650,0,0,30,0,-30
651,1,0,83,0,-83
652,1,1,763,1238,475
653,0,0,73,0,-73
654,0,0,36,0,-36
655,0,0,5,0,-5
656,1,1,147,1201,1054
657,0,0,5,0,-5
658,1,0,9,0,-9
659,0,0,19,0,-19
660,1,1,2387,1774,-613
661,0,0,37,0,-37
662,0,0,7,0,-7
663,0,0,19,0,-19
664,0,0,7,0,-7
665,0,0,27,0,-27
666,1,0,21,0,-21
667,1,1,605,1681,1076
668,0,0,10,0,-10
669,0,0,205,0,-205
670,0,0,6,0,-6
671,1,0,34,0,-34
672,0,0,66,0,-66
673,1,0,47,0,-47
674,1,0,17,0,-17
675,1,0,123,0,-123
676,1,1,429,1775,1346
677,0,0,8,0,-8
678,1,1,354,1558,1204
679,1,1,195,1405,1210
680,1,0,9,0,-9
681,1,1,108,1227,1119
682,1,0,37,0,-37
683,0,0,82,0,-82
684,0,0,182,0,-182
685,0,0,1,0,-1
686,0,0,30,0,-30
687,1,0,10,0,-10
688,0,0,45,0,-45
689,1,0,42,0,-42
690,1,0,21,0,-21
691,0,0,4,0,-4
692,1,0,15,0,-15
693,1,1,689,2040,1351
694,1,1,121,1229,1108
695,0,0,60,0,-60
696,0,0,12,0,-12
697,0,0,52,0,-52
698,1,1,3030,1630,-1400
699,0,0,65,0,-65
700,1,0,34,0,-34
701,1,0,15,0,-15
702,1,0,40,0,-40
703,1,0,34,0,-34
704,1,1,425,1740,1315
705,0,0,26,0,-26
706,1,0,153,0,-153
707,1,1,541,1609,1068
708,1,1,189,1476,1287
709,0,0,16,0,-16
710,1,0,6,0,-6
711,1,1,277,1657,1380
712,1,1,139,1353,1214
713,1,1,246,1285,1039
714,0,0,92,0,-92
715,1,1,730,1276,546
716,0,0,26,0,-26
717,1,0,10,0,-10
718,1,1,129,1977,1848
719,0,0,65,0,-65
720,1,0,162,0,-162
721,0,0,8,0,-8
722,1,1,499,1464,965
723,0,0,0,0,0
724,0,0,185,0,-185
725,0,0,96,0,-96
726,1,1,723,3193,2470
727,1,1,354,1312,958
728,1,1,1839,1369,-470
729,1,1,361,1338,977
730,0,0,11,0,-11
731,1,0,69,0,-69
732,1,0,29,0,-29
733,1,0,39,0,-39
734,0,0,0,0,0
735,1,1,672,2202,1530
736,0,0,5,0,-5
737,0,0,33,0,-33
738,0,0,34,0,-34
739,1,0,17,0,-17
740,0,0,35,0,-35
741,1,0,64,0,-64
742,0,0,96,0,-96
743,0,0,140,0,-140
744,1,0,33,0,-33
745,0,0,39,0,-39
746,1,0,20,0,-20
747,1,0,67,0,-67
748,0,0,124,0,-124
749,1,1,429,1275,846
750,0,0,133,0,-133
751,0,0,57,0,-57
752,1,1,543,1620,1077
753,1,1,140,1523,1383
754,0,0,9,0,-9
755,0,0,27,0,-27
756,1,1,392,1281,889
757,0,0,79,0,-79
758,0,0,79,0,-79
759,1,1,12,1401,1389
760,0,0,59,0,-59
761,1,0,7,0,-7
762,1,1,1775,3917,2142
763,1,0,13,0,-13
764,1,0,0,0,0
765,1,0,62,0,-62
766,1,0,89,0,-89
767,0,0,43,0,-43
768,0,0,178,0,-178
769,1,0,49,0,-49
770,0,0,36,0,-36
771,1,1,359,1444,1085
772,1,1,124,1436,1312
773,1,0,6,0,-6
774,1,1,361,1713,1352
775,0,0,70,0,-70
776,1,0,44,0,-44
777,1,1,1534,1523,-11
778,1,0,24,0,-24
779,1,1,175,1447,1272
780,1,0,119,0,-119
781,1,0,31,0,-31
782,1,1,172,1570,1398
783,0,0,39,0,-39
784,0,0,209,0,-209
785,1,0,22,0,-22
786,0,0,50,0,-50
787,0,0,0,0,0
788,1,0,3,0,-3
789,1,1,463,1817,1354
790,0,0,151,0,-151
791,0,0,10,0,-10
792,1,1,166,1302,1136
793,0,0,26,0,-26
794,0,0,68,0,-68
795,1,0,44,0,-44
796,1,0,23,0,-23
797,1,1,298,1431,1133
798,1,1,123,1279,1156
799,1,1,353,1482,1129
800,1,1,155,1726,1571
801,1,0,18,0,-18
802,1,1,304,1426,1122
803,1,1,1508,1292,-216
804,0,0,178,0,-178
805,0,0,55,0,-55
806,1,0,61,0,-61
807,1,1,364,1468,1104
808,1,0,69,0,-69
809,1,0,99,0,-99
810,0,0,66,0,-66
811,0,0,120,0,-120
812,1,1,370,1592,1222
813,1,1,126,1374,1248
814,0,0,43,0,-43
815,1,0,3,0,-3
816,0,0,34,0,-34
817,1,1,449,1264,815
818,0,0,1,0,-1
819,1,1,827,1200,373
820,1,0,44,0,-44
821,0,0,149,0,-149
822,0,0,83,0,-83
823,0,0,36,0,-36
824,0,0,13,0,-13
825,0,0,12,0,-12
826,0,0,12,0,-12
827,1,0,44,0,-44
828,1,1,2621,1258,-1363
829,0,0,126,0,-126
830,0,0,16,0,-16
831,1,0,100,0,-100
832,0,0,19,0,-19
833,1,1,354,1220,866
834,1,0,84,0,-84
835,0,0,22,0,-22
836,1,0,15,0,-15
837,1,1,131,1696,1565
838,1,0,54,0,-54
839,1,1,1196,1700,504
840,0,0,18,0,-18
841,0,0,63,0,-63
842,0,0,13,0,-13
843,1,1,731,2637,1906
844,1,1,104,1311,1207
845,1,0,51,0,-51
846,1,1,1324,1694,370
847,1,1,234,1511,1277
848,0,0,47,0,-47
849,1,0,148,0,-148
850,1,0,104,0,-104
851,1,0,52,0,-52
852,1,1,73,1419,1346
853,0,0,43,0,-43
854,1,1,272,1585,1313
855,1,0,28,0,-28
856,1,0,73,0,-73
857,1,1,353,1202,849
858,1,0,8,0,-8
859,0,0,37,0,-37
860,0,0,126,0,-126
861,0,0,63,0,-63
862,0,0,34,0,-34
863,0,0,13,0,-13
864,1,0,112,0,-112
865,1,1,712,1353,641
866,1,0,16,0,-16
867,0,0,31,0,-31
868,0,0,21,0,-21
869,0,0,11,0,-11
870,0,0,4,0,-4
871,1,1,115,1413,1298
872,1,0,113,0,-113
873,1,0,177,0,-177
874,1,1,58,1340,1282
875,0,0,16,0,-16
876,0,0,25,0,-25
877,1,0,91,0,-91
878,0,0,13,0,-13
879,0,0,22,0,-22
880,1,0,49,0,-49
881,0,0,154,0,-154
882,1,0,41,0,-41
883,1,1,306,1376,1070
884,0,0,2,0,-2
885,1,0,23,0,-23
886,0,0,38,0,-38
887,1,1,375,2612,2237
888,1,1,471,1434,963
889,1,0,59,0,-59
890,1,0,20,0,-20
891,1,0,21,0,-21
892,0,0,37,0,-37
893,0,0,2,0,-2
894,0,0,23,0,-23
895,0,0,72,0,-72
896,1,0,3,0,-3
897,1,1,684,1454,770
898,1,1,387,1363,976
899,1,0,1,0,-1
900,0,0,16,0,-16
901,1,0,19,0,-19
902,1,1,296,2107,1811
903,1,1,353,1321,968
904,0,0,158,0,-158
905,0,0,166,0,-166
906,0,0,47,0,-47
907,1,1,104,1288,1184
908,1,1,642,1246,604
909,0,0,16,0,-16
910,0,0,19,0,-19
911,0,0,21,0,-21
912,0,0,2,0,-2
913,1,1,14,1230,1216
914,1,1,48,1239,1191
915,1,1,611,1622,1011
916,0,0,30,0,-30
917,0,0,214,0,-214
918,1,1,98,2228,2130
919,0,0,31,0,-31
920,1,1,153,1669,1516
921,1,1,358,4374,4016
922,1,1,1632,1338,-294
923,1,0,71,0,-71
924,0,0,107,0,-107
925,1,0,50,0,-50
926,0,0,9,0,-9
927,1,1,16,1591,1575
928,1,1,127,2088,1961
929,1,0,4,0,-4
930,0,0,45,0,-45
931,0,0,42,0,-42
932,1,0,3,0,-3
933,1,1,84,1809,1725
934,1,1,42,1631,1589
935,0,0,8,0,-8
936,1,0,22,0,-22
937,1,1,1158,1664,506
938,0,0,31,0,-31
939,1,0,59,0,-59
940,0,0,41,0,-41
941,1,1,655,1379,724
942,1,1,378,1271,893
943,0,0,7,0,-7
944,0,0,21,0,-21
945,1,0,103,0,-103
946,0,0,8,0,-8
947,0,0,19,0,-19
948,0,0,19,0,-19
949,0,0,41,0,-41
950,1,0,140,0,-140
951,0,0,56,0,-56
952,0,0,187,0,-187
953,0,0,14,0,-14
954,1,1,1555,1642,87
955,1,1,180,1277,1097
956,1,1,92,1673,1581
957,1,1,593,1793,1200
958,1,1,874,1395,521
959,1,1,446,1876,1430
960,0,0,10,0,-10
961,1,1,267,1891,1624
962,1,0,129,0,-129
963,1,0,5,0,-5
964,0,0,57,0,-57
965,1,0,103,0,-103
966,0,0,2,0,-2
967,0,0,30,0,-30
968,1,1,783,1642,859
969,1,0,22,0,-22
970,1,0,63,0,-63
971,0,0,9,0,-9
972,0,0,63,0,-63
973,1,1,600,1469,869
974,1,0,10,0,-10
975,1,0,47,0,-47
976,1,0,41,0,-41
977,0,0,52,0,-52
978,0,0,62,0,-62
979,1,1,219,1406,1187
980,1,1,628,1358,730
981,1,0,96,0,-96
982,0,0,96,0,-96
983,0,0,25,0,-25
984,1,1,289,1379,1090
985,1,1,491,1943,1452
986,1,0,28,0,-28
987,1,0,38,0,-38
988,1,1,1103,1287,184
989,0,0,117,0,-117
990,0,0,0,0,0
991,0,0,9,0,-9
992,0,0,5,0,-5
993,1,0,33,0,-33
994,1,0,33,0,-33
995,0,0,14,0,-14
996,1,1,685,1333,648
997,0,0,51,0,-51
998,0,0,37,0,-37
999,1,0,3,0,-3
1000,1,0,154,0,-154
1001,0,0,3,0,-3
1002,1,1,2142,1420,-722
1003,0,0,3,0,-3
1004,1,0,11,0,-11
1005,1,1,367,1265,898
1006,0,0,80,0,-80
1007,1,0,15,0,-15
1008,0,0,2,0,-2
1009,1,0,66,0,-66
1010,1,1,307,1326,1019
1011,1,1,373,1201,828
1012,0,0,123,0,-123
1013,0,0,117,0,-117
1014,1,0,135,0,-135
1015,1,0,33,0,-33
1016,1,1,851,1208,357
1017,0,0,57,0,-57
1018,1,1,469,1262,793
1019,0,0,50,0,-50
1020,1,0,35,0,-35
1021,1,1,1090,1334,244
1022,1,1,2083,2134,51
1023,1,1,707,1369,662
1024,1,0,7,0,-7
1025,0,0,93,0,-93
1026,1,0,76,0,-76
1027,1,1,823,2327,1504
1028,0,0,23,0,-23
1029,1,1,44,1333,1289
1030,0,0,6,0,-6
1031,1,0,41,0,-41
1032,1,1,284,1274,990
1033,0,0,43,0,-43
1034,0,0,51,0,-51
1035,1,1,283,1769,1486
1036,1,1,2025,1468,-557
1037,1,1,501,1379,878
1038,1,1,208,1284,1076
1039,1,0,0,0,0
1040,0,0,26,0,-26
1041,0,0,6,0,-6
1042,0,0,3,0,-3
1043,1,1,195,1337,1142
1044,0,0,22,0,-22
1045,1,1,1085,1519,434
1046,1,0,36,0,-36
1047,1,1,403,1221,818
1048,0,0,1,0,-1
1049,1,0,31,0,-31
1050,1,0,19,0,-19
1051,1,1,813,1218,405
1052,1,1,71,1891,1820
1053,1,1,182,1238,1056
1054,1,0,92,0,-92
1055,1,1,335,1815,1480
1056,1,0,58,0,-58
1057,1,0,170,0,-170
1058,1,1,432,1263,831
1059,0,0,25,0,-25
1060,1,0,22,0,-22
1061,1,0,24,0,-24
1062,1,0,27,0,-27
1063,0,0,115,0,-115
1064,0,0,2,0,-2
1065,1,1,236,1854,1618
1066,0,0,77,0,-77
1067,0,0,0,0,0
1068,1,1,13,1475,1462
1069,0,0,12,0,-12
1070,1,1,26,1927,1901
1071,0,0,11,0,-11
1072,0,0,207,0,-207
1073,0,0,143,0,-143
1074,1,0,17,0,-17
1075,1,0,15,0,-15
1076,1,1,417,1639,1222
1077,0,0,70,0,-70
1078,1,0,13,0,-13
1079,0,0,19,0,-19
1080,1,0,79,0,-79
1081,0,0,7,0,-7
1082,1,0,35,0,-35
1083,0,0,17,0,-17
1084,0,0,45,0,-45
1085,1,0,59,0,-59
1086,0,0,26,0,-26
1087,1,0,67,0,-67
1088,1,1,240,3971,3731
1089,1,1,440,1337,897
1090,1,0,5,0,-5
1091,1,0,148,0,-148
1092,0,0,1,0,-1
1093,0,0,71,0,-71
1094,0,0,64,0,-64
1095,0,0,11,0,-11
1096,1,0,68,0,-68
1097,0,0,17,0,-17
1098,1,1,325,1661,1336
1099,0,0,17,0,-17
1100,1,1,112,1531,1419
1101,1,1,866,1743,877
1102,1,1,193,1448,1255
1103,0,0,54,0,-54
1104,0,0,40,0,-40
1105,1,0,53,0,-53
1106,1,1,1132,1300,168
1107,1,0,17,0,-17
1108,1,1,1662,1385,-277
1109,1,1,229,1345,1116
1110,1,1,87,1457,1370
1111,1,0,78,0,-78
1112,0,0,11,0,-11
1113,0,0,89,0,-89
1114,0,0,63,0,-63
1115,0,0,47,0,-47
1116,0,0,9,0,-9
1117,0,0,51,0,-51
1118,1,0,35,0,-35
1119,1,1,98,1385,1287
1120,0,0,82,0,-82
1121,1,0,51,0,-51
1122,1,1,854,1538,684
1123,0,0,136,0,-136
1124,1,1,972,1480,508
1125,0,0,156,0,-156
1126,0,0,3,0,-3
1127,1,1,556,1384,828
1128,0,0,0,0,0
1129,1,0,60,0,-60
1130,0,0,149,0,-149
1131,1,0,17,0,-17
1132,1,0,32,0,-32
1133,1,0,11,0,-11
1134,1,1,347,1502,1155
1135,1,0,9,0,-9
1136,0,0,85,0,-85
1137,0,0,182,0,-182
1138,1,1,1001,2018,1017
1139,0,0,77,0,-77
1140,0,0,82,0,-82
1141,1,1,331,1256,925
1142,1,0,67,0,-67
1143,0,0,8,0,-8
1144,1,1,326,2743,2417
1145,0,0,38,0,-38
1146,1,0,67,0,-67
1147,0,0,10,0,-10
1148,1,0,116,0,-116
1149,1,1,224,2284,2060
1150,1,1,702,2656,1954
1151,1,0,35,0,-35
1152,0,0,4,0,-4
1153,0,0,57,0,-57
1154,1,0,11,0,-11
1155,0,0,0,0,0
1156,1,1,1298,1204,-94
1157,1,1,457,1812,1355
1158,0,0,127,0,-127
1159,1,1,2331,1773,-558
1160,1,1,648,1633,985
1161,1,1,327,1271,944
1162,1,0,34,0,-34
1163,0,0,1,0,-1
1164,0,0,35,0,-35
1165,1,0,7,0,-7
1166,0,0,20,0,-20
1167,1,0,13,0,-13
1168,0,0,111,0,-111
1169,1,1,610,1295,685
1170,0,0,27,0,-27
1171,1,1,995,1415,420
1172,1,0,21,0,-21
1173,1,0,19,0,-19
1174,1,1,1321,1232,-89
1175,1,1,23,1324,1301
1176,1,1,853,1417,564
1177,1,1,348,1202,854
1178,0,0,68,0,-68
1179,1,0,61,0,-61
1180,1,1,787,1811,1024
1181,1,0,28,0,-28
1182,1,1,428,1369,941
1183,0,0,4,0,-4
1184,0,0,39,0,-39
1185,0,0,48,0,-48
1186,0,0,4,0,-4
1187,0,0,17,0,-17
1188,1,1,808,1370,562
1189,1,0,40,0,-40
1190,1,1,647,1569,922
1191,0,0,22,0,-22
1192,0,0,60,0,-60
1193,1,0,57,0,-57
1194,0,0,60,0,-60
1195,1,1,361,1467,1106
1196,0,0,101,0,-101
1197,0,0,50,0,-50
1198,1,0,6,0,-6
1199,1,1,28,1380,1352
1200,1,0,20,0,-20
1201,1,1,976,1348,372
1202,0,0,4,0,-4
1203,1,0,30,0,-30
1204,1,0,43,0,-43
1205,1,0,68,0,-68
1206,0,0,32,0,-32
1207,0,0,124,0,-124
1208,1,0,108,0,-108
1209,1,1,1001,1262,261
1210,0,0,60,0,-60
1211,1,1,115,1331,1216
1212,0,0,5,0,-5
1213,1,1,102,1277,1175
1214,1,1,166,1248,1082
1215,0,0,3,0,-3
1216,1,0,2,0,-2
1217,1,0,28,0,-28
1218,0,0,25,0,-25
1219,0,0,51,0,-51
1220,1,1,205,1540,1335
1221,1,0,54,0,-54
1222,0,0,104,0,-104
1223,0,0,4,0,-4
1224,1,0,30,0,-30
1225,0,0,80,0,-80
1226,1,0,2,0,-2
1227,0,0,16,0,-16
1228,0,0,47,0,-47
1229,1,1,375,1262,887
1230,0,0,134,0,-134
1231,1,0,13,0,-13
1232,0,0,9,0,-9
1233,0,0,1,0,-1
1234,1,1,430,1979,1549
1235,1,1,590,1256,666
1236,1,0,34,0,-34
1237,1,1,379,1229,850
1238,1,1,130,1334,1204
1239,1,1,640,2748,2108
1240,1,1,123,1288,1165
1241,0,0,29,0,-29
1242,1,1,564,2943,2379
1243,1,1,416,1236,820
1244,1,0,32,0,-32
1245,1,0,50,0,-50
1246,0,0,37,0,-37
1247,1,1,858,1267,409
1248,0,0,0,0,0
1249,1,1,2703,1344,-1359
1250,1,0,69,0,-69
1251,0,0,79,0,-79
1252,1,1,576,2910,2334
1253,1,1,620,1654,1034
1254,0,0,0,0,0
1255,1,1,354,1682,1328
1256,1,0,132,0,-132
1257,0,0,153,0,-153
1258,1,0,18,0,-18
1259,1,0,17,0,-17
1260,0,0,45,0,-45
1261,1,0,73,0,-73
1262,1,0,97,0,-97
1263,0,0,16,0,-16
1264,0,0,42,0,-42
1265,1,0,94,0,-94
1266,0,0,6,0,-6
1267,1,1,307,1217,910
1268,0,0,96,0,-96
1269,1,0,3,0,-3
1270,1,1,79,1489,1410
1271,1,1,328,1824,1496
1272,0,0,15,0,-15
1273,0,0,20,0,-20
1274,1,0,3,0,-3
1275,1,1,635,1537,902
1276,1,0,66,0,-66
1277,1,0,22,0,-22
1278,0,0,17,0,-17
1279,1,1,447,1302,855
1280,0,0,21,0,-21
1281,0,0,77,0,-77
1282,0,0,175,0,-175
1283,1,0,7,0,-7
1284,0,0,15,0,-15
1285,0,0,91,0,-91
1286,1,1,201,1743,1542
1287,1,0,81,0,-81
1288,0,0,14,0,-14
1289,0,0,101,0,-101
1290,0,0,14,0,-14
1291,0,0,64,0,-64
1292,1,0,47,0,-47
1293,1,1,340,1263,923
1294,1,1,41,2539,2498
1295,1,1,179,1241,1062
1296,1,1,1043,2020,977
1297,0,0,34,0,-34
1298,0,0,23,0,-23
1299,1,1,202,1573,1371
1300,1,0,70,0,-70
1301,0,0,55,0,-55
1302,1,0,67,0,-67
1303,0,0,66,0,-66
1304,1,1,518,1264,746
1305,0,0,73,0,-73
1306,1,1,748,2146,1398
1307,0,0,74,0,-74
1308,0,0,6,0,-6
1309,1,0,9,0,-9
1310,0,0,9,0,-9
1311,1,1,351,1641,1290
1312,1,1,320,1344,1024
1313,1,0,47,0,-47
1314,1,0,29,0,-29
1315,1,0,23,0,-23
1316,1,0,106,0,-106
1317,1,0,27,0,-27
1318,0,0,40,0,-40
1319,0,0,11,0,-11
1320,1,1,98,1356,1258
1321,1,0,50,0,-50
1322,1,1,95,1323,1228
1323,1,1,603,1217,614
1324,1,0,32,0,-32
1325,0,0,14,0,-14
1326,0,0,68,0,-68
1327,0,0,119,0,-119
1328,0,0,19,0,-19
1329,0,0,22,0,-22
1330,1,1,298,1391,1093
1331,1,0,4,0,-4
1332,1,0,244,0,-244
1333,1,1,427,1282,855
1334,1,1,140,1975,1835
1335,0,0,7,0,-7
1336,1,0,133,0,-133
1337,1,1,250,1873,1623
1338,1,1,697,1574,877
1339,0,0,24,0,-24
1340,1,0,1,0,-1
1341,0,0,27,0,-27
1342,1,1,490,2630,2140
1343,1,0,21,0,-21
1344,1,0,113,0,-113
1345,0,0,36,0,-36
1346,0,0,87,0,-87
1347,0,0,23,0,-23
1348,0,0,66,0,-66
1349,1,1,819,1226,407
1350,1,1,976,1347,371
1351,1,0,11,0,-11
1352,1,1,81,1259,1178
1353,1,1,85,1849,1764
1354,0,0,5,0,-5
1355,1,0,138,0,-138
1356,0,0,51,0,-51
1357,0,0,102,0,-102
1358,1,0,12,0,-12
1359,0,0,18,0,-18
1360,0,0,161,0,-161
1361,0,0,57,0,-57
1362,0,0,4,0,-4
1363,1,1,2224,1705,-519
1364,0,0,100,0,-100
1365,1,1,213,1346,1133
1366,1,1,323,1410,1087
1367,1,1,420,1520,1100
1368,1,0,14,0,-14
1369,1,1,209,1601,1392
1370,1,0,104,0,-104
1371,1,0,9,0,-9
1372,0,0,16,0,-16
1373,1,1,422,1620,1198
1374,1,1,815,1660,845
1375,1,1,252,1520,1268
1376,0,0,10,0,-10
1377,0,0,37,0,-37
1378,1,1,162,1797,1635
1379,0,0,36,0,-36
1380,1,0,57,0,-57
1381,1,1,77,1291,1214
1382,1,1,631,1737,1106
1383,0,0,31,0,-31
1384,1,0,11,0,-11
1385,1,1,115,1803,1688
1386,1,1,199,1467,1268
1387,1,1,1870,1548,-322
1388,0,0,48,0,-48
1389,1,0,52,0,-52
1390,1,0,60,0,-60
1391,0,0,25,0,-25
1392,1,1,316,1619,1303
1393,1,1,588,2042,1454
1394,0,0,31,0,-31
1395,1,1,1436,1245,-191
1396,1,1,854,1214,360
1397,1,1,427,2107,1680
1398,1,0,29,0,-29
1399,1,1,1596,1708,112
1400,1,1,571,1514,943
1401,0,0,45,0,-45
1402,1,0,72,0,-72
1403,0,0,30,0,-30
1404,0,0,3,0,-3
1405,0,0,27,0,-27
1406,1,0,5,0,-5
1407,0,0,30,0,-30
1408,1,0,2,0,-2
1409,1,1,635,1433,798
1410,0,0,62,0,-62
1411,0,0,29,0,-29
1412,1,1,401,1337,936
1413,0,0,62,0,-62
1414,1,0,131,0,-131
1415,1,0,56,0,-56
1416,1,0,102,0,-102
1417,1,1,2280,2329,49
1418,0,0,41,0,-41
1419,0,0,8,0,-8
1420,1,0,72,0,-72
1421,1,1,640,1565,925
1422,0,0,41,0,-41
1423,1,1,268,1257,989
1424,1,1,432,1351,919
1425,0,0,26,0,-26
1426,0,0,0,0,0
1427,1,0,17,0,-17
1428,0,0,13,0,-13
1429,1,0,21,0,-21
1430,1,0,6,0,-6
1431,1,1,108,1214,1106
1432,1,1,467,3277,2810
1433,1,1,351,1607,1256
1434,1,1,168,1283,1115
1435,0,0,15,0,-15
1436,0,0,5,0,-5
1437,1,0,39,0,-39
1438,1,1,593,1273,680
1439,0,0,43,0,-43
1440,1,0,19,0,-19
1441,0,0,32,0,-32
1442,1,1,195,1343,1148
1443,1,0,6,0,-6
1444,1,0,10,0,-10
1445,1,1,821,2241,1420
1446,1,1,788,1200,412
1447,0,0,48,0,-48
1448,1,1,960,1240,280
1449,1,0,14,0,-14
1450,1,1,355,1223,868
1451,1,0,22,0,-22
1452,1,0,50,0,-50
1453,0,0,24,0,-24
1454,0,0,85,0,-85
1455,1,1,1093,2151,1058
1456,0,0,37,0,-37
1457,1,0,137,0,-137
1458,0,0,105,0,-105
1459,0,0,99,0,-99
1460,0,0,84,0,-84
1461,0,0,9,0,-9
1462,1,0,19,0,-19
1463,0,0,19,0,-19
1464,0,0,136,0,-136
1465,1,0,59,0,-59
1466,1,1,115,1359,1244
1467,1,0,13,0,-13
1468,1,0,68,0,-68
1469,0,0,109,0,-109
1470,0,0,27,0,-27
1471,1,0,14,0,-14
1472,1,1,303,1499,1196
1473,0,0,9,0,-9
1474,0,0,33,0,-33
1475,0,0,38,0,-38
1476,0,0,98,0,-98
1477,1,1,160,1381,1221
1478,0,0,89,0,-89
1479,0,0,56,0,-56
1480,1,0,18,0,-18
1481,0,0,51,0,-51
1482,0,0,12,0,-12
1483,1,1,207,1247,1040
1484,1,1,1400,1355,-45
1485,1,0,36,0,-36
1486,1,0,28,0,-28
1487,1,0,23,0,-23
1488,1,0,14,0,-14
1489,0,0,4,0,-4
1490,1,1,1977,1747,-230
1491,1,0,83,0,-83
1492,0,0,6,0,-6
1493,1,0,16,0,-16
1494,1,0,63,0,-63
1495,1,0,49,0,-49
1496,1,1,239,2014,1775
1497,0,0,35,0,-35
1498,1,0,3,0,-3
1499,1,1,321,2461,2140
1500,1,0,280,0,-280
1501,0,0,15,0,-15
1502,1,0,66,0,-66
1503,1,0,65,0,-65
1504,0,0,65,0,-65
1505,0,0,81,0,-81
1506,1,0,47,0,-47
1507,1,1,93,2161,2068
1508,1,0,90,0,-90
1509,0,0,32,0,-32
1510,1,1,1071,1235,164
1511,0,0,75,0,-75
1512,1,1,108,1988,1880
1513,0,0,54,0,-54
1514,1,0,32,0,-32
1515,1,1,348,1353,1005
1516,0,0,128,0,-128
1517,0,0,79,0,-79
1518,1,1,84,1274,1190
1519,0,0,1,0,-1
1520,1,1,812,2119,1307
1521,0,0,65,0,-65
1522,0,0,93,0,-93
1523,1,0,95,0,-95
1524,0,0,38,0,-38
1525,0,0,74,0,-74
1526,1,1,722,1770,1048
1527,1,1,224,1745,1521
1528,1,1,1066,1361,295
1529,1,1,295,1272,977
1530,0,0,103,0,-103
1531,1,1,109,2615,2506
1532,1,1,1160,1921,761
1533,1,1,229,1603,1374
1534,0,0,180,0,-180
1535,1,0,29,0,-29
1536,1,1,164,1351,1187
1537,1,1,197,1467,1270
1538,1,0,13,0,-13
1539,0,0,179,0,-179
1540,1,1,245,2405,2160
1541,1,0,66,0,-66
1542,0,0,131,0,-131
1543,0,0,86,0,-86
1544,1,1,438,1409,971
1545,0,0,36,0,-36
1546,1,0,67,0,-67
1547,1,1,306,1214,908
1548,1,0,79,0,-79
1549,0,0,8,0,-8
1550,0,0,24,0,-24
1551,1,1,43,1256,1213
1552,1,0,86,0,-86
1553,0,0,71,0,-71
1554,1,0,50,0,-50
1555,1,1,823,1947,1124
1556,0,0,67,0,-67
1557,1,1,856,1395,539
1558,1,1,292,1464,1172
1559,0,0,7,0,-7
1560,1,1,1611,1357,-254
1561,0,0,49,0,-49
1562,0,0,46,0,-46
1563,1,0,8,0,-8
1564,0,0,103,0,-103
1565,1,0,20,0,-20
1566,0,0,44,0,-44
1567,0,0,38,0,-38
1568,1,0,35,0,-35
1569,0,0,4,0,-4
1570,0,0,88,0,-88
1571,0,0,33,0,-33
1572,0,0,26,0,-26
1573,1,0,53,0,-53
1574,1,0,8,0,-8
1575,1,0,1,0,-1
1576,1,0,268,0,-268
1577,0,0,5,0,-5
1578,0,0,10,0,-10
1579,1,0,2,0,-2
1580,0,0,100,0,-100
1581,1,1,524,1406,882
1582,1,1,1146,1762,616
1583,1,0,40,0,-40
1584,1,1,1462,2038,576
1585,1,0,6,0,-6
1586,1,0,18,0,-18
1587,0,0,13,0,-13
1588,1,0,19,0,-19
1589,1,0,37,0,-37
1590,0,0,35,0,-35
1591,1,1,283,1210,927
1592,1,1,2744,2179,-565
1593,0,0,2,0,-2
1594,1,0,2,0,-2
1595,0,0,54,0,-54
1596,1,0,204,0,-204
1597,1,1,37,1216,1179
1598,1,0,80,0,-80
1599,1,0,5,0,-5
1600,0,0,5,0,-5
1601,1,1,75,1749,1674
1602,1,0,15,0,-15
1603,1,1,385,1792,1407
1604,0,0,5,0,-5
1605,1,1,172,1940,1768
1606,0,0,70,0,-70
1607,1,1,418,1611,1193
1608,0,0,27,0,-27
1609,1,1,377,1594,1217
1610,1,1,935,1242,307
1611,0,0,57,0,-57
1612,1,1,746,1353,607
1613,0,0,28,0,-28
1614,1,0,54,0,-54
1615,0,0,167,0,-167
1616,1,1,289,1299,1010
1617,1,1,890,1651,761
1618,1,0,38,0,-38
1619,1,1,335,1225,890
1620,1,1,793,1706,913
1621,0,0,39,0,-39
1622,0,0,45,0,-45
1623,1,1,193,1287,1094
1624,0,0,7,0,-7
1625,0,0,65,0,-65
1626,0,0,66,0,-66
1627,1,0,23,0,-23
1628,1,1,569,1286,717
1629,1,1,551,1344,793
1630,1,0,12,0,-12
1631,1,0,107,0,-107
1632,1,0,61,0,-61
1633,0,0,16,0,-16
1634,0,0,64,0,-64
1635,0,0,5,0,-5
1636,0,0,65,0,-65
1637,1,0,108,0,-108
1638,1,1,827,2057,1230
1639,0,0,41,0,-41
1640,0,0,64,0,-64
1641,0,0,80,0,-80
1642,1,1,510,1244,734
1643,1,1,163,1221,1058
1644,1,1,320,1202,882
1645,1,1,328,1252,924
1646,1,0,6,0,-6
1647,0,0,43,0,-43
1648,1,0,11,0,-11
1649,0,0,1,0,-1
1650,1,1,1876,1218,-658
1651,1,1,67,1322,1255
1652,0,0,3,0,-3
1653,1,1,1083,1206,123
1654,1,0,42,0,-42
1655,1,1,907,1271,364
1656,1,0,14,0,-14
1657,0,0,61,0,-61
1658,0,0,45,0,-45
1659,0,0,33,0,-33
1660,1,0,6,0,-6
1661,1,0,77,0,-77
1662,0,0,80,0,-80
1663,1,0,56,0,-56
1664,0,0,99,0,-99
1665,1,0,26,0,-26
1666,1,0,4,0,-4
1667,0,0,33,0,-33
1668,0,0,48,0,-48
1669,1,1,1313,1565,252
1670,1,1,255,2315,2060
1671,1,1,670,1574,904
1672,0,0,88,0,-88
1673,1,1,803,1455,652
1674,0,0,133,0,-133
1675,1,1,229,1715,1486
1676,1,0,31,0,-31
1677,0,0,89,0,-89
1678,1,1,67,1368,1301
1679,0,0,2,0,-2
1680,1,0,50,0,-50
1681,0,0,66,0,-66
1682,1,0,22,0,-22
1683,1,0,73,0,-73
1684,1,0,43,0,-43
1685,0,0,24,0,-24
1686,0,0,4,0,-4
1687,1,1,106,1723,1617
1688,0,0,15,0,-15
1689,1,1,65,1337,1272
1690,0,0,17,0,-17
1691,1,1,62,2531,2469
1692,1,1,457,1381,924
1693,0,0,121,0,-121
1694,0,0,39,0,-39
1695,0,0,62,0,-62
1696,0,0,103,0,-103
1697,0,0,54,0,-54
1698,0,0,55,0,-55
1699,0,0,185,0,-185
1700,0,0,30,0,-30
1701,0,0,8,0,-8
1702,1,0,172,0,-172
1703,0,0,8,0,-8
1704,1,1,478,1277,799
1705,0,0,53,0,-53
1706,0,0,30,0,-30
1707,0,0,13,0,-13
1708,1,1,145,1279,1134
1709,1,0,9,0,-9
1710,1,1,403,1200,797
1711,1,0,60,0,-60
1712,1,1,357,1365,1008
1713,1,1,92,1250,1158
1714,1,1,604,1377,773
1715,0,0,29,0,-29
1716,1,0,22,0,-22
1717,0,0,93,0,-93
1718,0,0,133,0,-133
1719,0,0,0,0,0
1720,0,0,59,0,-59
1721,1,1,133,1266,1133
1722,1,1,519,1745,1226
1723,1,1,1016,1325,309
1724,1,0,24,0,-24
1725,1,1,1746,1351,-395
1726,1,0,16,0,-16
1727,0,0,11,0,-11
1728,1,0,17,0,-17
1729,0,0,49,0,-49
1730,0,0,15,0,-15
1731,1,1,560,1308,748
1732,1,1,705,1223,518
1733,1,1,39,1751,1712
1734,0,0,27,0,-27
1735,0,0,60,0,-60
1736,0,0,122,0,-122
1737,1,0,114,0,-114
1738,1,0,62,0,-62
1739,1,0,16,0,-16
1740,0,0,12,0,-12
1741,1,1,180,1200,1020
1742,1,1,492,1267,775
1743,1,0,109,0,-109
1744,1,0,25,0,-25
1745,0,0,122,0,-122
1746,1,1,1101,1275,174
1747,0,0,48,0,-48
1748,1,0,113,0,-113
1749,0,0,23,0,-23
1750,1,0,81,0,-81
1751,0,0,96,0,-96
1752,1,1,570,1256,686
1753,0,0,6,0,-6
1754,0,0,29,0,-29
1755,0,0,17,0,-17
1756,1,0,0,0,0
1757,1,1,160,1393,1233
1758,1,0,5,0,-5
1759,0,0,62,0,-62
1760,0,0,5,0,-5
1761,1,0,11,0,-11
1762,1,1,364,1646,1282
1763,1,1,533,1305,772
1764,1,1,200,3151,2951
1765,0,0,9,0,-9
1766,0,0,7,0,-7
1767,1,0,6,0,-6
1768,0,0,26,0,-26
1769,1,0,14,0,-14
1770,1,1,146,1225,1079
1771,1,0,89,0,-89
1772,1,0,27,0,-27
1773,0,0,187,0,-187
1774,0,0,78,0,-78
1775,1,1,247,1341,1094
1776,1,0,51,0,-51
1777,1,1,323,1251,928
1778,1,0,27,0,-27
1779,0,0,78,0,-78
1780,0,0,121,0,-121
1781,1,1,315,1786,1471
1782,1,0,3,0,-3
1783,0,0,37,0,-37
1784,0,0,12,0,-12
1785,1,1,555,1657,1102
1786,0,0,128,0,-128
1787,1,0,3,0,-3
1788,1,1,702,1366,664
1789,0,0,27,0,-27
1790,1,0,92,0,-92
1791,0,0,199,0,-199
1792,0,0,17,0,-17
1793,1,0,105,0,-105
1794,0,0,136,0,-136
1795,0,0,24,0,-24
1796,0,0,23,0,-23
1797,0,0,44,0,-44
1798,1,1,101,1496,1395
1799,1,1,368,1205,837
1800,1,0,68,0,-68
1801,1,1,244,1472,1228
1802,1,1,360,1301,941
1803,1,0,68,0,-68
1804,1,0,80,0,-80
1805,0,0,8,0,-8
1806,1,0,15,0,-15
1807,1,1,361,2052,1691
1808,1,0,154,0,-154
1809,1,0,21,0,-21
1810,0,0,2,0,-2
1811,0,0,80,0,-80
1812,1,1,1147,1235,88
1813,0,0,19,0,-19
1814,0,0,7,0,-7
1815,1,0,26,0,-26
1816,1,0,5,0,-5
1817,0,0,11,0,-11
1818,0,0,24,0,-24
1819,1,0,8,0,-8
1820,1,0,30,0,-30
1821,0,0,158,0,-158
1822,1,1,95,2086,1991
1823,1,1,426,1210,784
1824,1,0,13,0,-13
1825,1,1,751,1743,992
1826,1,1,536,1711,1175
1827,0,0,27,0,-27
1828,0,0,13,0,-13
1829,1,0,15,0,-15
1830,0,0,7,0,-7
1831,1,0,14,0,-14
1832,0,0,69,0,-69
1833,0,0,8,0,-8
1834,1,0,12,0,-12
1835,1,0,95,0,-95
1836,0,0,0,0,0
1837,0,0,12,0,-12
1838,1,1,1108,2120,1012
1839,0,0,73,0,-73
1840,1,1,65,1334,1269
1841,0,0,2,0,-2
1842,1,1,345,1293,948
1843,0,0,15,0,-15
1844,0,0,12,0,-12
1845,1,0,6,0,-6
1846,0,0,68,0,-68
1847,1,0,15,0,-15
1848,0,0,98,0,-98
1849,0,0,125,0,-125
1850,0,0,14,0,-14
1851,1,0,0,0,0
1852,0,0,73,0,-73
1853,1,0,4,0,-4
1854,0,0,1,0,-1
1855,1,0,74,0,-74
1856,0,0,28,0,-28
1857,0,0,107,0,-107
1858,0,0,18,0,-18
1859,0,0,41,0,-41
1860,0,0,66,0,-66
1861,0,0,109,0,-109
1862,1,1,404,1285,881
1863,0,0,66,0,-66
1864,1,1,399,1284,885
1865,1,0,154,0,-154
1866,1,1,383,2697,2314
1867,1,1,460,1936,1476
1868,1,1,119,1322,1203
1869,0,0,13,0,-13
1870,1,0,13,0,-13
1871,0,0,61,0,-61
1872,1,0,3,0,-3
1873,0,0,14,0,-14
1874,1,0,187,0,-187
1875,0,0,7,0,-7
1876,1,0,54,0,-54
1877,1,1,224,1257,1033
1878,1,1,470,1450,980
1879,0,0,75,0,-75
1880,0,0,12,0,-12
1881,0,0,4,0,-4
1882,1,0,27,0,-27
1883,1,1,162,1436,1274
1884,1,1,1227,1438,211
1885,1,0,4,0,-4
1886,0,0,96,0,-96
1887,1,0,52,0,-52
1888,0,0,91,0,-91
1889,0,0,85,0,-85
1890,1,0,39,0,-39
1891,1,1,344,1322,978
1892,1,0,32,0,-32
1893,1,0,81,0,-81
1894,1,0,104,0,-104
1895,0,0,58,0,-58
1896,1,0,77,0,-77
1897,1,0,103,0,-103
1898,0,0,54,0,-54
1899,1,1,89,1245,1156
1900,1,0,11,0,-11
1901,0,0,35,0,-35
1902,0,0,8,0,-8
1903,1,1,595,1482,887
1904,1,1,375,1701,1326
1905,1,0,11,0,-11
1906,1,1,1051,1341,290
1907,1,1,615,1214,599
1908,1,1,250,1467,1217
1909,0,0,37,0,-37
1910,0,0,15,0,-15
1911,1,0,34,0,-34
1912,0,0,40,0,-40
1913,1,0,57,0,-57
1914,1,1,129,1229,1100
1915,1,0,29,0,-29
1916,0,0,5,0,-5
1917,1,1,83,2340,2257
1918,1,1,512,1941,1429
1919,1,1,745,1411,666
1920,1,0,76,0,-76
1921,1,0,65,0,-65
1922,0,0,21,0,-21
1923,1,0,20,0,-20
1924,0,0,91,0,-91
1925,0,0,91,0,-91
1926,0,0,143,0,-143
1927,0,0,221,0,-221
1928,1,0,138,0,-138
1929,1,1,382,1652,1270
1930,0,0,19,0,-19
1931,1,1,1008,1264,256
1932,0,0,47,0,-47
1933,0,0,1,0,-1
1934,1,0,13,0,-13
1935,1,0,28,0,-28
1936,1,0,41,0,-41
1937,1,1,566,1547,981
1938,1,0,48,0,-48
1939,0,0,97,0,-97
1940,1,0,23,0,-23
1941,1,0,17,0,-17
1942,1,1,124,1630,1506
1943,1,1,244,1572,1328
1944,1,1,5,1202,1197
1945,1,1,49,1890,1841
1946,0,0,52,0,-52
1947,1,0,39,0,-39
1948,0,0,5,0,-5
1949,0,0,59,0,-59
1950,1,1,186,1885,1699
1951,0,0,71,0,-71
1952,1,0,52,0,-52
1953,0,0,0,0,0
1954,1,0,25,0,-25
1955,0,0,1,0,-1
1956,1,0,106,0,-106
1957,1,0,39,0,-39
1958,1,0,15,0,-15
1959,0,0,63,0,-63
1960,1,0,27,0,-27
1961,1,0,27,0,-27
1962,1,0,22,0,-22
1963,1,0,14,0,-14
1964,0,0,30,0,-30
1965,0,0,61,0,-61
1966,1,1,1167,1433,266
1967,1,0,5,0,-5
1968,1,0,12,0,-12
1969,1,0,24,0,-24
1970,1,0,17,0,-17
1971,1,0,10,0,-10
1972,1,1,535,1245,710
1973,0,0,68,0,-68
1974,0,0,30,0,-30
1975,1,0,114,0,-114
1976,1,1,853,1563,710
1977,1,0,114,0,-114
1978,1,1,1444,1915,471
1979,1,1,586,1205,619
1980,0,0,36,0,-36
1981,1,1,73,1349,1276
1982,0,0,9,0,-9
1983,1,0,26,0,-26
1984,0,0,9,0,-9
1985,1,1,1014,1292,278
1986,0,0,18,0,-18
1987,1,1,192,1308,1116
1988,1,0,20,0,-20
1989,0,0,16,0,-16
1990,1,1,56,1427,1371
1991,1,0,58,0,-58
1992,0,0,27,0,-27
1993,0,0,21,0,-21
1994,1,0,30,0,-30
1995,0,0,19,0,-19
1996,1,1,454,1267,813
1997,1,0,12,0,-12
1998,0,0,139,0,-139
1999,1,1,286,1458,1172
2000,0,0,65,0,-65
2001,1,1,257,1670,1413
2002,1,0,60,0,-60
2003,1,0,51,0,-51
2004,0,0,1,0,-1
2005,1,1,387,1251,864
2006,1,0,55,0,-55
2007,1,1,684,1864,1180
2008,1,0,101,0,-101
2009,1,1,1380,1246,-134
2010,0,0,21,0,-21
2011,0,0,107,0,-107
2012,1,1,1909,1434,-475
2013,0,0,29,0,-29
2014,1,0,19,0,-19
2015,1,0,68,0,-68
2016,1,0,64,0,-64
2017,0,0,27,0,-27
2018,1,0,12,0,-12
2019,1,1,566,1425,859
2020,0,0,45,0,-45
2021,0,0,38,0,-38
2022,1,1,1061,3088,2027
2023,1,1,388,1717,1329
2024,1,1,2077,1576,-501
2025,1,0,1,0,-1
2026,0,0,26,0,-26
2027,1,1,526,2271,1745
2028,0,0,3,0,-3
2029,0,0,9,0,-9
2030,0,0,74,0,-74
2031,1,1,462,1282,820
2032,1,0,13,0,-13
2033,0,0,82,0,-82
2034,1,0,102,0,-102
2035,1,1,536,1256,720
2036,0,0,87,0,-87
2037,0,0,154,0,-154
2038,0,0,13,0,-13
2039,1,1,755,1665,910
2040,0,0,56,0,-56
2041,0,0,34,0,-34
2042,1,0,99,0,-99
2043,1,0,143,0,-143
2044,1,1,120,1381,1261
2045,0,0,32,0,-32
2046,0,0,32,0,-32
2047,1,1,551,1271,720
2048,1,0,17,0,-17
2049,1,0,13,0,-13
2050,1,1,187,1231,1044
2051,1,0,20,0,-20
2052,0,0,59,0,-59
2053,1,0,11,0,-11
2054,1,1,316,1281,965
2055,0,0,47,0,-47
2056,0,0,8,0,-8
2057,0,0,25,0,-25
2058,0,0,88,0,-88
2059,1,0,37,0,-37
2060,1,1,1489,2554,1065
2061,1,1,432,1473,1041
2062,0,0,20,0,-20
2063,1,0,7,0,-7
2064,1,1,929,1269,340
2065,0,0,181,0,-181
2066,0,0,124,0,-124
2067,0,0,95,0,-95
2068,1,1,1049,1266,217
2069,1,0,16,0,-16
2070,1,0,3,0,-3
2071,1,0,85,0,-85
2072,1,0,132,0,-132
2073,1,0,22,0,-22
2074,1,0,9,0,-9
2075,0,0,157,0,-157
2076,0,0,10,0,-10
2077,1,0,37,0,-37
2078,1,1,565,1234,669
2079,0,0,24,0,-24
2080,0,0,9,0,-9
2081,1,0,159,0,-159
2082,1,1,361,1323,962
2083,0,0,66,0,-66
2084,1,1,389,1216,827
2085,1,1,52,1472,1420
2086,0,0,29,0,-29
2087,1,0,38,0,-38
2088,1,0,107,0,-107
2089,0,0,150,0,-150
2090,0,0,81,0,-81
2091,1,0,45,0,-45
2092,0,0,4,0,-4
2093,1,0,43,0,-43
2094,1,1,478,1235,757
2095,1,0,16,0,-16
2096,1,1,90,2776,2686
2097,1,1,1437,1858,421
2098,1,0,21,0,-21
2099,1,0,19,0,-19
2100,0,0,36,0,-36
2101,0,0,68,0,-68
2102,0,0,6,0,-6
2103,1,1,480,1420,940
2104,1,0,49,0,-49
2105,0,0,114,0,-114
2106,0,0,0,0,0
2107,0,0,91,0,-91
2108,0,0,125,0,-125
2109,1,0,39,0,-39
2110,0,0,36,0,-36
2111,0,0,71,0,-71
2112,0,0,121,0,-121
2113,0,0,54,0,-54
2114,1,1,260,1250,990
2115,1,1,99,1282,1183
2116,0,0,4,0,-4
2117,1,1,110,1324,1214
2118,1,1,244,2193,1949
2119,0,0,79,0,-79
2120,0,0,16,0,-16
2121,1,1,129,2053,1924
2122,1,1,159,1898,1739
2123,0,0,227,0,-227
2124,0,0,102,0,-102
2125,1,1,148,1286,1138
2126,1,1,1195,1818,623
2127,0,0,135,0,-135
2128,1,0,81,0,-81
2129,1,0,146,0,-146
2130,1,1,2203,2615,412
2131,1,1,51,1228,1177
2132,1,1,235,1323,1088
2133,1,0,35,0,-35
2134,0,0,4,0,-4
2135,1,1,404,1759,1355
2136,0,0,58,0,-58
2137,0,0,22,0,-22
2138,0,0,80,0,-80
2139,1,0,20,0,-20
2140,0,0,14,0,-14
2141,0,0,26,0,-26
2142,1,0,110,0,-110
2143,1,0,140,0,-140
2144,0,0,62,0,-62
2145,0,0,22,0,-22
2146,0,0,68,0,-68
2147,0,0,33,0,-33
2148,0,0,64,0,-64
2149,1,0,34,0,-34
2150,1,1,318,1224,906
2151,1,1,185,1867,1682
2152,1,0,74,0,-74
2153,1,0,29,0,-29
2154,1,1,419,1384,965
2155,1,0,1,0,-1
2156,1,0,51,0,-51
2157,0,0,19,0,-19
2158,0,0,23,0,-23
2159,0,0,2,0,-2
2160,0,0,15,0,-15
2161,1,0,76,0,-76
2162,1,1,347,1316,969
2163,1,1,442,1680,1238
2164,0,0,1,0,-1
2165,1,1,226,1482,1256
2166,1,1,107,1257,1150
2167,1,1,1272,1661,389
2168,1,0,4,0,-4
2169,1,1,404,3561,3157
2170,0,0,82,0,-82
2171,1,1,117,1538,1421
2172,1,0,75,0,-75
2173,1,0,2,0,-2
2174,0,0,8,0,-8
2175,0,0,122,0,-122
2176,1,1,1778,1450,-328
2177,1,1,598,2778,2180
2178,1,1,784,1465,681
2179,0,0,90,0,-90
2180,0,0,16,0,-16
2181,1,1,814,2463,1649
2182,1,1,135,1247,1112
2183,1,1,582,1250,668
2184,1,1,2200,1501,-699
2185,0,0,6,0,-6
2186,1,0,29,0,-29
2187,0,0,23,0,-23
2188,1,0,5,0,-5
2189,0,0,18,0,-18
2190,1,1,174,1336,1162
2191,1,0,115,0,-115
2192,0,0,8,0,-8
2193,0,0,82,0,-82
2194,0,0,3,0,-3
2195,0,0,7,0,-7
2196,0,0,93,0,-93
2197,0,0,19,0,-19
2198,1,1,583,1290,707
2199,0,0,20,0,-20
2200,1,1,857,1577,720
2201,1,1,82,1803,1721
2202,0,0,8,0,-8
2203,1,1,690,1328,638
2204,1,0,23,0,-23
2205,1,1,824,1722,898
2206,1,0,67,0,-67
2207,1,1,173,1683,1510
2208,0,0,17,0,-17
2209,1,0,17,0,-17
2210,1,0,5,0,-5
2211,1,1,930,1729,799
2212,1,0,119,0,-119
2213,1,1,409,1637,1228
2214,1,0,11,0,-11
2215,1,0,22,0,-22
2216,1,0,54,0,-54
2217,1,0,7,0,-7
2218,1,0,18,0,-18
2219,1,1,1231,1241,10
2220,1,1,53,1828,1775
2221,1,1,528,1248,720
2222,1,0,0,0,0
2223,1,1,1784,1348,-436
2224,1,0,57,0,-57
2225,0,0,29,0,-29
2226,0,0,32,0,-32
2227,0,0,117,0,-117
2228,1,0,15,0,-15
2229,1,0,18,0,-18
2230,1,0,54,0,-54
2231,1,0,5,0,-5
2232,0,0,8,0,-8
2233,0,0,182,0,-182
2234,1,0,5,0,-5
2235,1,1,354,2405,2051
2236,1,1,185,1779,1594
2237,1,0,7,0,-7
2238,1,0,12,0,-12
2239,1,0,46,0,-46
2240,1,0,33,0,-33
2241,0,0,81,0,-81
2242,1,0,10,0,-10
2243,1,0,13,0,-13
2244,1,0,0,0,0
2245,1,1,93,1693,1600
2246,1,1,33,1639,1606
2247,0,0,187,0,-187
2248,1,1,239,1630,1391
2249,0,0,29,0,-29
2250,0,0,7,0,-7
2251,1,1,1814,1740,-74
2252,1,0,37,0,-37
2253,0,0,26,0,-26
2254,0,0,13,0,-13
2255,1,0,29,0,-29
2256,0,0,296,0,-296
2257,1,0,69,0,-69
2258,0,0,46,0,-46
2259,0,0,243,0,-243
2260,0,0,32,0,-32
2261,0,0,59,0,-59
2262,0,0,18,0,-18
2263,0,0,61,0,-61
2264,0,0,127,0,-127
2265,1,1,62,1618,1556
2266,1,1,2498,2439,-59
2267,0,0,104,0,-104
2268,1,1,357,1229,872
2269,1,1,537,1556,1019
2270,1,0,98,0,-98
2271,0,0,9,0,-9
2272,1,0,21,0,-21
2273,0,0,15,0,-15
2274,0,0,227,0,-227
2275,0,0,20,0,-20
2276,1,1,197,2779,2582
2277,0,0,33,0,-33
2278,0,0,48,0,-48
2279,0,0,26,0,-26
2280,1,1,255,1518,1263
2281,1,1,73,1591,1518
2282,1,1,104,1673,1569
2283,1,0,2,0,-2
2284,0,0,50,0,-50
2285,1,0,5,0,-5
2286,0,0,80,0,-80
2287,1,1,273,2109,1836
2288,1,0,54,0,-54
2289,1,1,379,1289,910
2290,0,0,76,0,-76
2291,0,0,39,0,-39
2292,0,0,29,0,-29
2293,0,0,10,0,-10
2294,1,0,44,0,-44
2295,0,0,22,0,-22
2296,1,0,15,0,-15
2297,1,0,53,0,-53
2298,1,1,1039,1297,258
2299,0,0,57,0,-57
2300,0,0,70,0,-70
2301,1,1,838,1277,439
2302,0,0,92,0,-92
2303,0,0,78,0,-78
2304,0,0,8,0,-8
2305,0,0,104,0,-104
2306,1,0,3,0,-3
2307,1,1,392,1473,1081
2308,1,0,27,0,-27
2309,1,0,7,0,-7
2310,1,1,664,2997,2333
2311,1,0,32,0,-32
2312,1,1,665,1210,545
2313,1,0,8,0,-8
2314,1,1,81,1576,1495
2315,0,0,69,0,-69
2316,1,0,111,0,-111
2317,1,1,1331,1271,-60
2318,0,0,7,0,-7
2319,0,0,3,0,-3
2320,1,0,20,0,-20
2321,1,1,343,1248,905
2322,0,0,4,0,-4
2323,1,0,14,0,-14
2324,1,1,670,1208,538
2325,1,1,2183,1249,-934
2326,1,0,26,0,-26
2327,0,0,26,0,-26
2328,0,0,76,0,-76
2329,0,0,4,0,-4
2330,0,0,79,0,-79
2331,1,0,42,0,-42
2332,1,1,532,2200,1668
2333,0,0,25,0,-25
2334,1,1,271,1433,1162
2335,0,0,16,0,-16
2336,1,1,330,1480,1150
2337,1,1,1147,3421,2274
2338,0,0,53,0,-53
2339,0,0,35,0,-35
2340,1,1,105,1221,1116
2341,0,0,1,0,-1
2342,1,1,1210,2078,868
2343,1,1,695,3704,3009
2344,1,0,94,0,-94
2345,0,0,11,0,-11
2346,1,0,8,0,-8
2347,1,1,971,1381,410
2348,0,0,35,0,-35
2349,1,1,33,1689,1656
2350,0,0,13,0,-13
2351,1,0,65,0,-65
2352,1,0,139,0,-139
2353,0,0,71,0,-71
2354,1,1,343,1215,872
2355,1,0,28,0,-28
2356,0,0,0,0,0
2357,1,1,1042,2332,1290
2358,1,0,65,0,-65
2359,0,0,73,0,-73
2360,0,0,67,0,-67
2361,1,0,10,0,-10
2362,0,0,126,0,-126
2363,1,1,1719,1484,-235
2364,1,1,1524,1254,-270
2365,0,0,4,0,-4
2366,1,0,13,0,-13
2367,0,0,4,0,-4
2368,0,0,12,0,-12
2369,0,0,42,0,-42
2370,0,0,15,0,-15
2371,1,0,9,0,-9
2372,1,0,40,0,-40
2373,1,1,154,1455,1301
2374,1,0,34,0,-34
2375,1,0,5,0,-5
2376,0,0,126,0,-126
2377,1,1,2283,1567,-716
2378,1,1,517,1230,713
2379,1,0,136,0,-136
2380,1,0,30,0,-30
2381,0,0,26,0,-26
2382,1,1,912,1519,607
2383,0,0,66,0,-66
2384,1,1,976,1695,719
2385,1,0,43,0,-43
2386,0,0,153,0,-153
2387,0,0,6,0,-6
2388,1,0,10,0,-10
2389,1,1,470,1528,1058
2390,1,1,75,1633,1558
2391,1,0,146,0,-146
2392,0,0,45,0,-45
2393,1,1,64,1434,1370
2394,1,0,82,0,-82
2395,0,0,48,0,-48
2396,1,0,110,0,-110
2397,0,0,23,0,-23
2398,1,1,153,1228,1075
2399,0,0,135,0,-135
2400,1,1,743,2890,2147
2401,1,1,259,1385,1126
2402,0,0,36,0,-36
2403,1,1,2373,1303,-1070
2404,1,1,93,1281,1188
2405,1,0,11,0,-11
2406,0,0,53,0,-53
2407,1,1,303,1615,1312
2408,0,0,3,0,-3
2409,0,0,10,0,-10
2410,1,1,348,1256,908
2411,0,0,129,0,-129
2412,0,0,41,0,-41
2413,1,1,485,1437,952
2414,1,1,585,2329,1744
2415,1,0,58,0,-58
2416,1,0,7,0,-7
2417,1,1,1351,1309,-42
2418,1,1,451,2273,1822
2419,0,0,96,0,-96
2420,1,1,1356,1570,214
2421,0,0,12,0,-12
2422,0,0,11,0,-11
2423,1,1,372,1542,1170
2424,1,0,52,0,-52
2425,0,0,38,0,-38
2426,1,0,40,0,-40
2427,0,0,87,0,-87
2428,0,0,11,0,-11
2429,1,0,1,0,-1
2430,0,0,80,0,-80
2431,1,1,155,1240,1085
2432,1,1,293,1433,1140
2433,1,1,60,1456,1396
2434,1,1,87,1227,1140
2435,0,0,62,0,-62
2436,1,1,375,1330,955
2437,1,1,697,1363,666
2438,1,1,202,1239,1037
2439,0,0,29,0,-29
2440,1,1,285,1507,1222
2441,1,0,97,0,-97
2442,0,0,36,0,-36
2443,1,1,935,1926,991
2444,1,0,24,0,-24
2445,1,0,37,0,-37
2446,0,0,33,0,-33
2447,1,0,76,0,-76
2448,1,1,1412,1480,68
2449,1,1,808,1236,428
2450,0,0,1,0,-1
2451,1,1,386,1264,878
2452,1,1,109,1222,1113
2453,1,1,224,1400,1176
2454,1,1,105,1271,1166
2455,1,0,20,0,-20
2456,0,0,10,0,-10
2457,1,0,21,0,-21
2458,1,1,522,1757,1235
2459,1,0,11,0,-11
2460,0,0,41,0,-41
2461,1,1,1478,1321,-157
2462,0,0,126,0,-126
2463,1,0,162,0,-162
2464,1,1,64,1491,1427
2465,1,0,77,0,-77
2466,1,0,63,0,-63
2467,1,1,72,1223,1151
2468,1,0,15,0,-15
2469,1,0,111,0,-111
2470,1,1,1299,1295,-4
2471,0,0,82,0,-82
2472,1,1,457,1201,744
2473,1,1,485,1224,739
2474,1,0,13,0,-13
2475,1,1,802,1796,994
2476,1,1,140,2263,2123
2477,1,0,11,0,-11
2478,1,0,41,0,-41
2479,1,1,125,1456,1331
2480,1,0,9,0,-9
2481,1,1,1188,1278,90
2482,0,0,102,0,-102
2483,1,0,25,0,-25
2484,0,0,26,0,-26
2485,1,1,222,1480,1258
2486,0,0,131,0,-131
2487,1,1,452,1591,1139
2488,1,1,134,1690,1556
2489,0,0,18,0,-18
2490,0,0,7,0,-7
2491,1,1,474,1262,788
2492,1,0,50,0,-50
2493,1,1,1264,3633,2369
2494,1,1,1174,1434,260
2495,1,1,241,1596,1355
2496,1,1,708,3194,2486
2497,0,0,86,0,-86
2498,0,0,28,0,-28
2499,1,1,93,1244,1151
2500,0,0,18,0,-18
2501,1,0,26,0,-26
2502,1,0,114,0,-114
2503,0,0,13,0,-13
2504,1,0,29,0,-29
2505,0,0,0,0,0
2506,1,0,84,0,-84
2507,1,0,12,0,-12
2508,0,0,17,0,-17
2509,1,1,451,1917,1466
2510,1,0,3,0,-3
2511,1,1,110,1267,1157
2512,1,1,348,1471,1123
2513,0,0,96,0,-96
2514,1,1,377,1278,901
2515,1,1,76,1346,1270
2516,1,0,36,0,-36
2517,1,0,47,0,-47
2518,0,0,132,0,-132
2519,1,1,88,1230,1142
2520,0,0,52,0,-52
2521,1,1,229,1586,1357
2522,1,1,260,1497,1237
2523,1,1,80,1270,1190
2524,0,0,140,0,-140
2525,0,0,5,0,-5
2526,1,0,233,0,-233
2527,1,1,605,1729,1124
2528,1,0,67,0,-67
2529,1,1,18,1413,1395
2530,1,0,16,0,-16
2531,0,0,8,0,-8
2532,1,0,4,0,-4
2533,0,0,7,0,-7
2534,0,0,47,0,-47
2535,1,1,467,2318,1851
2536,1,1,150,1558,1408
2537,1,1,315,1361,1046
2538,0,0,42,0,-42
2539,0,0,22,0,-22
2540,0,0,0,0,0
2541,1,1,234,1212,978
2542,1,0,4,0,-4
2543,1,1,281,1636,1355
2544,0,0,39,0,-39
2545,1,1,929,1221,292
2546,1,0,29,0,-29
2547,0,0,17,0,-17
2548,0,0,12,0,-12
2549,1,0,47,0,-47
2550,1,0,66,0,-66
2551,1,0,59,0,-59
2552,1,1,2257,1282,-975
2553,0,0,19,0,-19
2554,0,0,3,0,-3
2555,0,0,3,0,-3
2556,0,0,5,0,-5
2557,1,0,54,0,-54
2558,1,1,243,1521,1278
2559,1,1,250,1554,1304
2560,0,0,23,0,-23
2561,1,0,133,0,-133
2562,0,0,205,0,-205
2563,0,0,249,0,-249
2564,1,0,26,0,-26
2565,1,1,490,1275,785
2566,1,1,681,1237,556
2567,1,0,5,0,-5
2568,0,0,5,0,-5
2569,1,1,472,1488,1016
2570,1,0,80,0,-80
2571,1,1,345,1372,1027
2572,0,0,43,0,-43
2573,0,0,29,0,-29
2574,1,1,1657,1447,-210
2575,1,1,915,1339,424
2576,0,0,124,0,-124
2577,0,0,6,0,-6
2578,0,0,62,0,-62
2579,0,0,1,0,-1
2580,0,0,36,0,-36
2581,1,0,130,0,-130
2582,1,1,1336,1642,306
2583,1,0,113,0,-113
2584,0,0,51,0,-51
2585,0,0,61,0,-61
2586,1,0,46,0,-46
2587,0,0,108,0,-108
2588,1,1,1329,1822,493
2589,0,0,41,0,-41
2590,0,0,118,0,-118
2591,0,0,11,0,-11
2592,1,1,221,1220,999
2593,0,0,12,0,-12
2594,1,0,83,0,-83
2595,1,1,274,1304,1030
2596,0,0,103,0,-103
2597,0,0,59,0,-59
2598,1,1,1105,1292,187
2599,1,0,52,0,-52
2600,1,0,37,0,-37
2601,0,0,116,0,-116
2602,0,0,34,0,-34
2603,1,0,102,0,-102
2604,0,0,21,0,-21
2605,0,0,54,0,-54
2606,0,0,48,0,-48
2607,0,0,54,0,-54
2608,0,0,24,0,-24
2609,1,0,6,0,-6
2610,1,1,440,1594,1154
2611,1,1,778,2696,1918
2612,1,0,79,0,-79
2613,1,1,190,1568,1378
2614,1,1,1310,1460,150
2615,0,0,31,0,-31
2616,0,0,13,0,-13
2617,0,0,45,0,-45
2618,1,1,79,1361,1282
2619,0,0,5,0,-5
2620,1,0,64,0,-64
2621,1,0,78,0,-78
2622,1,1,1085,1824,739
2623,1,1,2433,1214,-1219
2624,1,1,468,1395,927
2625,1,1,860,1360,500
2626,0,0,20,0,-20
2627,0,0,31,0,-31
2628,1,0,157,0,-157
2629,0,0,18,0,-18
2630,0,0,55,0,-55
2631,1,0,161,0,-161
2632,0,0,60,0,-60
2633,0,0,23,0,-23
2634,0,0,47,0,-47
2635,0,0,92,0,-92
2636,1,1,1279,1406,127
2637,0,0,102,0,-102
2638,1,1,1844,2023,179
2639,0,0,227,0,-227
2640,1,1,216,1234,1018
2641,1,1,1122,1848,726
2642,1,1,72,1293,1221
2643,0,0,20,0,-20
2644,0,0,172,0,-172
2645,1,1,1547,1301,-246
2646,0,0,143,0,-143
2647,1,1,304,1735,1431
2648,1,1,43,1242,1199
2649,0,0,12,0,-12
2650,1,0,142,0,-142
2651,0,0,16,0,-16
2652,0,0,11,0,-11
2653,1,0,12,0,-12
2654,0,0,2,0,-2
2655,1,0,252,0,-252
2656,1,0,55,0,-55
2657,0,0,8,0,-8
2658,0,0,273,0,-273
2659,1,0,18,0,-18
2660,1,1,88,1366,1278
2661,1,0,0,0,0
2662,1,1,345,1269,924
2663,1,1,443,1729,1286
2664,0,0,58,0,-58
2665,0,0,12,0,-12
2666,0,0,43,0,-43
2667,1,1,468,1373,905
2668,1,0,14,0,-14
2669,0,0,42,0,-42
2670,0,0,79,0,-79
2671,1,0,32,0,-32
2672,0,0,4,0,-4
2673,1,0,58,0,-58
2674,1,0,68,0,-68
2675,0,0,43,0,-43
2676,1,1,1491,1582,91
2677,1,0,26,0,-26
2678,1,1,1217,1214,-3
2679,1,0,8,0,-8
2680,0,0,109,0,-109
2681,1,0,158,0,-158
2682,0,0,72,0,-72
2683,1,0,95,0,-95
2684,1,0,22,0,-22
2685,1,0,18,0,-18
2686,1,0,37,0,-37
2687,0,0,98,0,-98
2688,1,1,332,1754,1422
2689,1,1,158,1523,1365
2690,1,1,397,1282,885
2691,1,1,451,1363,912
2692,0,0,4,0,-4
2693,1,0,171,0,-171
2694,0,0,6,0,-6
2695,0,0,49,0,-49
2696,0,0,7,0,-7
2697,0,0,70,0,-70
2698,1,0,17,0,-17
2699,1,1,555,1539,984
2700,0,0,13,0,-13
2701,1,1,1506,1530,24
2702,1,1,1164,1310,146
2703,0,0,58,0,-58
2704,1,1,655,1486,831
2705,0,0,8,0,-8
2706,0,0,15,0,-15
2707,1,0,11,0,-11
2708,0,0,35,0,-35
2709,1,1,445,1221,776
2710,0,0,36,0,-36
2711,0,0,62,0,-62
2712,1,0,77,0,-77
2713,1,1,234,1382,1148
2714,0,0,28,0,-28
2715,0,0,116,0,-116
2716,0,0,25,0,-25
2717,1,1,125,1526,1401
2718,0,0,281,0,-281
2719,1,0,128,0,-128
2720,1,1,293,2375,2082
2721,1,0,25,0,-25
2722,0,0,34,0,-34
2723,0,0,86,0,-86
2724,1,1,46,1543,1497
2725,0,0,5,0,-5
2726,1,1,641,2214,1573
2727,1,1,545,1312,767
2728,1,1,140,1207,1067
2729,1,0,12,0,-12
2730,0,0,102,0,-102
2731,1,1,459,1305,846
2732,1,1,800,1455,655
2733,1,0,7,0,-7
2734,0,0,36,0,-36
2735,1,1,724,1300,576
2736,1,0,48,0,-48
2737,1,0,17,0,-17
2738,1,1,61,1455,1394
2739,1,1,981,2099,1118
2740,1,1,427,1489,1062
2741,1,0,6,0,-6
2742,1,1,24,1211,1187
2743,1,0,56,0,-56
2744,0,0,128,0,-128
2745,1,0,25,0,-25
2746,0,0,1,0,-1
2747,1,1,156,1385,1229
2748,1,0,68,0,-68
2749,0,0,33,0,-33
2750,1,1,132,1468,1336
2751,1,0,28,0,-28
2752,1,1,1632,1262,-370
2753,0,0,31,0,-31
2754,1,1,103,1569,1466
2755,1,0,32,0,-32
2756,0,0,30,0,-30
2757,0,0,104,0,-104
2758,0,0,77,0,-77
2759,0,0,44,0,-44
2760,0,0,165,0,-165
2761,0,0,211,0,-211
2762,1,1,388,1614,1226
2763,1,0,78,0,-78
2764,0,0,8,0,-8
2765,1,0,22,0,-22
2766,1,0,5,0,-5
2767,1,0,28,0,-28
2768,1,1,227,2310,2083
2769,1,0,8,0,-8
2770,1,1,1431,1421,-10
2771,0,0,141,0,-141
2772,0,0,7,0,-7
2773,1,0,124,0,-124
2774,1,1,643,2156,1513
2775,0,0,1,0,-1
2776,1,0,11,0,-11
2777,0,0,62,0,-62
2778,1,1,290,1216,926
2779,1,1,804,1267,463
2780,1,1,316,1519,1203
2781,1,0,84,0,-84
2782,0,0,44,0,-44
2783,1,1,172,1230,1058
2784,1,1,123,1341,1218
2785,1,1,507,1287,780
2786,0,0,47,0,-47
2787,1,1,63,1415,1352
2788,1,1,682,1521,839
2789,1,1,973,1277,304
2790,1,1,41,1302,1261
2791,0,0,54,0,-54
2792,1,0,40,0,-40
2793,0,0,11,0,-11
2794,1,1,501,1529,1028
2795,0,0,8,0,-8
2796,0,0,0,0,0
2797,0,0,17,0,-17
2798,0,0,87,0,-87
2799,0,0,49,0,-49
2800,0,0,29,0,-29
2801,0,0,216,0,-216
2802,0,0,17,0,-17
2803,0,0,1,0,-1
2804,1,1,470,1654,1184
2805,0,0,190,0,-190
2806,1,1,525,1480,955
2807,0,0,21,0,-21
2808,1,1,1429,1294,-135
2809,1,0,33,0,-33
2810,0,0,176,0,-176
2811,0,0,294,0,-294
2812,1,1,1283,1456,173
2813,1,0,87,0,-87
2814,0,0,99,0,-99
2815,0,0,75,0,-75
2816,0,0,7,0,-7
2817,1,1,763,1310,547
2818,1,0,83,0,-83
2819,0,0,79,0,-79
2820,1,1,240,1215,975
2821,0,0,57,0,-57
2822,0,0,74,0,-74
2823,1,0,58,0,-58
2824,1,0,95,0,-95
2825,1,0,12,0,-12
2826,1,0,0,0,0
2827,1,0,265,0,-265
2828,0,0,30,0,-30
2829,1,1,810,1877,1067
2830,1,0,0,0,0
2831,1,1,183,2209,2026
2832,1,1,1882,1272,-610
2833,1,0,105,0,-105
2834,1,1,1048,1286,238
2835,1,0,31,0,-31
2836,0,0,19,0,-19
2837,1,0,102,0,-102
2838,1,0,2,0,-2
2839,1,0,23,0,-23
2840,1,0,30,0,-30
2841,1,1,108,1232,1124
2842,1,0,42,0,-42
2843,0,0,22,0,-22
2844,0,0,95,0,-95
2845,0,0,56,0,-56
2846,1,0,45,0,-45
2847,0,0,14,0,-14
2848,1,1,1836,1261,-575
2849,1,1,626,1338,712
2850,1,0,3,0,-3
2851,0,0,17,0,-17
2852,1,0,72,0,-72
2853,1,1,443,1702,1259
2854,0,0,31,0,-31
2855,1,0,47,0,-47
2856,1,1,1510,1728,218
2857,1,0,13,0,-13
2858,0,0,4,0,-4
2859,1,0,196,0,-196
2860,1,1,391,2059,1668
2861,1,0,33,0,-33
2862,1,1,351,1207,856
2863,1,0,67,0,-67
2864,1,1,37,1791,1754
2865,1,0,10,0,-10
2866,1,1,1622,2996,1374
2867,0,0,1,0,-1
2868,0,0,18,0,-18
2869,1,0,10,0,-10
2870,0,0,43,0,-43
2871,1,0,104,0,-104
2872,0,0,79,0,-79
2873,0,0,40,0,-40
2874,1,1,1384,1364,-20
2875,0,0,31,0,-31
2876,1,1,217,1396,1179
2877,1,1,1814,1919,105
2878,1,1,116,2167,2051
2879,1,0,36,0,-36
2880,1,1,88,1223,1135
2881,1,0,31,0,-31
2882,0,0,167,0,-167
2883,1,0,50,0,-50
2884,1,0,99,0,-99
2885,0,0,4,0,-4
2886,1,1,539,1309,770
2887,0,0,0,0,0
2888,1,1,87,1253,1166
2889,1,0,25,0,-25
2890,0,0,3,0,-3
2891,1,1,47,1426,1379
2892,1,1,415,1544,1129
2893,0,0,6,0,-6
2894,1,0,60,0,-60
2895,1,1,150,1247,1097
2896,0,0,13,0,-13
2897,1,0,72,0,-72
2898,1,1,99,1935,1836
2899,0,0,20,0,-20
2900,1,1,1390,1283,-107
2901,0,0,120,0,-120
2902,0,0,63,0,-63
2903,1,0,42,0,-42
2904,0,0,70,0,-70
2905,1,0,34,0,-34
2906,0,0,16,0,-16
2907,1,0,50,0,-50
2908,0,0,5,0,-5
2909,1,0,15,0,-15
2910,0,0,9,0,-9
2911,0,0,43,0,-43
2912,1,0,25,0,-25
2913,1,0,23,0,-23
2914,1,1,357,1507,1150
2915,1,0,129,0,-129
2916,1,0,6,0,-6
2917,1,1,251,1820,1569
2918,1,0,8,0,-8
2919,1,0,39,0,-39
2920,0,0,12,0,-12
2921,1,0,75,0,-75
2922,1,1,108,1269,1161
2923,0,0,162,0,-162
2924,0,0,34,0,-34
2925,0,0,41,0,-41
2926,1,0,16,0,-16
2927,1,0,65,0,-65
2928,1,1,334,1491,1157
2929,0,0,110,0,-110
2930,1,0,29,0,-29
2931,1,1,800,1367,567
2932,1,0,119,0,-119
2933,1,0,17,0,-17
2934,0,0,141,0,-141
2935,1,0,7,0,-7
2936,1,0,34,0,-34
2937,0,0,59,0,-59
2938,0,0,212,0,-212
2939,0,0,30,0,-30
2940,0,0,0,0,0
2941,1,1,280,1214,934
2942,1,0,3,0,-3
2943,1,0,43,0,-43
2944,0,0,5,0,-5
2945,1,1,43,1245,1202
2946,1,0,95,0,-95
2947,1,1,547,1328,781
2948,0,0,51,0,-51
2949,1,0,74,0,-74
2950,1,0,20,0,-20
2951,0,0,32,0,-32
2952,1,0,4,0,-4
2953,0,0,0,0,0
2954,0,0,2,0,-2
2955,1,1,314,1316,1002
2956,0,0,29,0,-29
2957,1,1,121,2315,2194
2958,1,1,644,1303,659
2959,0,0,7,0,-7
2960,1,0,1,0,-1
2961,1,1,291,1306,1015
2962,0,0,26,0,-26
2963,0,0,37,0,-37
2964,1,0,53,0,-53
2965,1,0,65,0,-65
2966,0,0,16,0,-16
2967,1,0,52,0,-52
2968,1,0,113,0,-113
2969,1,1,1453,1368,-85
2970,1,0,83,0,-83
2971,1,0,39,0,-39
2972,1,1,217,1234,1017
2973,0,0,106,0,-106
2974,0,0,49,0,-49
2975,1,0,40,0,-40
2976,1,0,8,0,-8
2977,1,1,241,1598,1357
2978,0,0,85,0,-85
2979,1,1,519,1242,723
2980,1,0,4,0,-4
2981,1,0,3,0,-3
2982,1,1,697,1277,580
2983,1,1,336,1243,907
2984,1,0,21,0,-21
2985,1,0,2,0,-2
2986,1,1,250,2099,1849
2987,1,0,79,0,-79
2988,0,0,42,0,-42
2989,0,0,38,0,-38
2990,1,0,11,0,-11
2991,1,1,1339,1426,87
2992,1,1,97,1435,1338
2993,0,0,60,0,-60
2994,1,0,20,0,-20
2995,1,1,4,1312,1308
2996,1,0,7,0,-7
2997,1,0,10,0,-10
2998,1,0,4,0,-4
2999,0,0,73,0,-73
3000,1,1,717,1877,1160
3001,0,0,6,0,-6
3002,1,1,665,1743,1078
3003,0,0,54,0,-54
3004,1,0,8,0,-8
3005,1,1,611,1330,719
3006,1,0,97,0,-97
3007,1,1,618,1380,762
3008,1,0,13,0,-13
3009,1,0,173,0,-173
3010,0,0,0,0,0
3011,1,1,804,1824,1020
3012,0,0,189,0,-189
3013,1,0,37,0,-37
3014,1,1,133,1529,1396
3015,0,0,32,0,-32
3016,1,1,765,2247,1482
3017,1,1,74,1834,1760
3018,1,1,528,1606,1078
3019,0,0,14,0,-14
3020,1,0,203,0,-203
3021,1,0,184,0,-184
3022,1,1,533,1308,775
3023,1,0,37,0,-37
3024,1,0,26,0,-26
3025,0,0,54,0,-54
3026,1,0,125,0,-125
3027,1,1,93,1350,1257
3028,0,0,51,0,-51
3029,1,1,172,1961,1789
3030,1,0,32,0,-32
3031,1,1,341,1450,1109
3032,1,0,6,0,-6
3033,1,0,15,0,-15
3034,0,0,3,0,-3
3035,0,0,17,0,-17
3036,1,0,50,0,-50
3037,1,1,442,1615,1173
3038,1,1,225,1216,991
3039,0,0,50,0,-50
3040,0,0,5,0,-5
3041,0,0,71,0,-71
3042,0,0,12,0,-12
3043,0,0,106,0,-106
3044,1,0,20,0,-20
3045,1,1,413,1275,862
3046,0,0,19,0,-19
3047,1,0,19,0,-19
3048,1,0,74,0,-74
3049,0,0,17,0,-17
3050,1,1,260,1372,1112
3051,1,0,18,0,-18
3052,0,0,4,0,-4
3053,1,1,352,1477,1125
3054,0,0,43,0,-43
3055,1,1,100,1257,1157
3056,1,0,163,0,-163
3057,1,1,319,3675,3356
3058,0,0,339,0,-339
3059,0,0,10,0,-10
3060,1,1,900,1618,718
3061,0,0,62,0,-62
3062,1,0,177,0,-177
3063,1,1,237,1247,1010
3064,1,1,228,1434,1206
3065,1,1,202,1559,1357
3066,0,0,23,0,-23
3067,1,0,77,0,-77
3068,1,0,74,0,-74
3069,1,0,113,0,-113
3070,1,0,76,0,-76
3071,0,0,31,0,-31
3072,0,0,135,0,-135
3073,0,0,30,0,-30
3074,1,0,6,0,-6
3075,0,0,27,0,-27
3076,1,1,255,1258,1003
3077,0,0,61,0,-61
3078,0,0,40,0,-40
3079,0,0,40,0,-40
3080,0,0,46,0,-46
3081,1,0,8,0,-8
3082,1,0,81,0,-81
3083,1,1,242,1621,1379
3084,1,1,152,1210,1058
3085,1,1,801,1362,561
3086,1,1,438,1521,1083
3087,0,0,115,0,-115
3088,0,0,62,0,-62
3089,0,0,37,0,-37
3090,0,0,28,0,-28
3091,1,0,7,0,-7
3092,1,0,108,0,-108
3093,1,1,1315,1289,-26
3094,0,0,84,0,-84
3095,0,0,50,0,-50
3096,1,1,460,2062,1602
3097,0,0,17,0,-17
3098,0,0,56,0,-56
3099,1,1,165,1252,1087
3100,1,1,335,1634,1299
3101,1,0,34,0,-34
3102,0,0,4,0,-4
3103,0,0,27,0,-27
3104,1,1,301,1342,1041
3105,1,0,109,0,-109
3106,0,0,124,0,-124
3107,1,0,16,0,-16
3108,1,0,34,0,-34
3109,0,0,158,0,-158
3110,1,0,2,0,-2
3111,1,1,1576,1289,-287
3112,1,0,6,0,-6
3113,1,0,47,0,-47
3114,0,0,1,0,-1
3115,1,0,232,0,-232
3116,1,0,101,0,-101
3117,0,0,15,0,-15
3118,1,1,76,2332,2256
3119,1,0,12,0,-12
3120,1,1,657,1322,665
3121,1,0,13,0,-13
3122,1,0,36,0,-36
3123,1,1,673,2327,1654
3124,1,0,150,0,-150
3125,0,0,125,0,-125
3126,0,0,56,0,-56
3127,0,0,91,0,-91
3128,1,0,22,0,-22
3129,1,0,35,0,-35
3130,1,0,53,0,-53
3131,1,0,15,0,-15
3132,1,0,17,0,-17
3133,0,0,40,0,-40
3134,0,0,75,0,-75
3135,0,0,27,0,-27
3136,0,0,5,0,-5
3137,0,0,44,0,-44
3138,0,0,72,0,-72
3139,1,0,31,0,-31
3140,1,1,141,1688,1547
3141,1,0,3,0,-3
3142,0,0,109,0,-109
3143,0,0,95,0,-95
3144,1,0,254,0,-254
3145,0,0,13,0,-13
3146,1,1,288,1396,1108
3147,1,1,1150,6944,5794
3148,1,1,360,1552,1192
3149,1,0,11,0,-11
3150,1,1,392,1585,1193
3151,0,0,113,0,-113
3152,1,0,40,0,-40
3153,1,1,26,1520,1494
3154,1,1,184,1222,1038
3155,1,0,8,0,-8
3156,1,0,10,0,-10
3157,1,1,760,2167,1407
3158,0,0,17,0,-17
3159,1,1,867,1545,678
3160,1,0,30,0,-30
3161,1,1,157,1290,1133
3162,0,0,16,0,-16
3163,1,0,31,0,-31
3164,1,0,0,0,0
3165,1,1,209,1440,1231
3166,0,0,50,0,-50
3167,1,1,625,1278,653
3168,0,0,64,0,-64
3169,0,0,50,0,-50
3170,1,1,611,1346,735
3171,1,1,254,1400,1146
3172,1,1,190,1747,1557
3173,0,0,27,0,-27
3174,0,0,18,0,-18
3175,1,1,1090,2416,1326
3176,0,0,72,0,-72
3177,1,0,99,0,-99
3178,0,0,64,0,-64
3179,1,1,2014,1389,-625
3180,0,0,19,0,-19
3181,0,0,0,0,0
3182,0,0,12,0,-12
3183,0,0,44,0,-44
3184,1,1,240,1533,1293
3185,1,0,50,0,-50
3186,1,0,19,0,-19
3187,0,0,58,0,-58
3188,1,1,152,1266,1114
3189,0,0,28,0,-28
3190,1,0,78,0,-78
3191,1,0,2,0,-2
3192,1,0,16,0,-16
3193,1,0,31,0,-31
3194,0,0,102,0,-102
3195,1,0,1,0,-1
3196,1,1,150,1317,1167
3197,1,0,10,0,-10
3198,1,1,394,1675,1281
3199,0,0,85,0,-85
3200,1,1,803,1208,405
3201,0,0,9,0,-9
3202,1,1,414,1572,1158
3203,0,0,6,0,-6
3204,0,0,3,0,-3
3205,0,0,9,0,-9
3206,1,1,563,1576,1013
3207,1,1,769,1281,512
3208,0,0,24,0,-24
3209,1,0,57,0,-57
3210,1,0,117,0,-117
3211,1,1,442,1839,1397
3212,1,0,172,0,-172
3213,1,0,111,0,-111
3214,1,0,72,0,-72
3215,1,0,1,0,-1
3216,0,0,42,0,-42
3217,1,0,11,0,-11
3218,0,0,53,0,-53
3219,1,1,198,1373,1175
3220,1,0,77,0,-77
3221,0,0,60,0,-60
3222,1,1,218,2708,2490
3223,1,1,1011,1792,781
3224,0,0,45,0,-45
3225,1,0,9,0,-9
3226,0,0,107,0,-107
3227,1,0,102,0,-102
3228,1,1,357,1337,980
3229,1,0,62,0,-62
3230,0,0,16,0,-16
3231,0,0,75,0,-75
3232,1,1,873,1235,362
3233,1,0,18,0,-18
3234,0,0,26,0,-26
3235,0,0,2,0,-2
3236,1,0,101,0,-101
3237,1,1,277,1238,961
3238,1,1,496,1231,735
3239,1,1,307,1345,1038
3240,1,0,85,0,-85
3241,0,0,168,0,-168
3242,0,0,16,0,-16
3243,1,1,120,1270,1150
3244,0,0,39,0,-39
3245,0,0,74,0,-74
3246,1,1,705,1290,585
3247,1,0,24,0,-24
3248,1,0,21,0,-21
3249,1,1,261,1382,1121
3250,1,1,128,1368,1240
3251,1,0,3,0,-3
3252,1,0,82,0,-82
3253,0,0,16,0,-16
3254,0,0,81,0,-81
3255,0,0,5,0,-5
3256,1,0,14,0,-14
3257,1,0,1,0,-1
3258,1,1,847,2646,1799
3259,1,1,65,1351,1286
3260,0,0,71,0,-71
3261,1,1,142,2263,2121
3262,0,0,61,0,-61
3263,0,0,5,0,-5
3264,0,0,8,0,-8
3265,1,1,417,2600,2183
3266,1,1,167,1475,1308
3267,1,0,5,0,-5
3268,1,1,150,1405,1255
3269,1,1,212,1200,988
3270,0,0,0,0,0
3271,0,0,4,0,-4
3272,1,0,4,0,-4
3273,1,0,77,0,-77
3274,1,0,59,0,-59
3275,1,0,23,0,-23
3276,1,0,15,0,-15
3277,1,0,52,0,-52
3278,0,0,131,0,-131
3279,0,0,53,0,-53
3280,0,0,41,0,-41
3281,1,1,633,1801,1168
3282,0,0,37,0,-37
3283,0,0,11,0,-11
3284,1,0,52,0,-52
3285,0,0,7,0,-7
3286,1,1,188,1208,1020
3287,0,0,69,0,-69
3288,1,0,53,0,-53
3289,1,0,35,0,-35
3290,1,1,7,1218,1211
3291,1,1,350,1313,963
3292,1,1,140,1212,1072
3293,0,0,55,0,-55
3294,1,0,11,0,-11
3295,1,0,137,0,-137
3296,1,1,252,1364,1112
3297,0,0,107,0,-107
3298,1,1,342,1402,1060
3299,1,1,381,1328,947
3300,0,0,57,0,-57
3301,1,0,77,0,-77
3302,0,0,26,0,-26
3303,0,0,84,0,-84
3304,1,1,148,1863,1715
3305,1,1,195,1692,1497
3306,1,1,381,1261,880
3307,1,1,680,1388,708
3308,0,0,17,0,-17
3309,1,1,538,1267,729
3310,1,1,228,1297,1069
3311,0,0,110,0,-110
3312,0,0,86,0,-86
3313,0,0,63,0,-63
3314,1,1,395,1570,1175
3315,1,0,20,0,-20
3316,1,1,67,1816,1749
3317,1,0,83,0,-83
3318,0,0,13,0,-13
3319,1,1,393,1243,850
3320,0,0,113,0,-113
3321,1,0,290,0,-290
3322,0,0,15,0,-15
3323,1,1,164,1226,1062
3324,1,1,610,1324,714
3325,1,1,546,2073,1527
3326,1,0,15,0,-15
3327,1,0,210,0,-210
3328,1,0,26,0,-26
3329,0,0,116,0,-116
3330,0,0,41,0,-41
3331,1,1,1722,1255,-467
3332,1,0,4,0,-4
3333,1,1,232,2159,1927
3334,1,1,520,1336,816
3335,0,0,41,0,-41
3336,1,0,4,0,-4
3337,1,1,208,1251,1043
3338,1,1,394,2527,2133
3339,1,1,650,2527,1877
3340,0,0,10,0,-10
3341,0,0,29,0,-29
3342,1,1,58,2091,2033
3343,0,0,6,0,-6
3344,1,0,165,0,-165
3345,1,1,23,1469,1446
3346,1,1,93,1312,1219
3347,0,0,35,0,-35
3348,0,0,74,0,-74
3349,0,0,25,0,-25
3350,1,0,199,0,-199
3351,0,0,30,0,-30
3352,1,1,1936,2542,606
3353,0,0,4,0,-4
3354,1,0,21,0,-21
3355,1,1,551,1901,1350
3356,1,1,1562,1396,-166
3357,1,1,511,1203,692
3358,1,1,432,1271,839
3359,0,0,147,0,-147
3360,0,0,147,0,-147
3361,0,0,54,0,-54
3362,0,0,8,0,-8
3363,1,0,21,0,-21
3364,1,0,49,0,-49
3365,1,1,72,1341,1269
3366,1,1,1744,1759,15
3367,0,0,0,0,0
3368,1,1,15,1639,1624
3369,1,0,23,0,-23
3370,1,0,73,0,-73
3371,1,0,4,0,-4
3372,1,1,290,1266,976
3373,0,0,15,0,-15
3374,1,1,291,2621,2330
3375,1,0,26,0,-26
3376,1,1,112,1899,1787
3377,0,0,17,0,-17
3378,1,1,95,1470,1375
3379,0,0,42,0,-42
3380,0,0,99,0,-99
3381,1,0,45,0,-45
3382,0,0,39,0,-39
3383,1,1,1105,1387,282
3384,1,1,327,2181,1854
3385,1,1,420,1366,946
3386,1,1,202,1463,1261
3387,1,1,509,1238,729
3388,0,0,33,0,-33
3389,0,0,5,0,-5
3390,0,0,10,0,-10
3391,0,0,10,0,-10
3392,1,1,234,1284,1050
3393,1,0,88,0,-88
3394,0,0,5,0,-5
3395,1,0,93,0,-93
3396,0,0,18,0,-18
3397,0,0,0,0,0
3398,1,0,82,0,-82
3399,0,0,34,0,-34
3400,1,1,234,1768,1534
3401,0,0,45,0,-45
3402,0,0,9,0,-9
3403,1,0,29,0,-29
3404,0,0,25,0,-25
3405,0,0,0,0,0
3406,1,0,5,0,-5
3407,0,0,15,0,-15
3408,1,0,3,0,-3
3409,1,0,11,0,-11
3410,1,1,304,1276,972
3411,0,0,18,0,-18
3412,1,1,916,1301,385
3413,1,0,23,0,-23
3414,1,1,576,1200,624
3415,1,0,1,0,-1
3416,1,1,481,1380,899
3417,1,1,478,1677,1199
3418,1,1,506,1211,705
3419,0,0,30,0,-30
3420,0,0,44,0,-44
3421,1,1,426,1845,1419
3422,1,1,339,1395,1056
3423,0,0,60,0,-60
3424,1,0,90,0,-90
3425,0,0,146,0,-146
3426,1,0,8,0,-8
3427,0,0,94,0,-94
3428,0,0,6,0,-6
3429,0,0,14,0,-14
3430,1,1,251,1327,1076
3431,0,0,246,0,-246
3432,0,0,106,0,-106
3433,0,0,30,0,-30
3434,0,0,69,0,-69
3435,0,0,36,0,-36
3436,0,0,27,0,-27
3437,1,0,165,0,-165
3438,1,1,927,1320,393
3439,1,1,556,1369,813
3440,1,1,454,1200,746
3441,1,0,103,0,-103
3442,1,0,12,0,-12
3443,1,1,537,1536,999
3444,0,0,5,0,-5
3445,0,0,13,0,-13
3446,1,0,30,0,-30
3447,1,1,340,1570,1230
3448,1,1,652,1868,1216
3449,1,1,470,1300,830
3450,0,0,11,0,-11
3451,1,0,20,0,-20
3452,1,0,57,0,-57
3453,1,0,31,0,-31
3454,0,0,70,0,-70
3455,1,1,436,1944,1508
3456,0,0,28,0,-28
3457,0,0,33,0,-33
3458,0,0,12,0,-12
3459,0,0,99,0,-99
3460,1,0,22,0,-22
3461,1,1,765,1250,485
3462,0,0,45,0,-45
3463,1,1,624,2549,1925
3464,0,0,25,0,-25
3465,0,0,49,0,-49
3466,1,0,131,0,-131
3467,1,0,2,0,-2
3468,1,0,4,0,-4
3469,1,0,100,0,-100
3470,1,1,422,1474,1052
3471,0,0,38,0,-38
3472,1,1,257,1300,1043
3473,1,1,405,1736,1331
3474,1,1,354,2855,2501
3475,1,1,1569,1222,-347
3476,1,0,89,0,-89
3477,0,0,58,0,-58
3478,1,1,604,1394,790
3479,0,0,16,0,-16
3480,1,0,16,0,-16
3481,0,0,91,0,-91
3482,1,1,80,1499,1419
3483,1,1,169,1518,1349
3484,0,0,24,0,-24
3485,1,1,1024,2123,1099
3486,0,0,11,0,-11
3487,1,1,1349,1626,277
3488,0,0,32,0,-32
3489,1,1,141,1286,1145
3490,1,1,662,1997,1335
3491,1,0,105,0,-105
3492,0,0,42,0,-42
3493,0,0,33,0,-33
3494,0,0,79,0,-79
3495,1,0,101,0,-101
3496,1,1,215,1927,1712
3497,1,0,102,0,-102
3498,1,1,388,1278,890
3499,0,0,77,0,-77
3500,1,1,564,1219,655
3501,0,0,5,0,-5
3502,0,0,59,0,-59
3503,1,1,194,2056,1862
3504,1,1,394,1434,1040
3505,1,0,63,0,-63
3506,0,0,45,0,-45
3507,1,0,4,0,-4
3508,1,1,199,3087,2888
3509,0,0,48,0,-48
3510,1,0,19,0,-19
3511,0,0,200,0,-200
3512,0,0,21,0,-21
3513,1,0,24,0,-24
3514,1,1,128,1265,1137
3515,1,1,226,3130,2904
3516,1,1,896,2519,1623
3517,1,1,502,1278,776
3518,1,1,234,1915,1681
3519,1,0,31,0,-31
3520,0,0,58,0,-58
3521,1,0,10,0,-10
3522,1,1,180,2963,2783
3523,0,0,170,0,-170
3524,0,0,46,0,-46
3525,1,0,71,0,-71
3526,0,0,73,0,-73
3527,0,0,27,0,-27
3528,1,0,23,0,-23
3529,1,1,1290,1266,-24
3530,0,0,119,0,-119
3531,1,0,69,0,-69
3532,0,0,52,0,-52
3533,0,0,9,0,-9
3534,1,1,372,1538,1166
3535,0,0,21,0,-21
3536,1,1,209,1329,1120
3537,1,1,1079,1313,234
3538,1,0,53,0,-53
3539,1,1,1031,1478,447
3540,1,1,863,1248,385
3541,0,0,45,0,-45
3542,1,0,70,0,-70
3543,1,0,57,0,-57
3544,0,0,60,0,-60
3545,1,0,21,0,-21
3546,0,0,6,0,-6
3547,1,0,20,0,-20
3548,1,0,3,0,-3
3549,1,1,480,1393,913
3550,0,0,35,0,-35
3551,0,0,17,0,-17
3552,1,1,72,1584,1512
3553,1,0,125,0,-125
3554,0,0,49,0,-49
3555,1,0,16,0,-16
3556,0,0,45,0,-45
3557,0,0,162,0,-162
3558,0,0,6,0,-6
3559,0,0,120,0,-120
3560,1,0,21,0,-21
3561,0,0,29,0,-29
3562,1,1,598,1523,925
3563,1,1,203,1489,1286
3564,0,0,3,0,-3
3565,1,1,317,1313,996
3566,1,1,246,1215,969
3567,0,0,1,0,-1
3568,1,1,62,1232,1170
3569,0,0,7,0,-7
3570,1,1,37,1361,1324
3571,1,1,1125,1540,415
3572,1,0,1,0,-1
3573,1,1,273,1201,928
3574,1,0,180,0,-180
3575,1,1,850,1435,585
3576,1,0,176,0,-176
3577,1,1,540,1254,714
3578,1,1,374,1292,918
3579,1,1,1147,1324,177
3580,1,1,298,1349,1051
3581,0,0,145,0,-145
3582,1,0,79,0,-79
3583,1,1,117,4565,4448
3584,1,0,37,0,-37
3585,0,0,5,0,-5
3586,0,0,0,0,0
3587,1,1,185,1275,1090
3588,1,0,26,0,-26
3589,1,1,148,1623,1475
3590,1,0,49,0,-49
3591,0,0,1,0,-1
3592,1,0,66,0,-66
3593,0,0,55,0,-55
3594,1,1,216,2028,1812
3595,1,0,0,0,0
3596,1,1,732,1239,507
3597,1,0,25,0,-25
3598,1,1,884,1407,523
3599,0,0,6,0,-6
3600,1,1,230,1272,1042
3601,1,0,38,0,-38
3602,0,0,7,0,-7
3603,1,0,14,0,-14
3604,0,0,32,0,-32
3605,1,1,147,1410,1263
3606,1,0,9,0,-9
3607,0,0,163,0,-163
3608,0,0,110,0,-110
3609,0,0,83,0,-83
3610,1,0,32,0,-32
3611,1,0,65,0,-65
3612,0,0,17,0,-17
3613,0,0,41,0,-41
3614,1,1,222,1269,1047
3615,0,0,44,0,-44
3616,0,0,27,0,-27
3617,1,1,413,1261,848
3618,1,0,1,0,-1
3619,0,0,207,0,-207
3620,0,0,34,0,-34
3621,0,0,166,0,-166
3622,1,1,82,1235,1153
3623,1,1,211,1290,1079
3624,0,0,58,0,-58
3625,0,0,138,0,-138
3626,1,0,26,0,-26
3627,0,0,54,0,-54
3628,0,0,57,0,-57
3629,1,0,3,0,-3
3630,0,0,12,0,-12
3631,1,1,1075,1418,343
3632,0,0,63,0,-63
3633,0,0,71,0,-71
3634,0,0,8,0,-8
3635,0,0,44,0,-44
3636,0,0,12,0,-12
3637,1,1,414,1647,1233
3638,1,0,5,0,-5
3639,1,0,6,0,-6
3640,1,1,210,1774,1564
3641,1,0,21,0,-21
3642,1,0,93,0,-93
3643,1,0,19,0,-19
3644,1,1,378,1346,968
3645,1,1,593,1602,1009
3646,1,1,2127,1313,-814
3647,0,0,42,0,-42
3648,1,1,883,1378,495
3649,1,1,273,1427,1154
3650,1,0,26,0,-26
3651,0,0,35,0,-35
3652,1,1,194,1204,1010
3653,1,0,5,0,-5
3654,1,0,1,0,-1
3655,0,0,104,0,-104
3656,1,0,3,0,-3
3657,0,0,3,0,-3
3658,0,0,26,0,-26
3659,0,0,10,0,-10
3660,1,0,89,0,-89
3661,1,0,20,0,-20
3662,0,0,10,0,-10
3663,0,0,53,0,-53
3664,0,0,162,0,-162
3665,0,0,195,0,-195
3666,1,0,8,0,-8
3667,1,0,70,0,-70
3668,1,0,155,0,-155
3669,0,0,164,0,-164
3670,1,1,851,2160,1309
3671,0,0,46,0,-46
3672,1,0,64,0,-64
3673,1,0,0,0,0
3674,0,0,6,0,-6
3675,1,0,46,0,-46
3676,1,1,730,1582,852
3677,1,0,49,0,-49
3678,0,0,23,0,-23
3679,0,0,10,0,-10
3680,1,1,471,2056,1585
3681,1,1,1902,1222,-680
3682,0,0,0,0,0
3683,1,0,22,0,-22
3684,0,0,161,0,-161
3685,1,1,202,2124,1922
3686,0,0,7,0,-7
3687,1,0,9,0,-9
3688,1,0,28,0,-28
3689,0,0,17,0,-17
3690,0,0,29,0,-29
3691,0,0,202,0,-202
3692,1,0,118,0,-118
3693,0,0,13,0,-13
3694,1,0,26,0,-26
3695,1,1,556,1678,1122
3696,1,0,29,0,-29
3697,1,0,13,0,-13
3698,1,1,47,1306,1259
3699,1,0,99,0,-99
3700,1,1,387,1650,1263
3701,1,1,427,1618,1191
3702,1,1,736,1406,670
3703,0,0,11,0,-11
3704,1,0,36,0,-36
3705,1,0,145,0,-145
3706,1,0,31,0,-31
3707,0,0,1,0,-1
3708,1,1,697,1203,506
3709,1,0,30,0,-30
3710,0,0,11,0,-11
3711,1,1,902,1363,461
3712,1,0,98,0,-98
3713,0,0,9,0,-9
3714,1,0,22,0,-22
3715,1,1,1017,1813,796
3716,0,0,52,0,-52
3717,0,0,95,0,-95
3718,1,1,249,1979,1730
3719,0,0,1,0,-1
3720,0,0,12,0,-12
3721,0,0,62,0,-62
3722,0,0,15,0,-15
3723,1,0,5,0,-5
3724,1,0,60,0,-60
3725,1,0,21,0,-21
3726,1,1,495,1230,735
3727,0,0,21,0,-21
3728,1,0,22,0,-22
3729,0,0,56,0,-56
3730,1,0,83,0,-83
3731,1,0,139,0,-139
3732,1,0,8,0,-8
3733,1,0,6,0,-6
3734,1,1,564,1496,932
3735,1,1,678,1485,807
3736,0,0,38,0,-38
3737,0,0,14,0,-14
3738,1,0,51,0,-51
3739,1,1,1691,1353,-338
3740,1,1,111,1594,1483
3741,0,0,1,0,-1
3742,0,0,58,0,-58
3743,1,1,68,1715,1647
3744,1,1,510,1801,1291
3745,1,1,303,1393,1090
3746,1,0,3,0,-3
3747,1,0,114,0,-114
3748,0,0,136,0,-136
3749,1,0,62,0,-62
3750,1,0,84,0,-84
3751,1,1,182,2014,1832
3752,1,1,370,1896,1526
3753,1,0,92,0,-92
3754,0,0,32,0,-32
3755,0,0,24,0,-24
3756,1,1,248,2422,2174
3757,0,0,133,0,-133
3758,1,0,84,0,-84
3759,1,1,469,2403,1934
3760,0,0,52,0,-52
3761,1,0,72,0,-72
3762,1,1,123,1251,1128
3763,1,1,491,1247,756
3764,1,0,40,0,-40
3765,1,1,579,1503,924
3766,0,0,119,0,-119
3767,1,0,82,0,-82
3768,1,1,353,1555,1202
3769,1,0,82,0,-82
3770,1,1,450,1373,923
3771,1,1,15,1233,1218
3772,1,0,75,0,-75
3773,0,0,36,0,-36
3774,1,0,18,0,-18
3775,1,0,32,0,-32
3776,1,1,381,1312,931
3777,0,0,78,0,-78
3778,0,0,0,0,0
3779,0,0,70,0,-70
3780,0,0,68,0,-68
3781,1,0,33,0,-33
3782,1,0,11,0,-11
3783,0,0,37,0,-37
3784,1,1,293,1639,1346
3785,1,1,911,1574,663
3786,1,0,1,0,-1
3787,0,0,59,0,-59
3788,0,0,84,0,-84
3789,0,0,119,0,-119
3790,1,1,205,1451,1246
3791,0,0,37,0,-37
3792,0,0,1,0,-1
3793,1,1,726,1327,601
3794,1,1,2295,1202,-1093
3795,0,0,53,0,-53
3796,1,1,380,1553,1173
3797,1,0,40,0,-40
3798,1,0,93,0,-93
3799,1,1,1074,2968,1894
3800,1,1,327,1459,1132
3801,1,0,12,0,-12
3802,1,0,50,0,-50
3803,1,0,24,0,-24
3804,0,0,23,0,-23
3805,0,0,212,0,-212
3806,1,1,662,1467,805
3807,1,0,41,0,-41
3808,1,1,105,1418,1313
3809,0,0,138,0,-138
3810,0,0,16,0,-16
3811,1,0,50,0,-50
3812,1,1,27,1625,1598
3813,1,1,807,1293,486
3814,1,1,521,1204,683
3815,1,1,737,1226,489
3816,0,0,30,0,-30
3817,1,0,64,0,-64
3818,1,0,7,0,-7
3819,0,0,1,0,-1
3820,1,1,1263,1334,71
3821,0,0,33,0,-33
3822,0,0,106,0,-106
3823,0,0,4,0,-4
3824,1,0,27,0,-27
3825,0,0,19,0,-19
3826,0,0,1,0,-1
3827,0,0,171,0,-171
3828,0,0,19,0,-19
3829,1,1,817,3819,3002
3830,1,1,359,1907,1548
3831,0,0,20,0,-20
3832,1,1,1186,1288,102
3833,1,0,13,0,-13
3834,1,0,21,0,-21
3835,0,0,40,0,-40
3836,1,0,22,0,-22
3837,0,0,11,0,-11
3838,1,1,452,1218,766
3839,0,0,17,0,-17
3840,1,1,488,2716,2228
3841,1,1,60,1461,1401
3842,1,1,533,1334,801
3843,0,0,3,0,-3
3844,1,0,160,0,-160
3845,1,1,537,1294,757
3846,1,0,29,0,-29
3847,0,0,151,0,-151
3848,0,0,20,0,-20
3849,1,0,18,0,-18
3850,0,0,106,0,-106
3851,0,0,60,0,-60
3852,1,1,139,1222,1083
3853,1,0,90,0,-90
3854,1,1,166,1668,1502
3855,0,0,18,0,-18
3856,1,1,117,2771,2654
3857,1,1,1562,1220,-342
3858,1,1,27,1709,1682
3859,0,0,22,0,-22
3860,0,0,14,0,-14
3861,0,0,50,0,-50
3862,0,0,2,0,-2
3863,0,0,150,0,-150
3864,0,0,103,0,-103
3865,1,1,140,1214,1074
3866,0,0,34,0,-34
3867,0,0,21,0,-21
3868,0,0,18,0,-18
3869,0,0,104,0,-104
3870,1,1,123,1257,1134
3871,1,0,65,0,-65
3872,0,0,0,0,0
3873,0,0,118,0,-118
3874,0,0,19,0,-19
3875,1,1,509,1313,804
3876,1,1,308,1959,1651
3877,1,1,635,1380,745
3878,0,0,175,0,-175
3879,0,0,48,0,-48
3880,0,0,45,0,-45
3881,0,0,78,0,-78
3882,1,1,89,1881,1792
3883,0,0,3,0,-3
3884,1,1,174,1210,1036
3885,1,0,104,0,-104
3886,0,0,4,0,-4
3887,0,0,27,0,-27
3888,1,0,27,0,-27
3889,1,0,27,0,-27
3890,1,1,592,1888,1296
3891,0,0,154,0,-154
3892,0,0,161,0,-161
3893,1,0,12,0,-12
3894,0,0,60,0,-60
3895,1,0,46,0,-46
3896,1,0,3,0,-3
3897,1,0,18,0,-18
3898,1,1,229,1448,1219
3899,1,0,7,0,-7
3900,1,0,67,0,-67
3901,1,0,32,0,-32
3902,1,0,95,0,-95
3903,1,1,109,1240,1131
3904,0,0,14,0,-14
3905,0,0,6,0,-6
3906,1,0,14,0,-14
3907,1,1,169,1956,1787
3908,0,0,17,0,-17
3909,1,0,7,0,-7
3910,1,0,44,0,-44
3911,0,0,10,0,-10
3912,0,0,63,0,-63
3913,1,1,25,1219,1194
3914,0,0,237,0,-237
3915,1,1,591,1245,654
3916,0,0,7,0,-7
3917,1,1,173,1296,1123
3918,1,1,943,1673,730
3919,0,0,135,0,-135
3920,1,0,214,0,-214
3921,0,0,8,0,-8
3922,0,0,18,0,-18
3923,0,0,20,0,-20
3924,0,0,0,0,0
3925,1,1,146,1207,1061
3926,0,0,10,0,-10
3927,0,0,3,0,-3
3928,0,0,32,0,-32
3929,1,0,84,0,-84
3930,0,0,0,0,0
3931,1,0,11,0,-11
3932,0,0,56,0,-56
3933,1,1,1815,1478,-337
3934,0,0,0,0,0
3935,0,0,60,0,-60
3936,1,0,22,0,-22
3937,0,0,179,0,-179
3938,1,0,25,0,-25
3939,0,0,12,0,-12
3940,0,0,12,0,-12
3941,1,0,19,0,-19
3942,1,1,470,1286,816
3943,1,1,505,1687,1182
3944,1,1,1265,2657,1392
3945,0,0,38,0,-38
3946,1,1,238,1366,1128
3947,1,0,58,0,-58
3948,1,0,115,0,-115
3949,0,0,109,0,-109
3950,1,0,49,0,-49
3951,1,0,2,0,-2
3952,0,0,100,0,-100
3953,1,0,39,0,-39
3954,1,1,923,1216,293
3955,0,0,181,0,-181
3956,1,1,226,1200,974
3957,1,0,119,0,-119
3958,1,0,28,0,-28
3959,1,1,501,1278,777
3960,1,1,357,1603,1246
3961,1,0,89,0,-89
3962,0,0,12,0,-12
3963,0,0,39,0,-39
3964,0,0,10,0,-10
3965,0,0,159,0,-159
3966,1,0,215,0,-215
3967,1,0,17,0,-17
3968,0,0,53,0,-53
3969,0,0,25,0,-25
3970,1,1,437,1222,785
3971,0,0,5,0,-5
3972,1,1,1481,2366,885
3973,0,0,69,0,-69
3974,1,1,741,2665,1924
3975,1,0,7,0,-7
3976,0,0,75,0,-75
3977,1,0,8,0,-8
3978,1,1,358,1298,940
3979,1,0,33,0,-33
3980,1,0,67,0,-67
3981,1,0,30,0,-30
3982,1,0,100,0,-100
3983,1,0,3,0,-3
3984,1,0,13,0,-13
3985,0,0,4,0,-4
3986,0,0,7,0,-7
3987,1,1,753,1200,447
3988,0,0,12,0,-12
3989,1,0,13,0,-13
3990,1,0,23,0,-23
3991,1,0,41,0,-41
3992,1,0,37,0,-37
3993,1,1,672,1222,550
3994,0,0,19,0,-19
3995,0,0,0,0,0
3996,1,1,683,1303,620
3997,0,0,57,0,-57
3998,0,0,11,0,-11
3999,0,0,5,0,-5
4000,1,0,25,0,-25
4001,0,0,114,0,-114
4002,1,0,64,0,-64
4003,1,1,2394,1582,-812
4004,1,0,23,0,-23
4005,1,1,207,1266,1059
4006,0,0,209,0,-209
4007,1,1,492,1279,787
4008,0,0,5,0,-5
4009,0,0,5,0,-5
4010,1,0,15,0,-15
4011,1,1,704,1772,1068
4012,1,1,831,1273,442
4013,1,0,11,0,-11
4014,0,0,101,0,-101
4015,1,1,41,2014,1973
4016,0,0,28,0,-28
4017,0,0,15,0,-15
4018,1,0,120,0,-120
4019,1,0,14,0,-14
4020,1,0,3,0,-3
4021,1,1,224,1299,1075
4022,1,0,30,0,-30
4023,0,0,62,0,-62
4024,0,0,50,0,-50
4025,1,1,94,1251,1157
4026,1,0,11,0,-11
4027,0,0,87,0,-87
4028,0,0,16,0,-16
4029,1,1,319,1474,1155
4030,1,0,3,0,-3
4031,0,0,10,0,-10
4032,0,0,21,0,-21
4033,1,1,545,1209,664
4034,1,0,33,0,-33
4035,1,0,67,0,-67
4036,1,1,343,1704,1361
4037,1,1,249,1760,1511
4038,0,0,41,0,-41
4039,1,1,449,1700,1251
4040,1,1,1992,1290,-702
4041,1,1,281,1812,1531
4042,0,0,64,0,-64
4043,1,1,170,3343,3173
4044,1,0,44,0,-44
4045,0,0,71,0,-71
4046,1,0,29,0,-29
4047,1,1,372,1543,1171
4048,1,0,35,0,-35
4049,0,0,59,0,-59
4050,1,0,23,0,-23
4051,1,1,130,1336,1206
4052,1,1,350,1308,958
4053,1,1,946,1248,302
4054,0,0,5,0,-5
4055,1,0,37,0,-37
4056,1,1,167,1492,1325
4057,0,0,178,0,-178
4058,0,0,41,0,-41
4059,0,0,36,0,-36
4060,1,1,211,1201,990
4061,1,1,711,1819,1108
4062,1,0,5,0,-5
4063,1,0,2,0,-2
4064,1,0,76,0,-76
4065,1,0,46,0,-46
4066,0,0,46,0,-46
4067,0,0,17,0,-17
4068,1,1,310,1884,1574
4069,1,1,931,1458,527
4070,1,1,193,2864,2671
4071,0,0,82,0,-82
4072,0,0,81,0,-81
4073,1,1,3414,1259,-2155
4074,0,0,194,0,-194
4075,0,0,62,0,-62
4076,1,1,364,1243,879
4077,1,1,363,1216,853
4078,1,1,143,1212,1069
4079,1,0,45,0,-45
4080,1,1,42,1592,1550
4081,0,0,113,0,-113
4082,1,0,37,0,-37
4083,1,1,29,1225,1196
4084,1,1,198,1726,1528
4085,0,0,22,0,-22
4086,1,0,21,0,-21
4087,1,1,374,1272,898
4088,1,1,294,1261,967
4089,0,0,146,0,-146
4090,1,0,64,0,-64
4091,1,0,43,0,-43
4092,0,0,44,0,-44
4093,0,0,2,0,-2
4094,1,1,26,1399,1373
4095,0,0,137,0,-137
4096,1,1,864,1585,721
4097,1,0,47,0,-47
4098,1,0,18,0,-18
4099,1,1,925,1258,333
4100,0,0,70,0,-70
4101,1,1,894,1264,370
4102,1,1,744,1656,912
4103,0,0,133,0,-133
4104,0,0,71,0,-71
4105,1,0,56,0,-56
4106,0,0,56,0,-56
4107,1,1,253,1653,1400
4108,0,0,89,0,-89
4109,1,0,38,0,-38
4110,1,1,1173,2160,987
4111,0,0,7,0,-7
4112,1,1,397,1979,1582
4113,1,1,528,1257,729
4114,0,0,196,0,-196
4115,1,0,71,0,-71
4116,1,0,3,0,-3
4117,1,1,212,1252,1040
4118,1,1,872,1231,359
4119,1,0,81,0,-81
4120,1,1,258,1292,1034
4121,1,0,95,0,-95
4122,0,0,20,0,-20
4123,0,0,42,0,-42
4124,1,1,1332,2954,1622
4125,1,1,113,2854,2741
4126,1,1,632,1212,580
4127,0,0,13,0,-13
4128,0,0,72,0,-72
4129,1,1,1120,1488,368
4130,1,1,241,1947,1706
4131,1,0,17,0,-17
4132,1,0,8,0,-8
4133,1,1,129,1437,1308
4134,1,1,998,1640,642
4135,0,0,167,0,-167
4136,1,1,654,1230,576
4137,1,0,8,0,-8
4138,1,1,118,1492,1374
4139,1,1,613,1497,884
4140,1,0,62,0,-62
4141,0,0,23,0,-23
4142,0,0,4,0,-4
4143,1,0,0,0,0
4144,0,0,61,0,-61
4145,1,0,67,0,-67
4146,1,0,56,0,-56
4147,0,0,9,0,-9
4148,1,1,1103,1543,440
4149,1,0,30,0,-30
4150,1,1,834,1215,381
4151,1,1,932,2123,1191
4152,1,1,598,1424,826
4153,0,0,71,0,-71
4154,1,0,39,0,-39
4155,1,1,489,1650,1161
4156,1,1,192,1544,1352
4157,1,1,190,1934,1744
4158,0,0,8,0,-8
4159,1,1,351,1202,851
4160,1,1,112,1299,1187
4161,1,1,615,1202,587
4162,1,0,5,0,-5
4163,1,0,27,0,-27
4164,1,0,22,0,-22
4165,1,1,438,1276,838
4166,1,1,628,1630,1002
4167,1,1,192,1357,1165
4168,1,0,90,0,-90
4169,1,0,49,0,-49
4170,1,1,21,1344,1323
4171,1,0,57,0,-57
4172,1,1,322,1668,1346
4173,1,1,327,2151,1824
4174,0,0,23,0,-23
4175,1,0,78,0,-78
4176,0,0,1,0,-1
4177,1,0,43,0,-43
4178,1,0,19,0,-19
4179,1,1,1243,1230,-13
4180,1,0,21,0,-21
4181,0,0,60,0,-60
4182,1,0,79,0,-79
4183,0,0,212,0,-212
4184,0,0,10,0,-10
4185,0,0,10,0,-10
4186,1,1,1075,1574,499
4187,1,1,778,1752,974
4188,0,0,22,0,-22
4189,0,0,19,0,-19
4190,1,1,430,1316,886
4191,0,0,136,0,-136
4192,1,1,563,1207,644
4193,1,1,326,1658,1332
4194,1,0,68,0,-68
4195,1,1,176,1487,1311
4196,1,0,42,0,-42
4197,1,0,108,0,-108
4198,1,0,27,0,-27
4199,1,0,132,0,-132
4200,1,0,380,0,-380
4201,0,0,279,0,-279
4202,0,0,20,0,-20
4203,0,0,130,0,-130
4204,0,0,86,0,-86
4205,0,0,5,0,-5
4206,1,0,89,0,-89
4207,1,1,716,1299,583
4208,1,0,62,0,-62
4209,1,1,237,1643,1406
4210,0,0,2,0,-2
4211,1,1,1360,1338,-22
4212,1,1,388,1401,1013
4213,1,0,47,0,-47
4214,1,1,911,1208,297
4215,1,0,32,0,-32
4216,1,0,4,0,-4
4217,0,0,193,0,-193
4218,0,0,4,0,-4
4219,0,0,1,0,-1
4220,0,0,61,0,-61
4221,0,0,44,0,-44
4222,1,1,386,1429,1043
4223,0,0,64,0,-64
4224,1,0,57,0,-57
4225,1,1,788,1413,625
4226,1,0,36,0,-36
4227,1,1,153,1527,1374
4228,1,0,37,0,-37
4229,1,1,173,1827,1654
4230,1,0,103,0,-103
4231,1,0,18,0,-18
4232,0,0,29,0,-29
4233,1,1,254,1641,1387
4234,1,0,116,0,-116
4235,1,0,61,0,-61
4236,1,0,9,0,-9
4237,0,0,1,0,-1
4238,1,0,58,0,-58
4239,1,0,10,0,-10
4240,0,0,23,0,-23
4241,1,0,74,0,-74
4242,0,0,137,0,-137
4243,0,0,115,0,-115
4244,0,0,46,0,-46
4245,1,0,70,0,-70
4246,0,0,130,0,-130
4247,1,0,9,0,-9
4248,1,1,543,1426,883
4249,0,0,28,0,-28
4250,1,0,12,0,-12
4251,1,1,304,1272,968
4252,1,1,1139,2155,1016
4253,1,0,32,0,-32
4254,0,0,117,0,-117
4255,1,0,62,0,-62
4256,1,0,10,0,-10
4257,0,0,16,0,-16
4258,0,0,5,0,-5
4259,0,0,42,0,-42
4260,1,1,242,1443,1201
4261,1,1,308,1710,1402
4262,0,0,16,0,-16
4263,1,1,223,1546,1323
4264,1,0,32,0,-32
4265,1,0,51,0,-51
4266,0,0,28,0,-28
4267,1,0,52,0,-52
4268,0,0,84,0,-84
4269,1,1,378,1207,829
4270,1,1,334,1546,1212
4271,0,0,246,0,-246
4272,1,1,246,1310,1064
4273,1,1,449,1325,876
4274,0,0,32,0,-32
4275,1,0,50,0,-50
4276,0,0,51,0,-51
4277,1,0,13,0,-13
4278,1,0,5,0,-5
4279,1,0,45,0,-45
4280,0,0,0,0,0
4281,1,0,141,0,-141
4282,1,0,26,0,-26
4283,0,0,28,0,-28
4284,1,0,31,0,-31
4285,1,1,133,2177,2044
4286,1,1,662,2049,1387
4287,0,0,57,0,-57
4288,0,0,131,0,-131
4289,1,0,8,0,-8
4290,0,0,84,0,-84
4291,1,1,393,1302,909
4292,0,0,28,0,-28
4293,0,0,30,0,-30
4294,1,1,57,1291,1234
4295,1,1,973,1998,1025
4296,0,0,83,0,-83
4297,1,1,1311,1420,109
4298,1,1,333,1613,1280
4299,0,0,25,0,-25
4300,0,0,106,0,-106
4301,1,0,5,0,-5
4302,0,0,22,0,-22
4303,0,0,29,0,-29
4304,1,1,294,1309,1015
4305,0,0,35,0,-35
4306,1,0,10,0,-10
4307,1,1,344,1227,883
4308,1,0,25,0,-25
4309,0,0,16,0,-16
4310,0,0,104,0,-104
4311,1,1,753,1724,971
4312,1,1,1309,2301,992
4313,1,1,92,1742,1650
4314,1,0,4,0,-4
4315,0,0,11,0,-11
4316,1,1,244,1766,1522
4317,1,0,2,0,-2
4318,1,1,407,1538,1131
4319,1,0,6,0,-6
4320,1,1,734,1615,881
4321,0,0,45,0,-45
4322,0,0,35,0,-35
4323,1,1,475,3844,3369
4324,0,0,12,0,-12
4325,1,1,1047,1222,175
4326,1,0,32,0,-32
4327,1,1,1645,1791,146
4328,0,0,83,0,-83
4329,1,1,352,2100,1748
4330,1,1,325,1237,912
4331,0,0,108,0,-108
4332,1,1,36,1245,1209
4333,1,1,4180,1582,-2598
4334,1,0,40,0,-40
4335,1,1,184,1398,1214
4336,0,0,82,0,-82
4337,1,0,142,0,-142
4338,1,1,565,1373,808
4339,1,1,484,2291,1807
4340,1,0,51,0,-51
4341,1,0,10,0,-10
4342,1,0,25,0,-25
4343,1,1,409,1795,1386
4344,1,1,280,1377,1097
4345,0,0,6,0,-6
4346,0,0,15,0,-15
4347,1,1,276,1974,1698
4348,1,1,149,1737,1588
4349,0,0,20,0,-20
4350,1,0,89,0,-89
4351,1,0,11,0,-11
4352,1,1,251,2582,2331
4353,1,0,54,0,-54
4354,0,0,36,0,-36
4355,1,0,40,0,-40
4356,1,0,65,0,-65
4357,0,0,4,0,-4
4358,1,0,2,0,-2
4359,1,0,24,0,-24
4360,1,1,555,1279,724
4361,1,1,390,1243,853
4362,1,0,14,0,-14
4363,1,1,646,1354,708
4364,1,0,0,0,0
4365,0,0,8,0,-8
4366,0,0,5,0,-5
4367,0,0,57,0,-57
4368,1,1,197,1951,1754
4369,1,0,45,0,-45
4370,1,0,13,0,-13
4371,1,1,190,1215,1025
4372,1,0,68,0,-68
4373,1,1,435,1919,1484
4374,0,0,57,0,-57
4375,1,0,23,0,-23
4376,1,0,62,0,-62
4377,0,0,127,0,-127
4378,1,1,1306,1461,155
4379,1,0,35,0,-35
4380,1,1,526,1375,849
4381,0,0,54,0,-54
4382,1,1,355,1257,902
4383,0,0,113,0,-113
4384,0,0,0,0,0
4385,0,0,54,0,-54
4386,1,0,7,0,-7
4387,1,0,23,0,-23
4388,0,0,33,0,-33
4389,1,0,5,0,-5
4390,0,0,82,0,-82
4391,1,0,32,0,-32
4392,1,1,266,1862,1596
4393,1,0,11,0,-11
4394,1,1,590,1582,992
4395,0,0,29,0,-29
4396,1,0,1,0,-1
4397,1,0,18,0,-18
4398,1,0,46,0,-46
4399,1,0,30,0,-30
4400,1,0,31,0,-31
4401,0,0,28,0,-28
4402,1,0,155,0,-155
4403,1,0,22,0,-22
4404,1,1,943,1464,521
4405,0,0,101,0,-101
4406,0,0,5,0,-5
4407,1,0,6,0,-6
4408,1,1,57,1330,1273
4409,1,0,139,0,-139
4410,0,0,1,0,-1
4411,1,0,39,0,-39
4412,1,1,899,1218,319
4413,1,0,98,0,-98
4414,1,1,143,1362,1219
4415,0,0,117,0,-117
4416,0,0,44,0,-44
4417,0,0,10,0,-10
4418,0,0,2,0,-2
4419,1,0,56,0,-56
4420,0,0,31,0,-31
4421,1,1,143,1375,1232
4422,1,0,100,0,-100
4423,1,1,193,1205,1012
4424,0,0,153,0,-153
4425,1,1,139,1245,1106
4426,1,0,62,0,-62
4427,1,0,4,0,-4
4428,0,0,8,0,-8
4429,1,0,19,0,-19
4430,0,0,39,0,-39
4431,1,1,293,2081,1788
4432,0,0,5,0,-5
4433,0,0,28,0,-28
4434,1,1,1293,1253,-40
4435,1,0,24,0,-24
4436,1,1,1076,1283,207
4437,1,0,11,0,-11
4438,1,0,86,0,-86
4439,1,1,410,1417,1007
4440,1,1,119,1319,1200
4441,1,1,63,1353,1290
4442,1,0,2,0,-2
4443,0,0,20,0,-20
4444,1,1,177,1285,1108
4445,0,0,14,0,-14
4446,0,0,0,0,0
4447,0,0,2,0,-2
4448,1,1,380,2478,2098
4449,0,0,3,0,-3
4450,1,0,54,0,-54
4451,1,1,861,1441,580
4452,1,0,27,0,-27
4453,0,0,33,0,-33
4454,0,0,28,0,-28
4455,1,0,5,0,-5
4456,1,1,105,1225,1120
4457,0,0,8,0,-8
4458,0,0,74,0,-74
4459,1,0,243,0,-243
4460,1,0,75,0,-75
4461,0,0,4,0,-4
4462,1,0,40,0,-40
4463,1,0,47,0,-47
4464,1,1,498,1288,790
4465,0,0,69,0,-69
4466,1,0,17,0,-17
4467,0,0,16,0,-16
4468,0,0,24,0,-24
4469,1,1,764,1249,485
4470,1,1,119,2739,2620
4471,0,0,4,0,-4
4472,1,1,611,1328,717
4473,1,0,50,0,-50
4474,1,0,16,0,-16
4475,1,0,2,0,-2
4476,0,0,85,0,-85
4477,1,0,76,0,-76
4478,1,1,126,1210,1084
4479,0,0,7,0,-7
4480,0,0,13,0,-13
4481,0,0,6,0,-6
4482,0,0,47,0,-47
4483,1,0,180,0,-180
4484,1,0,62,0,-62
4485,1,1,887,1340,453
4486,0,0,32,0,-32
4487,1,1,277,1289,1012
4488,1,0,48,0,-48
4489,1,1,1243,1277,34
4490,1,0,36,0,-36
4491,1,0,22,0,-22
4492,0,0,11,0,-11
4493,0,0,50,0,-50
4494,0,0,33,0,-33
4495,1,0,23,0,-23
4496,0,0,31,0,-31
4497,0,0,35,0,-35
4498,0,0,29,0,-29
4499,1,1,86,1216,1130
4500,0,0,71,0,-71
4501,1,1,537,1319,782
4502,0,0,140,0,-140
4503,1,0,9,0,-9
4504,1,0,29,0,-29
4505,0,0,18,0,-18
4506,0,0,12,0,-12
4507,1,0,42,0,-42
4508,1,0,84,0,-84
4509,1,1,1093,1295,202
4510,1,0,12,0,-12
4511,0,0,18,0,-18
4512,0,0,12,0,-12
4513,0,0,130,0,-130
4514,1,0,269,0,-269
4515,1,1,920,2255,1335
4516,1,1,1496,1276,-220
4517,0,0,26,0,-26
4518,1,0,84,0,-84
4519,1,0,10,0,-10
4520,0,0,35,0,-35
4521,0,0,13,0,-13
4522,0,0,24,0,-24
4523,1,0,3,0,-3
4524,1,0,57,0,-57
4525,1,0,61,0,-61
4526,1,1,376,3498,3122
4527,1,1,390,1375,985
4528,1,0,41,0,-41
4529,0,0,58,0,-58
4530,1,1,1460,2162,702
4531,0,0,23,0,-23
4532,0,0,53,0,-53
4533,0,0,43,0,-43
4534,0,0,7,0,-7
4535,0,0,0,0,0
4536,1,0,45,0,-45
4537,0,0,33,0,-33
4538,1,1,167,1265,1098
4539,0,0,6,0,-6
4540,0,0,21,0,-21
4541,1,0,30,0,-30
4542,1,0,1,0,-1
4543,1,1,440,1274,834
4544,1,0,17,0,-17
4545,1,1,25,1658,1633
4546,0,0,104,0,-104
4547,1,0,224,0,-224
4548,1,1,664,1452,788
4549,0,0,22,0,-22
4550,0,0,6,0,-6
4551,1,1,228,1803,1575
4552,0,0,62,0,-62
4553,1,1,27,1291,1264
4554,1,1,55,1240,1185
4555,1,0,92,0,-92
4556,1,0,200,0,-200
4557,1,0,80,0,-80
4558,0,0,136,0,-136
4559,1,1,1809,1469,-340
4560,0,0,52,0,-52
4561,1,1,43,2232,2189
4562,0,0,26,0,-26
4563,1,1,377,1596,1219
4564,1,1,210,2575,2365
4565,1,0,43,0,-43
4566,1,1,129,1201,1072
4567,1,1,584,1334,750
4568,1,1,58,1334,1276
4569,1,0,59,0,-59
4570,1,0,67,0,-67
4571,1,0,27,0,-27
4572,1,1,260,1328,1068
4573,1,1,67,1270,1203
4574,1,1,157,1273,1116
4575,0,0,39,0,-39
4576,1,0,22,0,-22
4577,1,0,10,0,-10
4578,0,0,30,0,-30
4579,1,0,4,0,-4
4580,1,1,278,1236,958
4581,1,1,21,1967,1946
4582,0,0,23,0,-23
4583,0,0,17,0,-17
4584,0,0,2,0,-2
4585,0,0,5,0,-5
4586,1,0,61,0,-61
4587,0,0,15,0,-15
4588,1,1,288,1687,1399
4589,1,0,20,0,-20
4590,0,0,10,0,-10
4591,0,0,2,0,-2
4592,0,0,8,0,-8
4593,1,1,502,4855,4353
4594,1,0,6,0,-6
4595,1,0,164,0,-164
4596,1,0,57,0,-57
4597,1,1,1179,1585,406
4598,0,0,31,0,-31
4599,0,0,3,0,-3
4600,1,1,101,1716,1615
4601,1,0,30,0,-30
4602,1,1,663,1867,1204
4603,1,0,40,0,-40
4604,0,0,131,0,-131
4605,0,0,100,0,-100
4606,0,0,91,0,-91
4607,0,0,8,0,-8
4608,1,1,601,3284,2683
4609,0,0,18,0,-18
4610,1,0,2,0,-2
4611,1,1,356,1236,880
4612,0,0,43,0,-43
4613,1,1,97,1451,1354
4614,0,0,102,0,-102
4615,0,0,1,0,-1
4616,0,0,36,0,-36
4617,0,0,34,0,-34
4618,1,1,22,1842,1820
4619,0,0,85,0,-85
4620,0,0,5,0,-5
4621,1,1,2303,1326,-977
4622,1,1,754,1260,506
4623,0,0,15,0,-15
4624,0,0,26,0,-26
4625,1,0,6,0,-6
4626,0,0,34,0,-34
4627,0,0,78,0,-78
4628,0,0,24,0,-24
4629,0,0,14,0,-14
4630,0,0,35,0,-35
4631,0,0,95,0,-95
4632,0,0,22,0,-22
4633,1,1,518,1245,727
4634,0,0,23,0,-23
4635,1,1,537,1571,1034
4636,1,0,55,0,-55
4637,1,1,600,1200,600
4638,1,0,85,0,-85
4639,0,0,209,0,-209
4640,0,0,192,0,-192
4641,0,0,22,0,-22
4642,0,0,23,0,-23
4643,1,0,34,0,-34
4644,1,1,205,1233,1028
4645,1,0,144,0,-144
4646,1,0,23,0,-23
4647,1,0,30,0,-30
4648,1,1,115,1497,1382
4649,1,0,14,0,-14
4650,0,0,8,0,-8
4651,1,1,79,1226,1147
4652,0,0,60,0,-60
4653,0,0,149,0,-149
4654,1,1,594,1209,615
4655,0,0,11,0,-11
4656,1,1,520,1259,739
4657,1,1,1451,1522,71
4658,1,1,1548,1201,-347
4659,0,0,1,0,-1
4660,1,1,812,1274,462
4661,1,1,629,1353,724
4662,1,1,255,2846,2591
4663,0,0,145,0,-145
4664,0,0,15,0,-15
4665,1,1,585,1299,714
4666,1,1,254,1371,1117
4667,0,0,13,0,-13
4668,0,0,11,0,-11
4669,0,0,112,0,-112
4670,0,0,49,0,-49
4671,1,0,148,0,-148
4672,1,1,303,2958,2655
4673,1,1,147,1635,1488
4674,0,0,42,0,-42
4675,1,1,51,1212,1161
4676,1,1,132,1401,1269
4677,1,0,103,0,-103
4678,0,0,15,0,-15
4679,1,1,192,1522,1330
4680,0,0,73,0,-73
4681,1,1,161,1257,1096
4682,1,1,734,1291,557
4683,1,0,40,0,-40
4684,1,0,153,0,-153
4685,0,0,145,0,-145
4686,1,0,10,0,-10
4687,0,0,25,0,-25
4688,1,1,588,1432,844
4689,1,1,1001,2414,1413
4690,1,1,840,1421,581
4691,1,1,551,3428,2877
4692,0,0,15,0,-15
4693,0,0,55,0,-55
4694,0,0,34,0,-34
4695,0,0,42,0,-42
4696,0,0,11,0,-11
4697,0,0,9,0,-9
4698,1,0,67,0,-67
4699,1,1,644,1377,733
4700,0,0,65,0,-65
4701,1,1,177,1214,1037
4702,1,0,6,0,-6
4703,0,0,0,0,0
4704,0,0,15,0,-15
4705,0,0,108,0,-108
4706,1,0,272,0,-272
4707,1,1,257,1335,1078
4708,1,1,490,1822,1332
4709,1,0,3,0,-3
4710,1,1,259,1862,1603
4711,0,0,14,0,-14
4712,0,0,18,0,-18
4713,0,0,62,0,-62
4714,1,1,706,1818,1112
4715,0,0,129,0,-129
4716,0,0,56,0,-56
4717,1,1,309,2227,1918
4718,1,1,38,1831,1793
4719,1,0,30,0,-30
4720,1,1,359,1763,1404
4721,1,1,809,1878,1069
4722,1,1,703,1418,715
4723,1,1,551,1240,689
4724,1,1,676,1209,533
4725,0,0,21,0,-21
4726,1,1,102,1543,1441
4727,0,0,63,0,-63
4728,1,0,11,0,-11
4729,1,1,679,1364,685
4730,0,0,48,0,-48
4731,1,0,54,0,-54
4732,0,0,102,0,-102
4733,1,0,81,0,-81
4734,0,0,18,0,-18
4735,0,0,6,0,-6
4736,1,0,1,0,-1
4737,1,1,346,1447,1101
4738,0,0,136,0,-136
4739,0,0,75,0,-75
4740,1,1,348,8162,7814
4741,1,0,12,0,-12
4742,1,1,386,1221,835
4743,1,0,65,0,-65
4744,1,1,187,1739,1552
4745,1,0,78,0,-78
4746,1,0,7,0,-7
4747,0,0,3,0,-3
4748,1,0,98,0,-98
4749,1,0,6,0,-6
4750,0,0,24,0,-24
4751,0,0,61,0,-61
4752,0,0,54,0,-54
4753,0,0,38,0,-38
4754,1,0,26,0,-26
4755,0,0,5,0,-5
4756,0,0,79,0,-79
4757,0,0,14,0,-14
4758,0,0,3,0,-3
4759,1,1,241,1307,1066
4760,1,1,526,1629,1103
4761,0,0,68,0,-68
4762,1,0,17,0,-17
4763,1,0,51,0,-51
4764,1,0,16,0,-16
4765,1,1,1794,1206,-588
4766,0,0,107,0,-107
4767,0,0,72,0,-72
4768,0,0,19,0,-19
4769,1,1,682,1359,677
4770,0,0,83,0,-83
4771,1,0,0,0,0
4772,0,0,3,0,-3
4773,1,0,102,0,-102
4774,1,1,720,1447,727
4775,1,1,499,1532,1033
4776,1,0,67,0,-67
4777,1,0,31,0,-31
4778,1,0,48,0,-48
4779,1,0,30,0,-30
4780,0,0,26,0,-26
4781,0,0,13,0,-13
4782,1,0,3,0,-3
4783,1,0,196,0,-196
4784,1,0,5,0,-5
4785,0,0,44,0,-44
4786,0,0,77,0,-77
4787,1,0,31,0,-31
4788,0,0,179,0,-179
4789,1,0,14,0,-14
4790,0,0,10,0,-10
4791,1,1,649,1508,859
4792,1,1,1577,1250,-327
4793,0,0,15,0,-15
4794,1,1,200,1201,1001
4795,1,0,18,0,-18
4796,1,0,27,0,-27
4797,0,0,160,0,-160
4798,1,0,4,0,-4
4799,1,0,26,0,-26
4800,1,0,18,0,-18
4801,1,0,2,0,-2
4802,1,0,20,0,-20
4803,1,0,148,0,-148
4804,1,0,116,0,-116
4805,0,0,36,0,-36
4806,1,0,10,0,-10
4807,1,0,86,0,-86
4808,0,0,55,0,-55
4809,0,0,6,0,-6
4810,1,0,54,0,-54
4811,1,1,239,1324,1085
4812,0,0,2,0,-2
4813,0,0,61,0,-61
4814,1,0,62,0,-62
4815,1,0,85,0,-85
4816,1,0,22,0,-22
4817,0,0,28,0,-28
4818,1,0,54,0,-54
4819,0,0,103,0,-103
4820,0,0,82,0,-82
4821,1,0,38,0,-38
4822,1,1,174,1331,1157
4823,1,1,676,1349,673
4824,1,0,171,0,-171
4825,1,1,680,1283,603
4826,0,0,61,0,-61
4827,0,0,46,0,-46
4828,1,0,25,0,-25
4829,0,0,57,0,-57
4830,1,1,1756,2220,464
4831,1,1,135,1434,1299
4832,0,0,9,0,-9
4833,0,0,33,0,-33
4834,1,0,24,0,-24
4835,1,1,468,2044,1576
4836,0,0,24,0,-24
4837,1,1,188,1805,1617
4838,0,0,82,0,-82
4839,1,1,517,1393,876
4840,1,1,429,1731,1302
4841,1,1,610,1301,691
4842,1,1,295,1366,1071
4843,1,1,281,1443,1162
4844,1,1,217,1441,1224
4845,1,0,6,0,-6
4846,1,0,139,0,-139
4847,1,1,209,1351,1142
4848,0,0,51,0,-51
4849,1,1,1256,1448,192
4850,1,0,122,0,-122
4851,0,0,1,0,-1
4852,1,1,66,1871,1805
4853,0,0,24,0,-24
4854,1,1,750,1314,564
4855,1,0,17,0,-17
4856,1,1,177,1664,1487
4857,1,1,164,1495,1331
4858,1,0,12,0,-12
4859,1,0,23,0,-23
4860,1,1,262,1488,1226
4861,1,0,36,0,-36
4862,1,1,253,1287,1034
4863,0,0,95,0,-95
4864,0,0,62,0,-62
4865,0,0,0,0,0
4866,0,0,48,0,-48
4867,0,0,10,0,-10
4868,1,1,1127,1359,232
4869,1,0,16,0,-16
4870,1,0,25,0,-25
4871,0,0,20,0,-20
4872,0,0,19,0,-19
4873,1,1,317,1416,1099
4874,0,0,8,0,-8
4875,0,0,29,0,-29
4876,0,0,111,0,-111
4877,1,0,17,0,-17
4878,1,1,913,1212,299
4879,1,1,128,1223,1095
4880,1,0,9,0,-9
4881,0,0,41,0,-41
4882,1,1,755,1218,463
4883,1,0,50,0,-50
4884,1,0,76,0,-76
4885,1,1,379,3235,2856
4886,1,1,494,1266,772
4887,1,0,19,0,-19
4888,1,0,57,0,-57
4889,1,1,574,1482,908
4890,1,1,405,1205,800
4891,0,0,33,0,-33
4892,0,0,35,0,-35
4893,0,0,129,0,-129
4894,1,0,84,0,-84
4895,1,1,538,1293,755
4896,1,0,21,0,-21
4897,0,0,104,0,-104
4898,1,1,744,1316,572
4899,0,0,32,0,-32
4900,1,0,13,0,-13
4901,1,0,41,0,-41
4902,0,0,164,0,-164
4903,0,0,10,0,-10
4904,1,1,248,2313,2065
4905,0,0,106,0,-106
4906,0,0,106,0,-106
4907,1,0,14,0,-14
4908,1,0,36,0,-36
4909,1,0,21,0,-21
4910,1,1,1349,1303,-46
4911,1,0,12,0,-12
4912,1,0,102,0,-102
4913,1,0,4,0,-4
4914,0,0,95,0,-95
4915,0,0,52,0,-52
4916,1,1,433,1543,1110
4917,1,0,27,0,-27
4918,0,0,2,0,-2
4919,0,0,2,0,-2
4920,1,0,1,0,-1
4921,0,0,36,0,-36
4922,1,1,208,1398,1190
4923,0,0,56,0,-56
4924,1,0,57,0,-57
4925,1,0,56,0,-56
4926,1,1,223,1462,1239
4927,1,0,18,0,-18
4928,0,0,60,0,-60
4929,1,0,34,0,-34
4930,1,0,41,0,-41
4931,1,0,1,0,-1
4932,0,0,2,0,-2
4933,0,0,5,0,-5
4934,1,1,606,2456,1850
4935,0,0,34,0,-34
4936,1,0,64,0,-64
4937,1,1,160,1484,1324
4938,0,0,144,0,-144
4939,0,0,24,0,-24
4940,0,0,2,0,-2
4941,1,0,47,0,-47
4942,1,1,345,1239,894
4943,0,0,18,0,-18
4944,0,0,85,0,-85
4945,1,0,19,0,-19
4946,0,0,58,0,-58
4947,1,0,33,0,-33
4948,0,0,7,0,-7
4949,1,1,395,1284,889
4950,0,0,1,0,-1
4951,1,1,706,2510,1804
4952,1,1,774,1738,964
4953,0,0,61,0,-61
4954,1,0,28,0,-28
4955,0,0,8,0,-8
4956,1,1,596,1712,1116
4957,1,0,17,0,-17
4958,1,1,340,2446,2106
4959,0,0,65,0,-65
4960,0,0,174,0,-174
4961,1,1,534,1298,764
4962,0,0,47,0,-47
4963,1,1,569,1820,1251
4964,0,0,45,0,-45
4965,0,0,21,0,-21
4966,0,0,139,0,-139
4967,1,0,25,0,-25
4968,0,0,47,0,-47
4969,0,0,15,0,-15
4970,1,1,82,1432,1350
4971,1,1,455,1955,1500
4972,1,1,137,1482,1345
4973,0,0,27,0,-27
4974,1,1,367,1254,887
4975,1,1,940,1448,508
4976,1,1,658,2795,2137
4977,1,0,8,0,-8
4978,1,0,50,0,-50
4979,0,0,16,0,-16
4980,0,0,45,0,-45
4981,1,1,609,1814,1205
4982,0,0,39,0,-39
4983,1,0,18,0,-18
4984,0,0,45,0,-45
4985,1,0,44,0,-44
4986,0,0,3,0,-3
4987,1,1,358,1799,1441
4988,1,1,868,1238,370
4989,0,0,5,0,-5
4990,0,0,29,0,-29
4991,0,0,17,0,-17
4992,1,1,2389,2279,-110
4993,0,0,9,0,-9
4994,0,0,54,0,-54
4995,1,1,1106,1316,210
4996,0,0,29,0,-29
4997,1,0,85,0,-85
4998,0,0,13,0,-13
4999,0,0,23,0,-23
5000,1,1,534,1223,689
5001,1,0,18,0,-18
5002,1,0,9,0,-9
5003,1,1,1768,2095,327
5004,1,0,32,0,-32
5005,0,0,10,0,-10
5006,1,0,63,0,-63
5007,1,0,17,0,-17
5008,1,1,926,1912,986
5009,0,0,91,0,-91
5010,0,0,59,0,-59
5011,0,0,21,0,-21
5012,0,0,81,0,-81
5013,1,0,40,0,-40
5014,1,0,41,0,-41
5015,0,0,86,0,-86
5016,1,0,42,0,-42
5017,0,0,258,0,-258
5018,1,0,6,0,-6
5019,1,0,36,0,-36
5020,1,1,304,1550,1246
5021,0,0,4,0,-4
5022,1,1,144,1333,1189
5023,0,0,17,0,-17
5024,1,1,794,2166,1372
5025,1,1,463,1758,1295
5026,0,0,74,0,-74
5027,1,0,15,0,-15
5028,0,0,44,0,-44
5029,1,0,101,0,-101
5030,1,1,564,1239,675
5031,1,1,545,1529,984
5032,1,0,26,0,-26
5033,0,0,5,0,-5
5034,0,0,114,0,-114
5035,0,0,56,0,-56
5036,1,1,2154,1338,-816
5037,1,1,275,2514,2239
5038,0,0,12,0,-12
5039,1,1,86,1233,1147
5040,1,0,121,0,-121
5041,1,0,9,0,-9
5042,1,1,1791,1321,-470
5043,0,0,148,0,-148
5044,0,0,143,0,-143
5045,1,1,259,1221,962
5046,1,0,35,0,-35
5047,0,0,116,0,-116
5048,0,0,37,0,-37
5049,1,1,1236,1262,26
5050,0,0,76,0,-76
5051,1,0,105,0,-105
5052,0,0,103,0,-103
5053,0,0,101,0,-101
5054,1,1,56,1545,1489
5055,1,1,398,2598,2200
5056,1,0,141,0,-141
5057,1,0,36,0,-36
5058,1,0,10,0,-10
5059,1,0,4,0,-4
5060,1,0,81,0,-81
5061,1,1,335,1926,1591
5062,1,1,427,1437,1010
5063,0,0,10,0,-10
5064,0,0,0,0,0
5065,0,0,112,0,-112
5066,1,0,125,0,-125
5067,1,1,201,1270,1069
5068,1,1,263,1232,969
5069,0,0,9,0,-9
5070,0,0,34,0,-34
5071,0,0,29,0,-29
5072,1,1,1369,1646,277
5073,0,0,35,0,-35
5074,1,1,279,1981,1702
5075,0,0,51,0,-51
5076,0,0,22,0,-22
5077,0,0,12,0,-12
5078,1,1,141,1269,1128
5079,0,0,42,0,-42
5080,0,0,40,0,-40
5081,0,0,60,0,-60
5082,1,1,958,1200,242
5083,0,0,36,0,-36
5084,1,0,7,0,-7
5085,1,0,6,0,-6
5086,1,1,1653,1287,-366
5087,0,0,70,0,-70
5088,1,1,1077,1214,137
5089,0,0,119,0,-119
5090,0,0,82,0,-82
5091,1,0,39,0,-39
5092,1,0,94,0,-94
5093,1,0,112,0,-112
5094,0,0,291,0,-291
5095,1,0,64,0,-64
5096,1,1,280,1381,1101
5097,0,0,149,0,-149
5098,0,0,140,0,-140
5099,1,0,36,0,-36
5100,1,0,25,0,-25
5101,1,1,210,1300,1090
5102,0,0,124,0,-124
5103,1,1,780,1245,465
5104,0,0,6,0,-6
5105,1,0,31,0,-31
5106,0,0,73,0,-73
5107,0,0,30,0,-30
5108,1,0,68,0,-68
5109,0,0,32,0,-32
5110,0,0,1,0,-1
5111,1,1,179,1370,1191
5112,0,0,109,0,-109
5113,1,1,444,2709,2265
5114,1,0,78,0,-78
5115,1,1,492,1202,710
5116,0,0,33,0,-33
5117,1,1,322,1229,907
5118,0,0,37,0,-37
5119,0,0,131,0,-131
5120,0,0,17,0,-17
5121,0,0,1,0,-1
5122,1,1,904,1332,428
5123,1,1,826,1604,778
5124,0,0,78,0,-78
5125,1,1,238,1931,1693
5126,1,1,164,1375,1211
5127,1,0,15,0,-15
5128,1,1,1403,1402,-1
5129,1,1,654,1210,556
5130,0,0,28,0,-28
5131,1,1,198,1884,1686
5132,0,0,27,0,-27
5133,1,1,642,1463,821
5134,0,0,114,0,-114
5135,0,0,177,0,-177
5136,1,1,196,1271,1075
5137,0,0,31,0,-31
5138,1,1,64,1382,1318
5139,1,0,31,0,-31
5140,0,0,30,0,-30
5141,0,0,66,0,-66
5142,1,0,15,0,-15
5143,0,0,174,0,-174
5144,1,1,750,1870,1120
5145,0,0,47,0,-47
5146,1,0,23,0,-23
5147,1,1,106,2015,1909
5148,0,0,15,0,-15
5149,1,1,119,1231,1112
5150,1,0,42,0,-42
5151,0,0,27,0,-27
5152,0,0,101,0,-101
5153,0,0,41,0,-41
5154,0,0,30,0,-30
5155,1,0,2,0,-2
5156,1,1,760,1303,543
5157,1,0,48,0,-48
5158,1,0,16,0,-16
5159,1,1,141,1240,1099
5160,1,0,132,0,-132
5161,0,0,48,0,-48
5162,1,1,243,1345,1102
5163,0,0,55,0,-55
5164,0,0,18,0,-18
5165,1,0,67,0,-67
5166,1,1,326,1222,896
5167,1,1,58,1327,1269
5168,1,0,64,0,-64
5169,1,0,60,0,-60
5170,1,1,356,1978,1622
5171,1,0,63,0,-63
5172,0,0,28,0,-28
5173,1,1,868,2805,1937
5174,0,0,9,0,-9
5175,1,1,511,1303,792
5176,1,1,475,1503,1028
5177,0,0,24,0,-24
5178,1,0,54,0,-54
5179,1,0,224,0,-224
5180,0,0,11,0,-11
5181,0,0,12,0,-12
5182,1,1,132,2402,2270
5183,0,0,12,0,-12
5184,0,0,2,0,-2
5185,1,0,30,0,-30
5186,1,0,40,0,-40
5187,1,1,264,1401,1137
5188,1,1,203,1304,1101
5189,0,0,32,0,-32
5190,0,0,2,0,-2
5191,1,1,463,2257,1794
5192,1,0,101,0,-101
5193,1,0,55,0,-55
5194,1,0,56,0,-56
5195,0,0,43,0,-43
5196,1,1,414,1414,1000
5197,1,0,1,0,-1
5198,0,0,11,0,-11
5199,0,0,70,0,-70
5200,1,1,64,1448,1384
5201,0,0,10,0,-10
5202,0,0,3,0,-3
5203,0,0,19,0,-19
5204,0,0,11,0,-11
5205,1,0,37,0,-37
5206,1,0,145,0,-145
5207,1,1,638,1346,708
5208,1,0,127,0,-127
5209,1,0,24,0,-24
5210,0,0,18,0,-18
5211,0,0,86,0,-86
5212,1,0,100,0,-100
5213,1,1,604,2079,1475
5214,0,0,20,0,-20
5215,1,1,420,1952,1532
5216,0,0,8,0,-8
5217,1,0,85,0,-85
5218,1,0,28,0,-28
5219,1,1,1218,1383,165
5220,1,0,32,0,-32
5221,0,0,107,0,-107
5222,0,0,175,0,-175
5223,1,0,22,0,-22
5224,0,0,102,0,-102
5225,1,0,103,0,-103
5226,0,0,43,0,-43
5227,1,0,18,0,-18
5228,0,0,1,0,-1
5229,1,1,430,1339,909
5230,1,1,173,1292,1119
5231,0,0,8,0,-8
5232,0,0,5,0,-5
5233,0,0,39,0,-39
5234,1,1,440,1224,784
5235,1,0,60,0,-60
5236,1,1,596,1290,694
5237,1,0,57,0,-57
5238,0,0,113,0,-113
5239,1,0,14,0,-14
5240,0,0,85,0,-85
5241,1,0,119,0,-119
5242,1,0,11,0,-11
5243,0,0,54,0,-54
5244,1,1,208,1277,1069
5245,1,0,15,0,-15
5246,0,0,34,0,-34
5247,0,0,46,0,-46
5248,1,0,83,0,-83
5249,1,1,731,1777,1046
5250,1,1,293,1722,1429
5251,1,1,1753,2539,786
5252,1,1,391,2635,2244
5253,0,0,54,0,-54
5254,1,0,124,0,-124
5255,0,0,45,0,-45
5256,1,0,4,0,-4
5257,1,1,1313,1355,42
5258,0,0,64,0,-64
5259,1,0,9,0,-9
5260,0,0,48,0,-48
5261,0,0,8,0,-8
5262,0,0,5,0,-5
5263,1,1,167,3039,2872
5264,0,0,5,0,-5
5265,1,1,923,1600,677
5266,1,1,723,1223,500
5267,1,1,70,1960,1890
5268,0,0,5,0,-5
5269,1,0,19,0,-19
5270,0,0,55,0,-55
5271,0,0,116,0,-116
5272,0,0,59,0,-59
5273,1,0,411,0,-411
5274,1,1,451,1230,779
5275,1,1,217,1287,1070
5276,0,0,9,0,-9
5277,1,1,864,1369,505
5278,1,0,14,0,-14
5279,0,0,26,0,-26
5280,0,0,47,0,-47
5281,0,0,2,0,-2
5282,0,0,105,0,-105
5283,1,1,338,2057,1719
5284,1,0,29,0,-29
5285,1,0,98,0,-98
5286,1,1,1044,1355,311
5287,1,1,151,1419,1268
5288,0,0,32,0,-32
5289,1,0,76,0,-76
5290,0,0,40,0,-40
5291,1,1,595,1569,974
5292,0,0,34,0,-34
5293,1,0,56,0,-56
5294,1,0,69,0,-69
5295,0,0,138,0,-138
5296,1,0,26,0,-26
5297,1,0,15,0,-15
5298,1,0,13,0,-13
5299,0,0,6,0,-6
5300,1,0,77,0,-77
5301,0,0,58,0,-58
5302,0,0,24,0,-24
5303,0,0,34,0,-34
5304,0,0,18,0,-18
5305,0,0,30,0,-30
5306,1,0,45,0,-45
5307,0,0,3,0,-3
5308,1,1,706,1222,516
5309,0,0,15,0,-15
5310,0,0,36,0,-36
5311,0,0,127,0,-127
5312,1,0,82,0,-82
5313,1,0,189,0,-189
5314,0,0,53,0,-53
5315,0,0,175,0,-175
5316,1,0,51,0,-51
5317,0,0,75,0,-75
5318,1,1,163,1379,1216
5319,1,0,53,0,-53
5320,1,0,198,0,-198
5321,1,0,79,0,-79
5322,1,1,95,1702,1607
5323,0,0,23,0,-23
5324,1,1,1761,1792,31
5325,0,0,23,0,-23
5326,1,0,73,0,-73
5327,1,1,891,1475,584
5328,1,0,9,0,-9
5329,0,0,11,0,-11
5330,0,0,5,0,-5
5331,0,0,7,0,-7
5332,0,0,40,0,-40
5333,1,0,22,0,-22
5334,0,0,3,0,-3
5335,1,1,248,1355,1107
5336,0,0,207,0,-207
5337,0,0,2,0,-2
5338,1,0,10,0,-10
5339,1,0,34,0,-34
5340,0,0,45,0,-45
5341,0,0,57,0,-57
5342,1,1,197,1446,1249
5343,0,0,50,0,-50
5344,1,1,194,3372,3178
5345,1,1,222,1256,1034
5346,0,0,2,0,-2
5347,0,0,5,0,-5
5348,1,0,8,0,-8
5349,1,0,12,0,-12
5350,0,0,22,0,-22
5351,0,0,31,0,-31
5352,0,0,22,0,-22
5353,0,0,35,0,-35
5354,0,0,106,0,-106
5355,1,1,264,1257,993
5356,0,0,25,0,-25
5357,0,0,53,0,-53
5358,0,0,113,0,-113
5359,1,1,148,1374,1226
5360,1,0,63,0,-63
5361,0,0,130,0,-130
5362,1,1,482,1706,1224
5363,1,0,13,0,-13
5364,1,0,80,0,-80
5365,0,0,13,0,-13
5366,1,0,61,0,-61
5367,1,0,63,0,-63
5368,1,0,62,0,-62
5369,1,1,849,1254,405
5370,0,0,57,0,-57
5371,0,0,15,0,-15
5372,1,1,472,1313,841
5373,0,0,0,0,0
5374,1,1,139,1266,1127
5375,0,0,28,0,-28
5376,1,1,29,1279,1250
5377,1,0,3,0,-3
5378,1,0,49,0,-49
5379,0,0,0,0,0
5380,1,1,207,1955,1748
5381,1,0,14,0,-14
5382,0,0,50,0,-50
5383,0,0,87,0,-87
5384,1,0,22,0,-22
5385,1,1,137,1289,1152
5386,0,0,29,0,-29
5387,1,0,76,0,-76
5388,0,0,30,0,-30
5389,1,0,58,0,-58
5390,1,0,21,0,-21
5391,1,1,870,1217,347
5392,1,0,38,0,-38
5393,0,0,88,0,-88
5394,0,0,3,0,-3
5395,1,1,431,1635,1204
5396,0,0,36,0,-36
5397,1,1,1537,1305,-232
5398,0,0,8,0,-8
5399,1,1,250,1250,1000
5400,1,1,883,2675,1792
5401,1,1,422,1200,778
5402,1,1,220,1693,1473
5403,1,0,16,0,-16
5404,1,1,173,1451,1278
5405,1,0,15,0,-15
5406,1,1,1373,1337,-36
5407,0,0,123,0,-123
5408,0,0,104,0,-104
5409,1,0,64,0,-64
5410,0,0,53,0,-53
5411,1,1,453,1938,1485
5412,1,0,49,0,-49
5413,0,0,2,0,-2
5414,0,0,9,0,-9
5415,1,0,0,0,0
5416,1,1,227,1239,1012
5417,1,0,1,0,-1
5418,1,1,54,1206,1152
5419,1,0,26,0,-26
5420,1,1,260,1220,960
5421,1,1,96,1539,1443
5422,0,0,113,0,-113
5423,1,0,241,0,-241
5424,1,0,81,0,-81
5425,1,1,46,1218,1172
5426,0,0,27,0,-27
5427,0,0,3,0,-3
5428,1,1,110,1306,1196
5429,1,1,811,1343,532
5430,1,1,513,1213,700
5431,0,0,6,0,-6
5432,0,0,31,0,-31
5433,0,0,116,0,-116
5434,0,0,53,0,-53
5435,1,0,88,0,-88
5436,1,0,112,0,-112
5437,1,1,274,1267,993
5438,1,1,576,1304,728
5439,1,1,526,1250,724
5440,1,0,110,0,-110
5441,1,0,21,0,-21
5442,1,1,272,1361,1089
5443,0,0,21,0,-21
5444,1,1,854,2030,1176
5445,0,0,23,0,-23
5446,0,0,79,0,-79
5447,1,0,115,0,-115
5448,1,0,27,0,-27
5449,0,0,21,0,-21
5450,1,1,504,2023,1519
5451,1,0,27,0,-27
5452,0,0,47,0,-47
5453,1,0,10,0,-10
5454,1,1,1044,1283,239
5455,1,0,77,0,-77
5456,0,0,4,0,-4
5457,1,0,67,0,-67
5458,1,0,52,0,-52
5459,0,0,49,0,-49
5460,1,1,357,1458,1101
5461,0,0,50,0,-50
5462,1,0,171,0,-171
5463,0,0,112,0,-112
5464,1,1,134,1459,1325
5465,0,0,64,0,-64
5466,0,0,28,0,-28
5467,1,0,87,0,-87
5468,1,0,30,0,-30
5469,1,1,1609,1235,-374
5470,1,1,256,2795,2539
5471,1,1,459,1201,742
5472,1,0,26,0,-26
5473,1,0,7,0,-7
5474,1,0,77,0,-77
5475,1,0,29,0,-29
5476,1,0,76,0,-76
5477,1,1,186,3696,3510
5478,1,1,251,1218,967
5479,0,0,1,0,-1
5480,0,0,37,0,-37
5481,0,0,17,0,-17
5482,1,1,296,1219,923
5483,1,0,27,0,-27
5484,1,1,577,1347,770
5485,1,1,489,1435,946
5486,1,1,109,1204,1095
5487,1,0,108,0,-108
5488,1,1,936,1532,596
5489,1,1,537,1487,950
5490,0,0,35,0,-35
5491,1,0,53,0,-53
5492,1,0,95,0,-95
5493,1,1,706,2216,1510
5494,0,0,0,0,0
5495,0,0,65,0,-65
5496,0,0,79,0,-79
5497,0,0,353,0,-353
5498,0,0,39,0,-39
5499,1,0,143,0,-143
5500,1,0,4,0,-4
5501,1,0,56,0,-56
5502,0,0,4,0,-4
5503,1,1,987,1233,246
5504,1,1,232,1941,1709
5505,1,0,13,0,-13
5506,1,0,11,0,-11
5507,1,0,36,0,-36
5508,1,1,430,1328,898
5509,1,1,635,1334,699
5510,1,1,196,1807,1611
5511,1,0,55,0,-55
5512,0,0,52,0,-52
5513,1,1,773,1333,560
5514,0,0,23,0,-23
5515,1,0,0,0,0
5516,1,0,50,0,-50
5517,0,0,137,0,-137
5518,1,0,55,0,-55
5519,1,1,232,1674,1442
5520,0,0,233,0,-233
5521,0,0,16,0,-16
5522,1,0,39,0,-39
5523,1,1,713,1546,833
5524,1,1,640,1351,711
5525,0,0,48,0,-48
5526,1,0,6,0,-6
5527,1,0,17,0,-17
5528,1,1,84,1238,1154
5529,0,0,12,0,-12
5530,1,1,422,1471,1049
5531,0,0,58,0,-58
5532,0,0,95,0,-95
5533,0,0,62,0,-62
5534,0,0,3,0,-3
5535,0,0,18,0,-18
5536,1,1,769,1241,472
5537,1,0,155,0,-155
5538,1,0,70,0,-70
5539,0,0,1,0,-1
5540,0,0,37,0,-37
5541,0,0,81,0,-81
5542,0,0,147,0,-147
5543,1,1,1165,1647,482
5544,1,0,27,0,-27
5545,0,0,52,0,-52
5546,0,0,98,0,-98
5547,1,0,179,0,-179
5548,0,0,17,0,-17
5549,1,0,19,0,-19
5550,1,1,1817,1343,-474
5551,0,0,81,0,-81
5552,0,0,85,0,-85
5553,0,0,2,0,-2
5554,1,0,103,0,-103
5555,1,1,782,1222,440
5556,1,0,31,0,-31
5557,1,1,314,1628,1314
5558,0,0,6,0,-6
5559,1,0,9,0,-9
5560,1,0,61,0,-61
5561,0,0,113,0,-113
5562,1,1,199,1268,1069
5563,1,0,16,0,-16
5564,0,0,154,0,-154
5565,0,0,17,0,-17
5566,1,0,8,0,-8
5567,1,0,22,0,-22
5568,1,0,150,0,-150
5569,0,0,143,0,-143
5570,1,0,64,0,-64
5571,1,1,123,1638,1515
5572,0,0,5,0,-5
5573,0,0,32,0,-32
5574,1,0,34,0,-34
5575,0,0,46,0,-46
5576,1,1,390,1553,1163
5577,0,0,46,0,-46
5578,0,0,6,0,-6
5579,1,1,133,1345,1212
5580,1,0,1,0,-1
5581,1,0,140,0,-140
5582,1,0,73,0,-73
5583,1,1,760,1791,1031
5584,0,0,7,0,-7
5585,0,0,11,0,-11
5586,1,0,54,0,-54
5587,1,1,191,1699,1508
5588,0,0,7,0,-7
5589,0,0,15,0,-15
5590,1,1,132,2834,2702
5591,0,0,107,0,-107
5592,1,0,6,0,-6
5593,1,1,125,1337,1212
5594,0,0,59,0,-59
5595,1,0,55,0,-55
5596,1,0,139,0,-139
5597,0,0,36,0,-36
5598,1,1,375,1365,990
5599,0,0,31,0,-31
5600,0,0,89,0,-89
5601,1,1,202,1485,1283
5602,0,0,10,0,-10
5603,0,0,61,0,-61
5604,0,0,22,0,-22
5605,0,0,96,0,-96
5606,1,1,156,1203,1047
5607,1,0,11,0,-11
5608,1,0,57,0,-57
5609,0,0,12,0,-12
5610,0,0,43,0,-43
5611,0,0,36,0,-36
5612,0,0,17,0,-17
5613,1,1,232,1307,1075
5614,1,0,4,0,-4
5615,1,0,1,0,-1
5616,0,0,65,0,-65
5617,1,1,355,1320,965
5618,1,1,573,1242,669
5619,0,0,61,0,-61
5620,0,0,49,0,-49
5621,0,0,6,0,-6
5622,1,1,522,1697,1175
5623,0,0,24,0,-24
5624,1,1,792,1330,538
5625,1,1,723,1479,756
5626,1,0,5,0,-5
5627,0,0,133,0,-133
5628,0,0,53,0,-53
5629,1,1,118,2230,2112
5630,1,1,85,1243,1158
5631,0,0,5,0,-5
5632,0,0,127,0,-127
5633,1,0,4,0,-4
5634,1,1,267,1235,968
5635,0,0,14,0,-14
5636,1,0,60,0,-60
5637,1,1,299,1627,1328
5638,1,0,68,0,-68
5639,1,1,1231,1277,46
5640,0,0,10,0,-10
5641,1,0,63,0,-63
5642,1,1,707,1849,1142
5643,1,1,1333,1461,128
5644,1,1,1236,1309,73
5645,1,0,21,0,-21
5646,0,0,11,0,-11
5647,0,0,50,0,-50
5648,1,1,415,1204,789
5649,1,0,60,0,-60
5650,1,0,74,0,-74
5651,1,0,25,0,-25
5652,1,1,664,1752,1088
5653,1,0,65,0,-65
5654,0,0,14,0,-14
5655,1,1,271,1200,929
5656,0,0,31,0,-31
5657,1,0,238,0,-238
5658,1,0,35,0,-35
5659,1,1,252,1300,1048
5660,1,1,1090,1253,163
5661,0,0,19,0,-19
5662,0,0,22,0,-22
5663,0,0,9,0,-9
5664,0,0,2,0,-2
5665,1,1,166,1493,1327
5666,1,1,875,1677,802
5667,1,1,78,1364,1286
5668,1,1,432,1374,942
5669,0,0,10,0,-10
5670,1,1,314,1671,1357
5671,0,0,20,0,-20
5672,1,1,668,1505,837
5673,0,0,139,0,-139
5674,1,0,76,0,-76
5675,0,0,20,0,-20
5676,0,0,11,0,-11
5677,1,1,141,2152,2011
5678,0,0,71,0,-71
5679,1,1,584,1335,751
5680,0,0,42,0,-42
5681,0,0,110,0,-110
5682,1,0,83,0,-83
5683,0,0,28,0,-28
5684,1,1,505,1309,804
5685,0,0,55,0,-55
5686,0,0,20,0,-20
5687,1,0,64,0,-64
5688,1,0,110,0,-110
5689,0,0,66,0,-66
5690,1,0,54,0,-54
5691,1,1,178,1693,1515
5692,1,0,95,0,-95
5693,1,1,2139,3263,1124
5694,1,0,14,0,-14
5695,0,0,1,0,-1
5696,1,0,60,0,-60
5697,1,0,56,0,-56
5698,1,1,592,2131,1539
5699,1,0,10,0,-10
5700,1,0,98,0,-98
5701,1,0,38,0,-38
5702,1,0,47,0,-47
5703,0,0,3,0,-3
5704,1,0,15,0,-15
5705,0,0,75,0,-75
5706,0,0,32,0,-32
5707,1,1,217,1417,1200
5708,1,1,151,1256,1105
5709,0,0,1,0,-1
5710,1,1,295,2661,2366
5711,1,1,76,1437,1361
5712,0,0,42,0,-42
5713,0,0,71,0,-71
5714,1,0,20,0,-20
5715,1,1,370,1259,889
5716,1,0,178,0,-178
5717,1,1,391,1299,908
5718,0,0,63,0,-63
5719,1,1,189,2109,1920
5720,1,0,47,0,-47
5721,0,0,1,0,-1
5722,1,0,218,0,-218
5723,1,0,38,0,-38
5724,0,0,29,0,-29
5725,0,0,5,0,-5
5726,1,0,54,0,-54
5727,0,0,14,0,-14
5728,1,1,1245,1428,183
5729,0,0,25,0,-25
5730,1,0,24,0,-24
5731,0,0,79,0,-79
5732,0,0,21,0,-21
5733,1,1,422,1449,1027
5734,0,0,106,0,-106
5735,0,0,107,0,-107
5736,0,0,7,0,-7
5737,0,0,31,0,-31
5738,1,1,1088,1349,261
5739,0,0,40,0,-40
5740,1,1,233,1778,1545
5741,1,1,215,1433,1218
5742,1,1,152,1272,1120
5743,1,1,183,1357,1174
5744,0,0,25,0,-25
5745,1,0,11,0,-11
5746,1,0,31,0,-31
5747,0,0,54,0,-54
5748,1,1,705,1237,532
5749,0,0,15,0,-15
5750,1,1,312,1260,948
5751,1,1,173,1636,1463
5752,1,0,60,0,-60
5753,0,0,12,0,-12
5754,1,1,145,1316,1171
5755,1,1,629,1285,656
5756,0,0,14,0,-14
5757,0,0,42,0,-42
5758,1,1,275,1409,1134
5759,0,0,110,0,-110
5760,0,0,17,0,-17
5761,0,0,159,0,-159
5762,1,0,40,0,-40
5763,1,1,508,1350,842
5764,1,1,283,1391,1108
5765,0,0,3,0,-3
5766,1,0,57,0,-57
5767,1,0,13,0,-13
5768,0,0,21,0,-21
5769,0,0,9,0,-9
5770,1,0,113,0,-113
5771,1,1,935,1300,365
5772,1,1,748,1224,476
5773,1,0,0,0,0
5774,0,0,52,0,-52
5775,0,0,16,0,-16
5776,1,1,566,2745,2179
5777,0,0,50,0,-50
5778,0,0,0,0,0
5779,0,0,23,0,-23
5780,0,0,20,0,-20
5781,1,1,198,1243,1045
5782,0,0,3,0,-3
5783,1,0,77,0,-77
5784,1,1,280,1422,1142
5785,1,1,916,1211,295
5786,0,0,57,0,-57
5787,0,0,3,0,-3
5788,0,0,10,0,-10
5789,0,0,24,0,-24
5790,1,1,217,2032,1815
5791,1,1,71,1276,1205
5792,1,0,74,0,-74
5793,1,1,1090,1338,248
5794,1,0,6,0,-6
5795,1,0,34,0,-34
5796,0,0,33,0,-33
5797,1,1,583,2434,1851
5798,0,0,25,0,-25
5799,1,0,20,0,-20
5800,1,0,144,0,-144
5801,1,0,40,0,-40
5802,1,0,34,0,-34
5803,0,0,29,0,-29
5804,0,0,51,0,-51
5805,1,1,289,1892,1603
5806,1,1,54,1497,1443
5807,0,0,1,0,-1
5808,1,0,17,0,-17
5809,1,0,42,0,-42
5810,0,0,144,0,-144
5811,0,0,6,0,-6
5812,1,1,29,2845,2816
5813,1,0,2,0,-2
5814,0,0,16,0,-16
5815,1,0,125,0,-125
5816,1,0,60,0,-60
5817,1,1,132,1911,1779
5818,1,0,15,0,-15
5819,1,0,70,0,-70
5820,1,1,647,1626,979
5821,1,1,224,1728,1504
5822,0,0,31,0,-31
5823,1,0,88,0,-88
5824,0,0,63,0,-63
5825,0,0,21,0,-21
5826,1,0,6,0,-6
5827,1,1,132,1554,1422
5828,1,1,586,1235,649
5829,0,0,33,0,-33
5830,0,0,41,0,-41
5831,1,0,79,0,-79
5832,1,1,14,2670,2656
5833,1,0,26,0,-26
5834,1,0,0,0,0
5835,1,1,153,1609,1456
5836,0,0,10,0,-10
5837,0,0,31,0,-31
5838,0,0,58,0,-58
5839,0,0,109,0,-109
5840,0,0,6,0,-6
5841,1,1,305,1795,1490
5842,0,0,14,0,-14
5843,1,1,806,1683,877
5844,0,0,17,0,-17
5845,1,1,1353,2007,654
5846,0,0,64,0,-64
5847,1,1,191,1496,1305
5848,1,0,1,0,-1
5849,0,0,19,0,-19
5850,0,0,22,0,-22
5851,0,0,8,0,-8
5852,0,0,13,0,-13
5853,0,0,199,0,-199
5854,0,0,10,0,-10
5855,0,0,79,0,-79
5856,1,0,3,0,-3
5857,0,0,128,0,-128
5858,1,0,38,0,-38
5859,1,1,107,1869,1762
5860,0,0,68,0,-68
5861,1,0,9,0,-9
5862,1,0,20,0,-20
5863,1,1,366,1946,1580
5864,1,0,150,0,-150
5865,1,1,1099,1334,235
5866,1,0,88,0,-88
5867,0,0,92,0,-92
5868,1,1,2145,1213,-932
5869,1,1,1244,1265,21
5870,1,1,250,1268,1018
5871,1,1,149,2413,2264
5872,1,1,54,1670,1616
5873,0,0,19,0,-19
5874,0,0,24,0,-24
5875,1,0,34,0,-34
5876,1,0,15,0,-15
5877,0,0,64,0,-64
5878,1,0,28,0,-28
5879,1,1,2245,1256,-989
5880,1,1,563,1308,745
5881,1,1,409,1410,1001
5882,1,0,31,0,-31
5883,0,0,71,0,-71
5884,0,0,189,0,-189
5885,1,0,33,0,-33
5886,0,0,84,0,-84
5887,0,0,9,0,-9
5888,1,1,132,1568,1436
5889,1,0,104,0,-104
5890,0,0,37,0,-37
5891,1,1,850,1669,819
5892,1,1,1364,1902,538
5893,1,0,94,0,-94
5894,1,0,41,0,-41
5895,0,0,43,0,-43
5896,1,0,103,0,-103
5897,1,1,102,6891,6789
5898,1,1,1223,1378,155
5899,1,0,14,0,-14
5900,0,0,44,0,-44
5901,0,0,28,0,-28
5902,1,0,38,0,-38
5903,1,1,780,1472,692
5904,0,0,29,0,-29
5905,1,1,211,1952,1741
5906,0,0,40,0,-40
5907,0,0,205,0,-205
5908,1,0,67,0,-67
5909,0,0,10,0,-10
5910,0,0,90,0,-90
5911,1,0,26,0,-26
5912,0,0,0,0,0
5913,0,0,73,0,-73
5914,0,0,35,0,-35
5915,1,1,2284,1700,-584
5916,1,1,303,1269,966
5917,1,0,94,0,-94
5918,0,0,108,0,-108
5919,1,1,1213,1522,309
5920,1,1,104,1214,1110
5921,1,1,558,1217,659
5922,0,0,42,0,-42
5923,1,1,407,1251,844
5924,1,1,265,1491,1226
5925,0,0,83,0,-83
5926,1,0,26,0,-26
5927,1,0,97,0,-97
5928,0,0,7,0,-7
5929,0,0,25,0,-25
5930,0,0,67,0,-67
5931,1,1,1492,1263,-229
5932,1,1,182,1508,1326
5933,1,1,1053,2275,1222
5934,0,0,125,0,-125
5935,0,0,0,0,0
5936,1,1,345,1592,1247
5937,0,0,40,0,-40
5938,1,1,1530,1505,-25
5939,1,1,314,1335,1021
5940,1,0,15,0,-15
5941,1,0,88,0,-88
5942,1,0,4,0,-4
5943,1,0,12,0,-12
5944,0,0,25,0,-25
5945,0,0,23,0,-23
5946,0,0,13,0,-13
5947,0,0,70,0,-70
5948,1,0,121,0,-121
5949,1,1,102,1232,1130
5950,1,1,565,1242,677
5951,1,0,58,0,-58
5952,0,0,9,0,-9
5953,1,1,72,1228,1156
5954,1,1,142,1304,1162
5955,0,0,56,0,-56
5956,1,1,232,1986,1754
5957,1,1,329,1325,996
5958,1,1,309,1568,1259
5959,0,0,44,0,-44
5960,1,1,209,1436,1227
5961,1,0,12,0,-12
5962,1,1,2555,1447,-1108
5963,0,0,8,0,-8
5964,1,0,14,0,-14
5965,0,0,192,0,-192
5966,0,0,14,0,-14
5967,1,1,597,1265,668
5968,1,1,335,1323,988
5969,0,0,8,0,-8
5970,1,1,506,1353,847
5971,1,0,104,0,-104
5972,1,1,724,1253,529
5973,1,1,807,4047,3240
5974,0,0,59,0,-59
5975,0,0,84,0,-84
5976,0,0,198,0,-198
5977,1,1,327,1479,1152
5978,0,0,43,0,-43
5979,1,1,529,1204,675
5980,1,1,251,2072,1821
5981,1,0,24,0,-24
5982,1,0,87,0,-87
5983,0,0,9,0,-9
5984,1,1,94,1502,1408
5985,0,0,5,0,-5
5986,1,0,30,0,-30
5987,1,0,9,0,-9
5988,0,0,8,0,-8
5989,0,0,74,0,-74
5990,0,0,29,0,-29
5991,0,0,20,0,-20
5992,1,0,6,0,-6
5993,1,0,64,0,-64
5994,0,0,38,0,-38
5995,0,0,0,0,0
5996,1,0,82,0,-82
5997,1,0,26,0,-26
5998,1,1,787,1274,487
5999,1,1,280,1229,949
6000,0,0,125,0,-125
6001,1,1,2159,1640,-519
6002,0,0,29,0,-29
6003,1,0,21,0,-21
6004,1,0,0,0,0
6005,0,0,17,0,-17
6006,0,0,26,0,-26
6007,1,0,47,0,-47
6008,1,0,52,0,-52
6009,0,0,8,0,-8
6010,1,0,37,0,-37
6011,1,1,291,1207,916
6012,1,1,577,1816,1239
6013,1,0,23,0,-23
6014,1,1,327,1268,941
6015,0,0,19,0,-19
6016,1,0,183,0,-183
6017,1,1,1314,1216,-98
6018,1,1,551,1541,990
6019,1,1,703,1712,1009
6020,1,0,7,0,-7
6021,1,1,1302,1738,436
6022,0,0,8,0,-8
6023,0,0,73,0,-73
6024,1,1,238,1211,973
6025,1,0,89,0,-89
6026,0,0,175,0,-175
6027,1,0,154,0,-154
6028,1,0,19,0,-19
6029,0,0,4,0,-4
6030,1,1,864,1487,623
6031,0,0,1,0,-1
6032,1,0,117,0,-117
6033,0,0,93,0,-93
6034,1,0,44,0,-44
6035,1,0,54,0,-54
6036,1,0,77,0,-77
6037,1,1,806,2753,1947
6038,0,0,41,0,-41
6039,1,0,89,0,-89
6040,1,0,55,0,-55
6041,1,1,169,1212,1043
6042,1,1,85,1313,1228
6043,1,0,10,0,-10
6044,1,1,148,2098,1950
6045,0,0,27,0,-27
6046,0,0,9,0,-9
6047,1,0,97,0,-97
6048,0,0,73,0,-73
6049,1,1,353,2370,2017
6050,0,0,18,0,-18
6051,0,0,54,0,-54
6052,0,0,31,0,-31
6053,0,0,15,0,-15
6054,1,0,45,0,-45
6055,0,0,34,0,-34
6056,1,0,91,0,-91
6057,1,0,7,0,-7
6058,0,0,14,0,-14
6059,1,1,437,1337,900
6060,1,0,36,0,-36
6061,1,1,1269,1566,297
6062,0,0,68,0,-68
6063,0,0,18,0,-18
6064,1,1,115,1326,1211
6065,1,0,22,0,-22
6066,0,0,83,0,-83
6067,1,1,535,1614,1079
6068,0,0,54,0,-54
6069,1,1,482,1371,889
6070,0,0,7,0,-7
6071,1,0,94,0,-94
6072,0,0,3,0,-3
6073,1,0,74,0,-74
6074,1,0,71,0,-71
6075,1,0,57,0,-57
6076,1,0,20,0,-20
6077,0,0,43,0,-43
6078,0,0,38,0,-38
6079,0,0,55,0,-55
6080,1,1,1981,1670,-311
6081,1,1,632,1286,654
6082,0,0,6,0,-6
6083,1,0,13,0,-13
6084,0,0,42,0,-42
6085,1,0,0,0,0
6086,0,0,31,0,-31
6087,1,0,31,0,-31
6088,1,0,49,0,-49
6089,1,1,2386,1242,-1144
6090,0,0,5,0,-5
6091,1,1,485,1590,1105
6092,1,0,31,0,-31
6093,1,0,169,0,-169
6094,1,1,855,1368,513
6095,0,0,59,0,-59
6096,1,0,0,0,0
6097,1,0,32,0,-32
6098,1,0,45,0,-45
6099,0,0,9,0,-9
6100,0,0,23,0,-23
6101,1,0,170,0,-170
6102,0,0,11,0,-11
6103,0,0,21,0,-21
6104,1,0,141,0,-141
6105,1,1,224,1244,1020
6106,0,0,198,0,-198
6107,1,1,1304,2805,1501
6108,1,0,267,0,-267
6109,1,0,72,0,-72
6110,1,0,27,0,-27
6111,1,0,36,0,-36
6112,1,0,34,0,-34
6113,0,0,21,0,-21
6114,1,0,5,0,-5
6115,1,1,631,1459,828
6116,1,0,415,0,-415
6117,1,1,745,1343,598
6118,0,0,38,0,-38
6119,0,0,25,0,-25
6120,1,1,568,1770,1202
6121,0,0,15,0,-15
6122,1,1,1651,1249,-402
6123,1,1,123,1327,1204
6124,0,0,20,0,-20
6125,0,0,28,0,-28
6126,1,1,408,3490,3082
6127,0,0,39,0,-39
6128,1,1,296,1393,1097
6129,0,0,29,0,-29
6130,1,1,511,1746,1235
6131,0,0,13,0,-13
6132,1,0,18,0,-18
6133,1,1,1731,1290,-441
6134,1,1,497,1233,736
6135,1,0,36,0,-36
6136,0,0,45,0,-45
6137,0,0,136,0,-136
6138,1,0,6,0,-6
6139,1,1,219,1495,1276
6140,1,1,117,3335,3218
6141,1,0,113,0,-113
6142,1,0,18,0,-18
6143,1,1,596,1944,1348
6144,0,0,58,0,-58
6145,0,0,33,0,-33
6146,1,1,937,1440,503
6147,1,1,312,1251,939
6148,1,1,673,1249,576
6149,0,0,50,0,-50
6150,0,0,14,0,-14
6151,1,0,70,0,-70
6152,0,0,8,0,-8
6153,1,0,2,0,-2
6154,1,0,27,0,-27
6155,1,0,10,0,-10
6156,1,1,783,1373,590
6157,1,0,20,0,-20
6158,1,0,9,0,-9
6159,0,0,8,0,-8
6160,1,0,21,0,-21
6161,1,1,399,1205,806
6162,1,1,404,4684,4280
6163,1,1,79,1221,1142
6164,1,0,105,0,-105
6165,1,0,80,0,-80
6166,1,1,36,1964,1928
6167,0,0,90,0,-90
6168,1,0,37,0,-37
6169,1,0,8,0,-8
6170,1,1,477,1306,829
6171,0,0,34,0,-34
6172,1,1,384,1500,1116
6173,1,1,500,1329,829
6174,0,0,26,0,-26
6175,1,1,70,1286,1216
6176,0,0,19,0,-19
6177,0,0,4,0,-4
6178,0,0,140,0,-140
6179,0,0,64,0,-64
6180,0,0,31,0,-31
6181,0,0,67,0,-67
6182,1,0,74,0,-74
6183,0,0,11,0,-11
6184,0,0,40,0,-40
6185,0,0,67,0,-67
6186,1,0,6,0,-6
6187,1,0,4,0,-4
6188,0,0,53,0,-53
6189,1,1,342,1283,941
6190,0,0,20,0,-20
6191,1,0,32,0,-32
6192,1,0,15,0,-15
6193,0,0,21,0,-21
6194,0,0,46,0,-46
6195,1,1,26,1804,1778
6196,0,0,1,0,-1
6197,0,0,6,0,-6
6198,1,0,20,0,-20
6199,1,0,6,0,-6
6200,0,0,51,0,-51
6201,0,0,79,0,-79
6202,1,0,87,0,-87
6203,1,0,33,0,-33
6204,1,1,131,1874,1743
6205,0,0,8,0,-8
6206,0,0,49,0,-49
6207,1,0,108,0,-108
6208,0,0,24,0,-24
6209,0,0,15,0,-15
6210,1,1,154,1288,1134
6211,1,0,31,0,-31
6212,0,0,0,0,0
6213,1,1,133,1386,1253
6214,1,0,51,0,-51
6215,1,0,190,0,-190
6216,0,0,25,0,-25
6217,1,0,215,0,-215
6218,0,0,126,0,-126
6219,0,0,4,0,-4
6220,1,0,49,0,-49
6221,1,0,162,0,-162
6222,0,0,26,0,-26
6223,0,0,29,0,-29
6224,1,0,11,0,-11
6225,1,0,114,0,-114
6226,1,1,812,1394,582
6227,1,1,111,1834,1723
6228,0,0,34,0,-34
6229,1,0,24,0,-24
6230,1,0,72,0,-72
6231,1,1,1108,1406,298
6232,0,0,16,0,-16
6233,1,1,350,1270,920
6234,0,0,65,0,-65
6235,1,1,560,1231,671
6236,0,0,7,0,-7
6237,0,0,149,0,-149
6238,1,0,23,0,-23
6239,1,0,6,0,-6
6240,0,0,66,0,-66
6241,1,1,870,2717,1847
6242,0,0,138,0,-138
6243,0,0,3,0,-3
6244,0,0,3,0,-3
6245,1,1,35,2276,2241
6246,0,0,3,0,-3
6247,1,1,1143,2038,895
6248,1,0,23,0,-23
6249,0,0,45,0,-45
6250,1,0,14,0,-14
6251,1,0,149,0,-149
6252,1,1,1533,2721,1188
6253,1,0,79,0,-79
6254,1,0,18,0,-18
6255,1,1,76,1515,1439
6256,0,0,78,0,-78
6257,1,0,94,0,-94
6258,1,0,14,0,-14
6259,0,0,48,0,-48
6260,0,0,25,0,-25
6261,0,0,12,0,-12
6262,1,1,483,1350,867
6263,1,1,415,1275,860
6264,1,0,21,0,-21
6265,1,0,37,0,-37
6266,0,0,69,0,-69
6267,1,1,98,1408,1310
6268,1,1,1050,1343,293
6269,1,0,102,0,-102
6270,1,0,3,0,-3
6271,1,1,311,1201,890
6272,1,1,415,1363,948
6273,0,0,178,0,-178
6274,0,0,1,0,-1
6275,0,0,11,0,-11
6276,0,0,73,0,-73
6277,1,0,21,0,-21
6278,1,1,1057,1814,757
6279,1,1,99,1339,1240
6280,1,0,1,0,-1
6281,0,0,5,0,-5
6282,0,0,32,0,-32
6283,1,0,318,0,-318
6284,0,0,37,0,-37
6285,0,0,33,0,-33
6286,0,0,217,0,-217
6287,0,0,147,0,-147
6288,0,0,27,0,-27
6289,1,0,49,0,-49
6290,1,0,25,0,-25
6291,1,1,285,1333,1048
6292,1,0,15,0,-15
6293,1,1,657,1240,583
6294,0,0,94,0,-94
6295,0,0,19,0,-19
6296,1,1,208,1304,1096
6297,1,0,20,0,-20
6298,1,1,390,1482,1092
6299,0,0,4,0,-4
6300,0,0,5,0,-5
6301,0,0,13,0,-13
6302,1,0,3,0,-3
6303,0,0,62,0,-62
6304,0,0,8,0,-8
6305,1,1,234,1259,1025
6306,1,0,3,0,-3
6307,1,0,10,0,-10
6308,1,1,252,1934,1682
6309,1,0,17,0,-17
6310,1,1,331,2116,1785
6311,1,0,35,0,-35
6312,1,1,161,1204,1043
6313,0,0,14,0,-14
6314,0,0,4,0,-4
6315,0,0,13,0,-13
6316,1,0,16,0,-16
6317,1,0,3,0,-3
6318,0,0,26,0,-26
6319,1,1,586,1248,662
6320,0,0,148,0,-148
6321,0,0,14,0,-14
6322,1,1,2632,1507,-1125
6323,1,0,94,0,-94
6324,1,1,29,1339,1310
6325,1,1,159,1729,1570
6326,0,0,46,0,-46
6327,1,0,138,0,-138
6328,1,0,33,0,-33
6329,1,0,64,0,-64
6330,0,0,18,0,-18
6331,0,0,46,0,-46
6332,0,0,112,0,-112
6333,0,0,45,0,-45
6334,1,1,840,1987,1147
6335,1,0,25,0,-25
6336,1,0,53,0,-53
6337,0,0,0,0,0
6338,1,1,939,1263,324
6339,1,0,0,0,0
6340,0,0,21,0,-21
6341,0,0,7,0,-7
6342,1,1,1749,1270,-479
6343,1,0,75,0,-75
6344,0,0,9,0,-9
6345,1,1,193,1275,1082
6346,0,0,73,0,-73
6347,1,0,30,0,-30
6348,1,1,88,1545,1457
6349,1,0,49,0,-49
6350,0,0,53,0,-53
6351,1,0,63,0,-63
6352,1,1,70,1561,1491
6353,0,0,157,0,-157
6354,1,0,102,0,-102
6355,1,0,72,0,-72
6356,1,1,228,1202,974
6357,0,0,125,0,-125
6358,0,0,15,0,-15
6359,0,0,78,0,-78
6360,1,0,31,0,-31
6361,1,0,115,0,-115
6362,0,0,15,0,-15
6363,0,0,54,0,-54
6364,0,0,41,0,-41
6365,0,0,176,0,-176
6366,1,1,333,1572,1239
6367,1,1,941,1224,283
6368,1,1,122,1488,1366
6369,0,0,23,0,-23
6370,1,1,1416,1505,89
6371,0,0,22,0,-22
6372,1,0,31,0,-31
6373,1,0,23,0,-23
6374,1,1,102,1350,1248
6375,1,1,2191,1442,-749
6376,1,0,30,0,-30
6377,0,0,7,0,-7
6378,1,1,510,1422,912
6379,1,0,93,0,-93
6380,0,0,10,0,-10
6381,1,1,66,1726,1660
6382,1,0,11,0,-11
6383,0,0,41,0,-41
6384,1,1,128,1761,1633
6385,1,0,28,0,-28
6386,0,0,64,0,-64
6387,1,1,101,1897,1796
6388,0,0,72,0,-72
6389,0,0,46,0,-46
6390,0,0,62,0,-62
6391,1,1,551,1375,824
6392,0,0,3,0,-3
6393,0,0,9,0,-9
6394,1,1,312,1711,1399
6395,1,1,405,2378,1973
6396,1,1,1043,1587,544
6397,0,0,5,0,-5
6398,1,1,366,1477,1111
6399,1,1,324,1300,976
6400,1,1,208,1402,1194
6401,0,0,139,0,-139
6402,1,1,54,1202,1148
6403,0,0,22,0,-22
6404,1,1,418,1888,1470
6405,0,0,198,0,-198
6406,1,0,169,0,-169
6407,0,0,15,0,-15
6408,0,0,13,0,-13
6409,1,1,269,1665,1396
6410,1,0,84,0,-84
6411,1,1,282,2286,2004
6412,1,0,155,0,-155
6413,1,0,104,0,-104
6414,0,0,50,0,-50
6415,0,0,46,0,-46
6416,1,0,48,0,-48
6417,1,1,401,2843,2442
6418,1,0,105,0,-105
6419,1,1,1284,1297,13
6420,1,0,179,0,-179
6421,1,0,9,0,-9
6422,1,1,13,1493,1480
6423,0,0,193,0,-193
6424,1,1,1460,3621,2161
6425,1,1,223,1298,1075
6426,1,1,1583,1261,-322
6427,0,0,55,0,-55
6428,0,0,10,0,-10
6429,1,1,1404,1247,-157
6430,1,0,49,0,-49
6431,0,0,80,0,-80
6432,0,0,64,0,-64
6433,0,0,109,0,-109
6434,0,0,8,0,-8
6435,1,0,42,0,-42
6436,0,0,35,0,-35
6437,0,0,30,0,-30
6438,0,0,15,0,-15
6439,1,1,1319,1277,-42
6440,0,0,13,0,-13
6441,1,0,33,0,-33
6442,0,0,42,0,-42
6443,0,0,14,0,-14
6444,0,0,34,0,-34
6445,0,0,20,0,-20
6446,1,1,98,1284,1186
6447,1,1,1257,1588,331
6448,1,1,574,1480,906
6449,1,0,126,0,-126
6450,0,0,13,0,-13
6451,0,0,683,0,-683
6452,0,0,46,0,-46
6453,0,0,2,0,-2
6454,1,0,13,0,-13
6455,1,1,887,1321,434
6456,1,1,192,1203,1011
6457,0,0,15,0,-15
6458,1,0,29,0,-29
6459,0,0,48,0,-48
6460,1,1,47,1725,1678
6461,1,0,82,0,-82
6462,0,0,72,0,-72
6463,1,0,89,0,-89
6464,0,0,115,0,-115
6465,0,0,10,0,-10
6466,1,1,603,1226,623
6467,0,0,64,0,-64
6468,1,1,729,1341,612
6469,1,0,3,0,-3
6470,0,0,11,0,-11
6471,1,0,63,0,-63
6472,1,0,74,0,-74
6473,1,0,11,0,-11
6474,1,0,129,0,-129
6475,1,1,360,1243,883
6476,1,1,2183,1222,-961
6477,1,1,1031,1953,922
6478,1,0,4,0,-4
6479,0,0,35,0,-35
6480,1,0,11,0,-11
6481,1,0,10,0,-10
6482,0,0,80,0,-80
6483,1,0,312,0,-312
6484,1,1,424,1413,989
6485,1,0,116,0,-116
6486,0,0,37,0,-37
6487,0,0,1,0,-1
6488,0,0,43,0,-43
6489,0,0,13,0,-13
6490,1,0,143,0,-143
6491,0,0,137,0,-137
6492,0,0,1,0,-1
6493,1,1,437,1939,1502
6494,1,1,863,1590,727
6495,1,0,107,0,-107
6496,0,0,71,0,-71
6497,1,1,850,1208,358
6498,1,0,69,0,-69
6499,1,1,69,1926,1857
6500,1,0,35,0,-35
6501,1,0,67,0,-67
6502,0,0,73,0,-73
6503,1,1,562,1280,718
6504,1,1,624,1420,796
6505,1,1,1356,2274,918
6506,1,1,118,1408,1290
6507,1,0,173,0,-173
6508,1,0,1,0,-1
6509,1,0,18,0,-18
6510,0,0,34,0,-34
6511,0,0,49,0,-49
6512,0,0,2,0,-2
6513,0,0,35,0,-35
6514,0,0,12,0,-12
6515,1,1,334,1245,911
6516,0,0,153,0,-153
6517,0,0,8,0,-8
6518,1,0,17,0,-17
6519,1,1,236,1836,1600
6520,1,0,134,0,-134
6521,1,1,678,1314,636
6522,1,1,8,1404,1396
6523,1,1,164,1401,1237
6524,1,0,31,0,-31
6525,1,1,804,2978,2174
6526,1,1,1733,1328,-405
6527,0,0,5,0,-5
6528,1,1,199,2190,1991
6529,1,1,584,1439,855
6530,0,0,33,0,-33
6531,0,0,20,0,-20
6532,1,1,674,1350,676
6533,1,0,79,0,-79
6534,0,0,7,0,-7
6535,1,1,722,1245,523
6536,1,1,264,1303,1039
6537,1,1,1368,2018,650
6538,1,1,842,2056,1214
6539,1,0,10,0,-10
6540,1,1,1131,3083,1952
6541,0,0,54,0,-54
6542,1,0,1,0,-1
6543,0,0,7,0,-7
6544,0,0,10,0,-10
6545,1,1,596,1218,622
6546,0,0,77,0,-77
6547,0,0,42,0,-42
6548,0,0,8,0,-8
6549,0,0,17,0,-17
6550,1,1,786,1276,490
6551,0,0,14,0,-14
6552,0,0,71,0,-71
6553,0,0,13,0,-13
6554,1,1,132,1471,1339
6555,1,1,660,1238,578
6556,1,0,76,0,-76
6557,1,0,322,0,-322
6558,0,0,1,0,-1
6559,0,0,42,0,-42
6560,0,0,33,0,-33
6561,0,0,17,0,-17
6562,0,0,71,0,-71
6563,1,0,1,0,-1
6564,0,0,78,0,-78
6565,0,0,3,0,-3
6566,1,1,582,1576,994
6567,0,0,9,0,-9
6568,1,1,856,2001,1145
6569,1,1,856,1767,911
6570,1,0,94,0,-94
6571,0,0,8,0,-8
6572,1,1,591,2065,1474
6573,1,1,116,1531,1415
6574,1,1,648,1300,652
6575,0,0,13,0,-13
6576,1,0,34,0,-34
6577,0,0,1,0,-1
6578,1,1,252,2079,1827
6579,0,0,26,0,-26
6580,1,0,52,0,-52
6581,1,0,43,0,-43
6582,1,0,14,0,-14
6583,0,0,85,0,-85
6584,1,1,1913,2272,359
6585,0,0,69,0,-69
6586,1,0,91,0,-91
6587,1,1,1284,1538,254
6588,1,1,1352,1228,-124
6589,0,0,28,0,-28
6590,1,1,80,1392,1312
6591,1,0,101,0,-101
6592,1,0,78,0,-78
6593,1,1,889,1388,499
6594,1,1,10,1222,1212
6595,1,0,28,0,-28
6596,1,1,1014,1278,264
6597,0,0,29,0,-29
6598,1,0,10,0,-10
6599,1,0,11,0,-11
6600,1,1,146,1340,1194
6601,1,0,89,0,-89
6602,0,0,18,0,-18
6603,0,0,109,0,-109
6604,1,1,885,2364,1479
6605,0,0,38,0,-38
6606,1,0,109,0,-109
6607,0,0,6,0,-6
6608,0,0,36,0,-36
6609,0,0,57,0,-57
6610,0,0,9,0,-9
6611,1,1,160,2349,2189
6612,1,0,96,0,-96
6613,1,1,1378,1535,157
6614,1,0,62,0,-62
6615,0,0,37,0,-37
6616,0,0,24,0,-24
6617,0,0,32,0,-32
6618,1,0,24,0,-24
6619,0,0,16,0,-16
6620,0,0,53,0,-53
6621,1,1,390,1497,1107
6622,1,0,0,0,0
6623,1,1,223,1254,1031
6624,1,0,61,0,-61
6625,0,0,24,0,-24
6626,0,0,32,0,-32
6627,1,1,131,1306,1175
6628,1,0,116,0,-116
6629,0,0,6,0,-6
6630,1,1,678,1200,522
6631,1,1,1305,1290,-15
6632,0,0,53,0,-53
6633,1,0,213,0,-213
6634,1,0,60,0,-60
6635,1,1,670,1477,807
6636,0,0,17,0,-17
6637,1,1,394,1200,806
6638,1,0,33,0,-33
6639,1,0,37,0,-37
6640,1,0,23,0,-23
6641,1,1,466,1268,802
6642,1,1,905,1302,397
6643,1,1,324,1304,980
6644,0,0,4,0,-4
6645,1,0,21,0,-21
6646,1,0,64,0,-64
6647,0,0,2,0,-2
6648,1,0,145,0,-145
6649,1,1,26,1899,1873
6650,0,0,97,0,-97
6651,0,0,36,0,-36
6652,1,0,78,0,-78
6653,1,0,39,0,-39
6654,1,0,25,0,-25
6655,1,0,8,0,-8
6656,0,0,45,0,-45
6657,0,0,109,0,-109
6658,0,0,3,0,-3
6659,0,0,129,0,-129
6660,1,1,327,1485,1158
6661,1,0,58,0,-58
6662,0,0,25,0,-25
6663,0,0,21,0,-21
6664,0,0,14,0,-14
6665,1,0,35,0,-35
6666,0,0,9,0,-9
6667,1,0,57,0,-57
6668,0,0,71,0,-71
6669,0,0,48,0,-48
6670,1,0,1,0,-1
6671,0,0,1,0,-1
6672,1,0,46,0,-46
6673,1,1,1552,1523,-29
6674,1,0,31,0,-31
6675,1,1,365,1504,1139
6676,0,0,46,0,-46
6677,0,0,36,0,-36
6678,1,0,36,0,-36
6679,1,0,61,0,-61
6680,0,0,9,0,-9
6681,1,1,281,1773,1492
6682,1,1,2508,1269,-1239
6683,0,0,43,0,-43
6684,0,0,52,0,-52
6685,1,0,15,0,-15
6686,0,0,113,0,-113
6687,0,0,41,0,-41
6688,1,1,269,1246,977
6689,1,0,11,0,-11
6690,1,1,1212,1263,51
6691,0,0,39,0,-39
6692,1,1,339,1218,879
6693,1,1,1376,1657,281
6694,1,0,191,0,-191
6695,0,0,16,0,-16
6696,1,0,65,0,-65
6697,1,1,386,2280,1894
6698,0,0,0,0,0
6699,0,0,6,0,-6
6700,1,0,44,0,-44
6701,0,0,29,0,-29
6702,1,0,47,0,-47
6703,1,1,41,1268,1227
6704,1,0,35,0,-35
6705,0,0,36,0,-36
6706,0,0,74,0,-74
6707,1,0,111,0,-111
6708,0,0,14,0,-14
6709,1,1,513,1451,938
6710,0,0,164,0,-164
6711,0,0,16,0,-16
6712,1,0,3,0,-3
6713,1,1,436,1512,1076
6714,1,0,11,0,-11
6715,0,0,12,0,-12
6716,1,0,17,0,-17
6717,0,0,0,0,0
6718,1,1,1013,1346,333
6719,1,0,94,0,-94
6720,1,1,355,1792,1437
6721,1,0,2,0,-2
6722,0,0,136,0,-136
6723,0,0,57,0,-57
6724,0,0,23,0,-23
6725,0,0,22,0,-22
6726,1,1,75,1468,1393
6727,0,0,8,0,-8
6728,1,1,221,1659,1438
6729,1,0,15,0,-15
6730,0,0,15,0,-15
6731,1,1,51,1841,1790
6732,0,0,108,0,-108
6733,1,0,12,0,-12
6734,1,1,696,1264,568
6735,1,0,16,0,-16
6736,0,0,16,0,-16
6737,0,0,41,0,-41
6738,1,1,945,1719,774
6739,1,1,345,1337,992
6740,1,1,1357,1621,264
6741,1,1,287,1691,1404
6742,1,0,19,0,-19
6743,1,1,333,2046,1713
6744,1,1,663,1213,550
6745,1,1,103,1472,1369
6746,0,0,60,0,-60
6747,0,0,48,0,-48
6748,0,0,35,0,-35
6749,1,1,1623,1242,-381
6750,1,0,61,0,-61
6751,1,0,48,0,-48
6752,0,0,23,0,-23
6753,0,0,40,0,-40
6754,1,1,544,1443,899
6755,1,0,13,0,-13
6756,0,0,92,0,-92
6757,1,1,713,2556,1843
6758,0,0,30,0,-30
6759,1,0,13,0,-13
6760,1,0,1,0,-1
6761,1,1,850,1438,588
6762,1,0,164,0,-164
6763,1,0,28,0,-28
6764,0,0,31,0,-31
6765,1,1,1776,1309,-467
6766,1,0,33,0,-33
6767,1,0,3,0,-3
6768,0,0,15,0,-15
6769,1,0,56,0,-56
6770,1,1,504,1898,1394
6771,0,0,14,0,-14
6772,0,0,1,0,-1
6773,1,0,139,0,-139
6774,1,0,9,0,-9
6775,1,0,32,0,-32
6776,0,0,16,0,-16
6777,1,1,764,1642,878
6778,0,0,75,0,-75
6779,1,1,480,1202,722
6780,1,0,134,0,-134
6781,1,1,720,1297,577
6782,1,1,503,1593,1090
6783,0,0,59,0,-59
6784,1,1,1711,1284,-427
6785,0,0,6,0,-6
6786,1,1,29,2072,2043
6787,1,1,176,1415,1239
6788,0,0,76,0,-76
6789,1,1,1175,1398,223
6790,0,0,182,0,-182
6791,1,0,18,0,-18
6792,0,0,39,0,-39
6793,0,0,31,0,-31
6794,0,0,54,0,-54
6795,1,1,186,1436,1250
6796,1,1,4315,1932,-2383
6797,0,0,13,0,-13
6798,0,0,74,0,-74
6799,0,0,12,0,-12
6800,0,0,15,0,-15
6801,0,0,22,0,-22
6802,1,0,41,0,-41
6803,1,1,202,1203,1001
6804,0,0,23,0,-23
6805,0,0,2,0,-2
6806,1,1,394,1501,1107
6807,1,0,134,0,-134
6808,1,0,77,0,-77
6809,0,0,29,0,-29
6810,1,1,1054,1765,711
6811,0,0,8,0,-8
6812,0,0,5,0,-5
6813,1,1,26,1418,1392
6814,1,0,56,0,-56
6815,0,0,4,0,-4
6816,0,0,2,0,-2
6817,0,0,46,0,-46
6818,1,1,441,1210,769
6819,0,0,5,0,-5
6820,0,0,30,0,-30
6821,1,1,1452,1475,23
6822,0,0,128,0,-128
6823,1,1,64,1668,1604
6824,1,0,40,0,-40
6825,0,0,19,0,-19
6826,1,1,101,1902,1801
6827,0,0,52,0,-52
6828,0,0,0,0,0
6829,0,0,41,0,-41
6830,1,1,127,2469,2342
6831,0,0,46,0,-46
6832,1,0,27,0,-27
6833,1,0,36,0,-36
6834,1,1,221,1422,1201
6835,0,0,17,0,-17
6836,0,0,89,0,-89
6837,0,0,30,0,-30
6838,1,0,57,0,-57
6839,1,0,57,0,-57
6840,1,0,5,0,-5
6841,1,0,32,0,-32
6842,1,1,255,1660,1405
6843,1,1,670,1446,776
6844,0,0,15,0,-15
6845,1,1,267,1646,1379
6846,0,0,10,0,-10
6847,0,0,73,0,-73
6848,0,0,19,0,-19
6849,1,0,14,0,-14
6850,1,1,328,1355,1027
6851,1,0,6,0,-6
6852,1,1,1961,1283,-678
6853,1,0,72,0,-72
6854,1,0,29,0,-29
6855,0,0,12,0,-12
6856,0,0,90,0,-90
6857,0,0,24,0,-24
6858,1,1,994,1372,378
6859,1,1,489,2597,2108
6860,1,0,104,0,-104
6861,0,0,55,0,-55
6862,0,0,77,0,-77
6863,1,1,501,1232,731
6864,1,1,86,2071,1985
6865,0,0,25,0,-25
6866,1,1,157,1468,1311
6867,1,1,155,1484,1329
6868,1,0,45,0,-45
6869,0,0,226,0,-226
6870,0,0,7,0,-7
6871,1,0,66,0,-66
6872,1,0,21,0,-21
6873,1,1,676,1392,716
6874,0,0,48,0,-48
6875,1,1,159,1508,1349
6876,1,0,7,0,-7
6877,1,0,91,0,-91
6878,0,0,6,0,-6
6879,1,0,21,0,-21
6880,1,1,2756,1702,-1054
6881,0,0,98,0,-98
6882,0,0,39,0,-39
6883,1,0,22,0,-22
6884,1,1,458,1521,1063
6885,1,1,370,1642,1272
6886,1,0,31,0,-31
6887,1,0,26,0,-26
6888,0,0,4,0,-4
6889,1,1,1402,3041,1639
6890,0,0,43,0,-43
6891,1,0,1,0,-1
6892,0,0,31,0,-31
6893,1,1,144,1592,1448
6894,0,0,150,0,-150
6895,0,0,2,0,-2
6896,0,0,5,0,-5
6897,1,0,16,0,-16
6898,1,1,61,2237,2176
6899,0,0,87,0,-87
6900,0,0,33,0,-33
6901,0,0,23,0,-23
6902,0,0,5,0,-5
6903,0,0,19,0,-19
6904,1,0,51,0,-51
6905,1,0,8,0,-8
6906,0,0,7,0,-7
6907,0,0,66,0,-66
6908,0,0,36,0,-36
6909,1,0,3,0,-3
6910,1,0,47,0,-47
6911,1,1,127,1946,1819
6912,1,1,411,1681,1270
6913,1,1,123,2194,2071
6914,1,0,22,0,-22
6915,0,0,24,0,-24
6916,0,0,5,0,-5
6917,0,0,27,0,-27
6918,0,0,10,0,-10
6919,0,0,22,0,-22
6920,0,0,166,0,-166
6921,1,0,220,0,-220
6922,0,0,35,0,-35
6923,1,1,13,1364,1351
6924,1,0,6,0,-6
6925,1,0,0,0,0
6926,0,0,12,0,-12
6927,0,0,111,0,-111
6928,0,0,38,0,-38
6929,1,1,483,2093,1610
6930,1,0,30,0,-30
6931,1,0,12,0,-12
6932,1,1,314,1586,1272
6933,1,1,469,1206,737
6934,1,1,105,1226,1121
6935,1,1,250,1391,1141
6936,0,0,17,0,-17
6937,1,0,39,0,-39
6938,0,0,28,0,-28
6939,0,0,124,0,-124
6940,1,0,21,0,-21
6941,0,0,99,0,-99
6942,1,1,171,4691,4520
6943,1,1,287,2458,2171
6944,1,1,199,1212,1013
6945,0,0,28,0,-28
6946,1,1,179,1425,1246
6947,0,0,138,0,-138
6948,1,1,575,1895,1320
6949,1,0,34,0,-34
6950,0,0,72,0,-72
6951,1,1,986,1217,231
6952,0,0,14,0,-14
6953,1,1,447,1510,1063
6954,0,0,23,0,-23
6955,0,0,38,0,-38
6956,1,1,401,1826,1425
6957,0,0,79,0,-79
6958,1,1,907,1343,436
6959,0,0,1,0,-1
6960,1,1,364,1446,1082
6961,0,0,49,0,-49
6962,0,0,54,0,-54
6963,1,1,551,1912,1361
6964,1,0,63,0,-63
6965,1,1,716,1213,497
6966,1,0,45,0,-45
6967,1,1,146,2038,1892
6968,0,0,46,0,-46
6969,1,0,121,0,-121
6970,1,1,403,2115,1712
6971,0,0,93,0,-93
6972,0,0,62,0,-62
6973,0,0,81,0,-81
6974,1,0,95,0,-95
6975,1,1,927,1306,379
6976,1,0,5,0,-5
6977,0,0,59,0,-59
6978,1,1,630,2206,1576
6979,1,1,70,1211,1141
6980,1,0,32,0,-32
6981,1,1,494,1247,753
6982,1,0,64,0,-64
6983,0,0,73,0,-73
6984,1,1,158,1335,1177
6985,1,0,56,0,-56
6986,1,1,105,1328,1223
6987,1,0,213,0,-213
6988,0,0,6,0,-6
6989,0,0,115,0,-115
6990,0,0,88,0,-88
6991,0,0,76,0,-76
6992,0,0,16,0,-16
6993,1,1,812,1318,506
6994,1,0,51,0,-51
6995,0,0,58,0,-58
6996,0,0,89,0,-89
6997,0,0,48,0,-48
6998,1,1,1409,1392,-17
6999,1,0,61,0,-61
7000,1,1,1468,1593,125
7001,1,0,7,0,-7
7002,1,1,430,1572,1142
7003,1,1,135,1277,1142
7004,0,0,125,0,-125
7005,0,0,5,0,-5
7006,0,0,35,0,-35
7007,1,1,1004,1449,445
7008,1,1,682,1366,684
7009,1,0,127,0,-127
7010,1,0,71,0,-71
7011,1,0,153,0,-153
7012,1,1,695,2443,1748
7013,1,1,263,1827,1564
7014,1,0,34,0,-34
7015,0,0,27,0,-27
7016,0,0,75,0,-75
7017,1,1,74,1947,1873
7018,0,0,44,0,-44
7019,0,0,17,0,-17
7020,0,0,9,0,-9
7021,0,0,57,0,-57
7022,1,1,503,2176,1673
7023,0,0,12,0,-12
7024,1,1,2503,1702,-801
7025,0,0,11,0,-11
7026,1,0,107,0,-107
7027,1,0,63,0,-63
7028,0,0,20,0,-20
7029,1,1,558,1321,763
7030,0,0,29,0,-29
7031,0,0,4,0,-4
7032,1,0,16,0,-16
7033,0,0,30,0,-30
7034,1,1,1108,1409,301
7035,0,0,49,0,-49
7036,0,0,41,0,-41
7037,1,0,15,0,-15
7038,1,0,57,0,-57
7039,1,0,67,0,-67
7040,1,1,646,2062,1416
7041,0,0,169,0,-169
7042,1,1,383,1506,1123
7043,0,0,135,0,-135
7044,0,0,67,0,-67
7045,0,0,4,0,-4
7046,0,0,77,0,-77
7047,0,0,0,0,0
7048,1,0,2,0,-2
7049,1,1,65,1536,1471
7050,0,0,189,0,-189
7051,0,0,138,0,-138
7052,0,0,62,0,-62
7053,0,0,5,0,-5
7054,1,0,28,0,-28
7055,1,0,41,0,-41
7056,0,0,20,0,-20
7057,0,0,26,0,-26
7058,0,0,62,0,-62
7059,1,1,159,1285,1126
7060,0,0,11,0,-11
7061,0,0,80,0,-80
7062,0,0,16,0,-16
7063,1,1,315,1514,1199
7064,1,1,403,1276,873
7065,0,0,10,0,-10
7066,0,0,22,0,-22
7067,1,0,99,0,-99
7068,1,1,83,1413,1330
7069,1,1,100,1500,1400
7070,1,1,567,1272,705
7071,0,0,59,0,-59
7072,1,0,116,0,-116
7073,1,0,1,0,-1
7074,1,1,236,1287,1051
7075,1,0,226,0,-226
7076,1,0,58,0,-58
7077,0,0,31,0,-31
7078,1,1,133,1410,1277
7079,1,0,111,0,-111
7080,1,1,106,1461,1355
7081,1,0,124,0,-124
7082,1,1,381,1308,927
7083,0,0,18,0,-18
7084,0,0,4,0,-4
7085,0,0,7,0,-7
7086,0,0,7,0,-7
7087,1,1,466,1308,842
7088,1,0,2,0,-2
7089,1,1,564,1437,873
7090,0,0,60,0,-60
7091,0,0,47,0,-47
7092,0,0,5,0,-5
7093,0,0,28,0,-28
7094,0,0,16,0,-16
7095,1,0,6,0,-6
7096,0,0,19,0,-19
7097,0,0,32,0,-32
7098,0,0,68,0,-68
7099,1,1,719,1205,486
7100,0,0,46,0,-46
7101,0,0,29,0,-29
7102,1,0,111,0,-111
7103,1,0,10,0,-10
7104,0,0,34,0,-34
7105,1,1,503,1274,771
7106,1,1,227,1570,1343
7107,1,0,104,0,-104
7108,0,0,0,0,0
7109,1,0,32,0,-32
7110,0,0,10,0,-10
7111,0,0,87,0,-87
7112,1,1,95,2111,2016
7113,1,0,43,0,-43
7114,0,0,5,0,-5
7115,0,0,27,0,-27
7116,1,0,116,0,-116
7117,0,0,12,0,-12
7118,0,0,134,0,-134
7119,1,0,315,0,-315
7120,1,1,19,1252,1233
7121,0,0,2,0,-2
7122,1,0,30,0,-30
7123,1,0,99,0,-99
7124,0,0,5,0,-5
7125,1,1,218,1783,1565
7126,1,0,35,0,-35
7127,1,0,35,0,-35
7128,0,0,19,0,-19
7129,1,0,7,0,-7
7130,1,1,827,1471,644
7131,0,0,16,0,-16
7132,1,0,68,0,-68
7133,0,0,55,0,-55
7134,0,0,35,0,-35
7135,0,0,6,0,-6
7136,0,0,173,0,-173
7137,1,1,379,2018,1639
7138,1,0,18,0,-18
7139,0,0,97,0,-97
7140,0,0,4,0,-4
7141,1,0,45,0,-45
7142,0,0,41,0,-41
7143,1,1,278,1258,980
7144,1,0,21,0,-21
7145,1,1,566,1887,1321
7146,0,0,30,0,-30
7147,1,0,1,0,-1
7148,0,0,76,0,-76
7149,1,1,838,1770,932
7150,1,0,26,0,-26
7151,0,0,29,0,-29
7152,0,0,80,0,-80
7153,1,1,118,1509,1391
7154,0,0,71,0,-71
7155,1,1,746,1444,698
7156,1,1,218,1750,1532
7157,1,1,236,1235,999
7158,0,0,30,0,-30
7159,1,1,593,1235,642
7160,0,0,3,0,-3
7161,1,0,4,0,-4
7162,1,1,622,1221,599
7163,0,0,8,0,-8
7164,1,0,3,0,-3
7165,0,0,79,0,-79
7166,1,0,7,0,-7
7167,1,1,275,1402,1127
7168,1,1,1017,1504,487
7169,1,0,0,0,0
7170,0,0,41,0,-41
7171,0,0,27,0,-27
7172,0,0,10,0,-10
7173,0,0,19,0,-19
7174,1,0,10,0,-10
7175,1,0,15,0,-15
7176,1,0,36,0,-36
7177,1,1,66,1557,1491
7178,0,0,17,0,-17
7179,0,0,45,0,-45
7180,1,0,20,0,-20
7181,1,0,9,0,-9
7182,1,0,36,0,-36
7183,1,1,371,1410,1039
7184,1,1,637,1352,715
7185,1,1,501,1369,868
7186,1,1,132,1792,1660
7187,1,0,75,0,-75
7188,1,1,326,1226,900
7189,0,0,50,0,-50
7190,1,1,345,1307,962
7191,1,0,24,0,-24
7192,1,1,815,1327,512
7193,1,0,55,0,-55
7194,1,0,25,0,-25
7195,0,0,29,0,-29
7196,1,0,23,0,-23
7197,1,1,645,1273,628
7198,1,1,99,2199,2100
7199,0,0,19,0,-19
7200,1,1,1083,1797,714
7201,1,1,62,1446,1384
7202,0,0,11,0,-11
7203,1,0,70,0,-70
7204,1,0,17,0,-17
7205,1,0,33,0,-33
7206,0,0,276,0,-276
7207,1,0,177,0,-177
7208,1,0,46,0,-46
7209,1,1,85,1499,1414
7210,1,0,18,0,-18
7211,1,1,486,1200,714
7212,1,0,26,0,-26
7213,0,0,84,0,-84
7214,1,0,11,0,-11
7215,1,1,441,1338,897
7216,1,1,89,1532,1443
7217,1,0,28,0,-28
7218,1,1,492,1679,1187
7219,0,0,123,0,-123
7220,1,1,178,1991,1813
7221,1,1,146,1216,1070
7222,1,0,31,0,-31
7223,0,0,7,0,-7
7224,0,0,85,0,-85
7225,0,0,28,0,-28
7226,0,0,28,0,-28
7227,0,0,14,0,-14
7228,1,1,116,1294,1178
7229,1,0,0,0,0
7230,0,0,19,0,-19
7231,0,0,21,0,-21
7232,0,0,22,0,-22
7233,0,0,35,0,-35
7234,1,0,27,0,-27
7235,1,1,682,1297,615
7236,0,0,120,0,-120
7237,0,0,52,0,-52
7238,0,0,11,0,-11
7239,1,0,77,0,-77
7240,0,0,192,0,-192
7241,1,0,73,0,-73
7242,0,0,6,0,-6
7243,1,0,27,0,-27
7244,1,1,359,1457,1098
7245,0,0,69,0,-69
7246,0,0,89,0,-89
7247,0,0,81,0,-81
7248,1,1,589,1339,750
7249,0,0,54,0,-54
7250,1,0,104,0,-104
7251,1,1,455,2396,1941
7252,0,0,0,0,0
7253,1,0,64,0,-64
7254,1,1,614,1295,681
7255,1,1,902,1730,828
7256,0,0,308,0,-308
7257,1,1,611,1224,613
7258,1,1,628,1300,672
7259,1,1,392,1538,1146
7260,1,0,21,0,-21
7261,1,0,60,0,-60
7262,0,0,12,0,-12
7263,1,0,0,0,0
7264,0,0,54,0,-54
7265,0,0,7,0,-7
7266,1,0,10,0,-10
7267,1,0,35,0,-35
7268,1,1,446,1880,1434
7269,0,0,52,0,-52
7270,0,0,83,0,-83
7271,1,0,21,0,-21
7272,1,1,467,1357,890
7273,1,0,32,0,-32
7274,1,0,19,0,-19
7275,1,0,4,0,-4
7276,1,0,10,0,-10
7277,1,1,164,2001,1837
7278,0,0,139,0,-139
7279,0,0,69,0,-69
7280,1,1,797,1343,546
7281,0,0,41,0,-41
7282,0,0,12,0,-12
7283,1,1,300,1339,1039
7284,1,0,69,0,-69
7285,1,1,242,1272,1030
7286,1,0,110,0,-110
7287,0,0,5,0,-5
7288,1,1,242,2118,1876
7289,1,1,221,1229,1008
7290,1,0,23,0,-23
7291,0,0,56,0,-56
7292,1,0,97,0,-97
7293,1,0,3,0,-3
7294,0,0,52,0,-52
7295,1,0,5,0,-5
7296,1,1,913,1703,790
7297,1,0,38,0,-38
7298,0,0,56,0,-56
7299,1,0,8,0,-8
7300,0,0,29,0,-29
7301,0,0,112,0,-112
7302,1,1,552,1366,814
7303,1,0,99,0,-99
7304,1,1,1093,1222,129
7305,0,0,18,0,-18
7306,0,0,105,0,-105
7307,0,0,17,0,-17
7308,1,1,121,1226,1105
7309,1,1,966,1417,451
7310,1,0,46,0,-46
7311,1,0,28,0,-28
7312,0,0,43,0,-43
7313,0,0,84,0,-84
7314,1,1,235,1409,1174
7315,1,1,479,1312,833
7316,1,1,244,1316,1072
7317,0,0,10,0,-10
7318,1,0,51,0,-51
7319,0,0,31,0,-31
7320,1,0,8,0,-8
7321,1,0,31,0,-31
7322,1,0,62,0,-62
7323,0,0,30,0,-30
7324,1,1,92,1355,1263
7325,0,0,9,0,-9
7326,1,0,7,0,-7
7327,1,0,134,0,-134
7328,1,1,1710,1426,-284
7329,1,0,44,0,-44
7330,0,0,80,0,-80
7331,0,0,94,0,-94
7332,1,1,386,1497,1111
7333,1,1,578,1428,850
7334,1,0,68,0,-68
7335,1,0,16,0,-16
7336,1,0,36,0,-36
7337,0,0,19,0,-19
7338,1,0,4,0,-4
7339,1,1,552,1396,844
7340,1,1,270,1311,1041
7341,1,1,192,1552,1360
7342,1,0,20,0,-20
7343,1,1,195,1619,1424
7344,1,1,296,1557,1261
7345,0,0,22,0,-22
7346,0,0,189,0,-189
7347,1,0,28,0,-28
7348,1,0,8,0,-8
7349,1,1,139,1827,1688
7350,1,1,730,1710,980
7351,0,0,154,0,-154
7352,0,0,28,0,-28
7353,0,0,47,0,-47
7354,1,0,30,0,-30
7355,0,0,67,0,-67
7356,1,0,104,0,-104
7357,1,1,183,1386,1203
7358,1,1,643,1604,961
7359,0,0,166,0,-166
7360,1,0,26,0,-26
7361,1,0,42,0,-42
7362,0,0,262,0,-262
7363,1,0,9,0,-9
7364,0,0,34,0,-34
7365,1,1,881,2243,1362
7366,1,0,27,0,-27
7367,0,0,31,0,-31
7368,1,1,126,1288,1162
7369,1,0,17,0,-17
7370,1,1,274,1446,1172
7371,1,0,32,0,-32
7372,1,1,323,1440,1117
7373,1,1,131,1953,1822
7374,0,0,63,0,-63
7375,1,0,77,0,-77
7376,0,0,10,0,-10
7377,1,0,3,0,-3
7378,1,1,317,2326,2009
7379,1,1,297,1467,1170
7380,0,0,49,0,-49
7381,1,0,80,0,-80
7382,0,0,21,0,-21
7383,1,1,471,1750,1279
7384,0,0,83,0,-83
7385,1,0,83,0,-83
7386,0,0,12,0,-12
7387,1,0,27,0,-27
7388,0,0,0,0,0
7389,1,0,65,0,-65
7390,1,1,379,1278,899
7391,1,1,49,2490,2441
7392,1,0,63,0,-63
7393,0,0,63,0,-63
7394,0,0,26,0,-26
7395,1,1,169,1233,1064
7396,1,0,59,0,-59
7397,1,0,51,0,-51
7398,1,1,82,1342,1260
7399,1,0,25,0,-25
7400,0,0,25,0,-25
7401,0,0,3,0,-3
7402,0,0,101,0,-101
7403,0,0,59,0,-59
7404,1,0,11,0,-11
7405,0,0,63,0,-63
7406,0,0,140,0,-140
7407,0,0,8,0,-8
7408,1,0,43,0,-43
7409,1,0,29,0,-29
7410,0,0,62,0,-62
7411,1,1,330,1392,1062
7412,1,1,328,1806,1478
7413,0,0,35,0,-35
7414,0,0,23,0,-23
7415,1,1,621,1308,687
7416,0,0,63,0,-63
7417,1,1,787,1565,778
7418,1,1,1863,1462,-401
7419,1,1,991,1342,351
7420,0,0,21,0,-21
7421,0,0,101,0,-101
7422,0,0,17,0,-17
7423,0,0,36,0,-36
7424,1,1,1113,1750,637
7425,1,1,313,1308,995
7426,1,1,239,1408,1169
7427,0,0,310,0,-310
7428,1,1,325,1288,963
7429,1,0,66,0,-66
7430,0,0,5,0,-5
7431,1,1,490,1461,971
7432,1,0,127,0,-127
7433,1,0,0,0,0
7434,1,1,799,1436,637
7435,1,0,130,0,-130
7436,1,1,763,1472,709
7437,1,1,301,1443,1142
7438,1,1,1394,1207,-187
7439,1,1,73,1444,1371
7440,0,0,35,0,-35
7441,1,0,15,0,-15
7442,1,1,274,2513,2239
7443,0,0,13,0,-13
7444,0,0,24,0,-24
7445,0,0,132,0,-132
7446,0,0,18,0,-18
7447,1,0,162,0,-162
7448,1,0,4,0,-4
7449,0,0,214,0,-214
7450,1,1,1052,2097,1045
7451,0,0,80,0,-80
7452,1,1,121,1970,1849
7453,1,0,50,0,-50
7454,0,0,126,0,-126
7455,0,0,45,0,-45
7456,1,1,2649,1252,-1397
7457,0,0,37,0,-37
7458,1,0,35,0,-35
7459,0,0,26,0,-26
7460,0,0,127,0,-127
7461,1,1,61,1498,1437
7462,1,0,7,0,-7
7463,1,1,735,1273,538
7464,1,0,35,0,-35
7465,1,0,0,0,0
7466,0,0,29,0,-29
7467,0,0,189,0,-189
7468,0,0,6,0,-6
7469,0,0,5,0,-5
7470,1,1,1818,1772,-46
7471,1,1,231,1351,1120
7472,1,0,88,0,-88
7473,0,0,41,0,-41
7474,1,1,221,1258,1037
7475,0,0,33,0,-33
7476,0,0,83,0,-83
7477,0,0,129,0,-129
7478,0,0,8,0,-8
7479,1,1,75,1207,1132
7480,1,0,123,0,-123
7481,1,0,9,0,-9
7482,1,1,422,1733,1311
7483,1,0,24,0,-24
7484,1,0,5,0,-5
7485,1,0,102,0,-102
7486,0,0,16,0,-16
7487,1,1,581,1717,1136
7488,1,1,574,1352,778
7489,0,0,6,0,-6
7490,1,0,44,0,-44
7491,1,1,445,1696,1251
7492,1,0,3,0,-3
7493,1,0,33,0,-33
7494,1,1,812,1246,434
7495,1,0,5,0,-5
7496,1,0,92,0,-92
7497,1,1,77,1255,1178
7498,1,0,161,0,-161
7499,0,0,49,0,-49
7500,0,0,23,0,-23
7501,1,1,307,1204,897
7502,1,1,1183,1569,386
7503,1,0,21,0,-21
7504,1,0,37,0,-37
7505,1,0,30,0,-30
7506,1,0,24,0,-24
7507,1,1,169,1783,1614
7508,1,0,13,0,-13
7509,1,1,869,1614,745
7510,1,0,4,0,-4
7511,1,0,32,0,-32
7512,0,0,11,0,-11
7513,0,0,9,0,-9
7514,1,1,464,1331,867
7515,1,0,192,0,-192
7516,1,0,10,0,-10
7517,1,0,16,0,-16
7518,0,0,58,0,-58
7519,0,0,6,0,-6
7520,1,0,9,0,-9
7521,0,0,44,0,-44
7522,0,0,76,0,-76
7523,1,0,23,0,-23
7524,1,1,1030,3100,2070
7525,1,0,4,0,-4
7526,0,0,20,0,-20
7527,1,1,93,1322,1229
7528,1,0,14,0,-14
7529,0,0,205,0,-205
7530,1,0,56,0,-56
7531,0,0,10,0,-10
7532,0,0,67,0,-67
7533,0,0,18,0,-18
7534,1,0,118,0,-118
7535,1,0,4,0,-4
7536,1,0,59,0,-59
7537,1,0,13,0,-13
7538,0,0,18,0,-18
7539,1,0,31,0,-31
7540,1,0,4,0,-4
7541,1,0,23,0,-23
7542,1,0,6,0,-6
7543,0,0,16,0,-16
7544,0,0,108,0,-108
7545,1,0,13,0,-13
7546,1,0,26,0,-26
7547,1,0,4,0,-4
7548,1,0,58,0,-58
7549,1,1,495,1593,1098
7550,0,0,18,0,-18
7551,1,0,33,0,-33
7552,1,1,585,1405,820
7553,0,0,5,0,-5
7554,0,0,16,0,-16
7555,1,1,1476,1302,-174
7556,0,0,4,0,-4
7557,1,0,69,0,-69
7558,1,0,45,0,-45
7559,1,1,504,1494,990
7560,1,0,32,0,-32
7561,1,1,76,1403,1327
7562,0,0,153,0,-153
7563,0,0,13,0,-13
7564,1,1,658,1640,982
7565,1,0,9,0,-9
7566,0,0,102,0,-102
7567,0,0,68,0,-68
7568,1,0,16,0,-16
7569,1,0,48,0,-48
7570,1,0,18,0,-18
7571,1,1,173,1251,1078
7572,1,1,43,1501,1458
7573,1,0,80,0,-80
7574,1,0,19,0,-19
7575,0,0,24,0,-24
7576,1,1,470,1404,934
7577,1,0,6,0,-6
7578,0,0,16,0,-16
7579,1,0,18,0,-18
7580,0,0,4,0,-4
7581,1,1,629,1241,612
7582,1,1,2355,1379,-976
7583,0,0,28,0,-28
7584,1,1,436,4441,4005
7585,0,0,26,0,-26
7586,1,1,668,1267,599
7587,0,0,53,0,-53
7588,0,0,2,0,-2
7589,1,0,51,0,-51
7590,1,1,19,1362,1343
7591,0,0,80,0,-80
7592,1,0,142,0,-142
7593,1,1,183,1307,1124
7594,1,0,39,0,-39
7595,1,1,804,1307,503
7596,1,1,725,1933,1208
7597,1,1,479,1338,859
7598,1,1,35,1687,1652
7599,0,0,117,0,-117
7600,0,0,70,0,-70
7601,1,0,7,0,-7
7602,1,1,1580,1211,-369
7603,1,0,95,0,-95
7604,1,0,28,0,-28
7605,1,0,65,0,-65
7606,0,0,21,0,-21
7607,0,0,15,0,-15
7608,1,1,277,1225,948
7609,1,1,186,1290,1104
7610,1,0,45,0,-45
7611,1,0,13,0,-13
7612,1,0,30,0,-30
7613,1,1,58,1843,1785
7614,0,0,0,0,0
7615,1,1,1093,1540,447
7616,1,0,128,0,-128
7617,1,1,743,1828,1085
7618,1,0,68,0,-68
7619,1,0,212,0,-212
7620,0,0,135,0,-135
7621,1,1,1018,1712,694
7622,1,0,0,0,0
7623,1,0,137,0,-137
7624,0,0,13,0,-13
7625,0,0,63,0,-63
7626,1,1,253,1283,1030
7627,1,0,7,0,-7
7628,1,1,1277,1334,57
7629,1,1,144,1258,1114
7630,0,0,76,0,-76
7631,0,0,40,0,-40
7632,1,1,655,1497,842
7633,0,0,0,0,0
7634,0,0,20,0,-20
7635,1,1,328,1248,920
7636,1,0,46,0,-46
7637,0,0,22,0,-22
7638,1,0,147,0,-147
7639,0,0,8,0,-8
7640,1,0,53,0,-53
7641,0,0,13,0,-13
7642,0,0,74,0,-74
7643,1,1,832,1224,392
7644,1,1,783,1327,544
7645,0,0,15,0,-15
7646,1,0,4,0,-4
7647,1,0,22,0,-22
7648,1,0,28,0,-28
7649,1,1,503,1818,1315
7650,0,0,36,0,-36
7651,0,0,62,0,-62
7652,1,1,872,1514,642
7653,1,1,29,3748,3719
7654,0,0,20,0,-20
7655,1,0,28,0,-28
7656,1,1,1759,2017,258
7657,1,0,64,0,-64
7658,1,1,170,1358,1188
7659,1,0,17,0,-17
7660,0,0,157,0,-157
7661,1,1,586,1221,635
7662,1,1,353,1888,1535
7663,1,1,320,1312,992
7664,0,0,23,0,-23
7665,0,0,63,0,-63
7666,0,0,31,0,-31
7667,0,0,25,0,-25
7668,1,0,13,0,-13
7669,1,0,48,0,-48
7670,1,1,687,1341,654
7671,1,1,376,1322,946
7672,0,0,166,0,-166
7673,0,0,71,0,-71
7674,1,1,865,1473,608
7675,0,0,78,0,-78
7676,0,0,37,0,-37
7677,1,0,136,0,-136
7678,1,0,38,0,-38
7679,1,1,135,2880,2745
7680,0,0,104,0,-104
7681,0,0,23,0,-23
7682,1,0,34,0,-34
7683,1,1,228,1211,983
7684,1,0,6,0,-6
7685,1,1,385,1322,937
7686,1,0,4,0,-4
7687,0,0,114,0,-114
7688,0,0,124,0,-124
7689,0,0,24,0,-24
7690,0,0,59,0,-59
7691,1,0,119,0,-119
7692,0,0,75,0,-75
7693,1,1,447,1202,755
7694,1,0,1,0,-1
7695,1,1,564,1215,651
7696,0,0,51,0,-51
7697,1,1,370,3411,3041
7698,1,1,437,1417,980
7699,0,0,40,0,-40
7700,0,0,181,0,-181
7701,1,0,26,0,-26
7702,1,0,83,0,-83
7703,1,0,52,0,-52
7704,1,1,878,1385,507
7705,1,0,44,0,-44
7706,1,0,9,0,-9
7707,0,0,0,0,0
7708,1,0,0,0,0
7709,1,1,140,1442,1302
7710,1,1,988,1445,457
7711,1,0,15,0,-15
7712,1,1,320,2132,1812
7713,1,1,118,1260,1142
7714,0,0,64,0,-64
7715,0,0,72,0,-72
7716,1,1,19,1804,1785
7717,1,0,182,0,-182
7718,0,0,14,0,-14
7719,1,0,80,0,-80
7720,1,0,51,0,-51
7721,1,1,798,1331,533
7722,1,0,62,0,-62
7723,1,1,108,1208,1100
7724,1,1,2647,1650,-997
7725,0,0,19,0,-19
7726,1,1,69,1737,1668
7727,1,1,75,1258,1183
7728,0,0,13,0,-13
7729,0,0,21,0,-21
7730,0,0,17,0,-17
7731,0,0,5,0,-5
7732,1,0,94,0,-94
7733,0,0,24,0,-24
7734,0,0,28,0,-28
7735,1,0,43,0,-43
7736,0,0,67,0,-67
7737,0,0,57,0,-57
7738,1,0,6,0,-6
7739,1,1,105,1854,1749
7740,0,0,27,0,-27
7741,0,0,103,0,-103
7742,1,0,24,0,-24
7743,1,0,22,0,-22
7744,1,1,595,1394,799
7745,1,0,6,0,-6
7746,0,0,44,0,-44
7747,0,0,25,0,-25
7748,1,0,4,0,-4
7749,1,0,38,0,-38
7750,0,0,38,0,-38
7751,0,0,11,0,-11
7752,1,0,13,0,-13
7753,0,0,38,0,-38
7754,0,0,38,0,-38
7755,1,1,336,1361,1025
7756,1,1,279,1290,1011
7757,1,1,268,1420,1152
7758,1,1,27,1255,1228
7759,1,0,1,0,-1
7760,0,0,4,0,-4
7761,1,1,585,1225,640
7762,1,0,99,0,-99
7763,1,1,811,2269,1458
7764,1,0,40,0,-40
7765,1,0,67,0,-67
7766,1,0,2,0,-2
7767,0,0,35,0,-35
7768,1,1,68,1402,1334
7769,0,0,60,0,-60
7770,1,0,94,0,-94
7771,0,0,5,0,-5
7772,1,1,2733,1829,-904
7773,1,0,111,0,-111
7774,1,0,76,0,-76
7775,1,1,288,1884,1596
7776,1,1,449,1394,945
7777,0,0,39,0,-39
7778,1,1,1034,1329,295
7779,1,0,3,0,-3
7780,1,1,131,1769,1638
7781,1,0,177,0,-177
7782,0,0,6,0,-6
7783,0,0,80,0,-80
7784,0,0,39,0,-39
7785,0,0,14,0,-14
7786,1,0,73,0,-73
7787,1,1,67,1494,1427
7788,1,0,10,0,-10
7789,1,0,6,0,-6
7790,0,0,74,0,-74
7791,1,0,61,0,-61
7792,1,0,80,0,-80
7793,1,0,13,0,-13
7794,0,0,66,0,-66
7795,0,0,43,0,-43
7796,1,0,2,0,-2
7797,1,0,26,0,-26
7798,0,0,20,0,-20
7799,1,0,141,0,-141
7800,1,1,348,1324,976
7801,1,0,98,0,-98
7802,1,0,132,0,-132
7803,1,1,887,3250,2363
7804,0,0,41,0,-41
7805,1,1,449,1719,1270
7806,0,0,34,0,-34
7807,1,1,774,1845,1071
7808,1,0,103,0,-103
7809,0,0,13,0,-13
7810,0,0,6,0,-6
7811,1,0,8,0,-8
7812,0,0,69,0,-69
7813,1,0,8,0,-8
7814,1,1,1438,1330,-108
7815,0,0,29,0,-29
7816,1,0,2,0,-2
7817,1,1,671,1804,1133
7818,1,0,133,0,-133
7819,0,0,31,0,-31
7820,0,0,2,0,-2
7821,0,0,65,0,-65
7822,0,0,29,0,-29
7823,0,0,21,0,-21
7824,1,1,496,1439,943
7825,1,0,37,0,-37
7826,0,0,60,0,-60
7827,0,0,49,0,-49
7828,1,1,117,1263,1146
7829,1,1,677,1796,1119
7830,0,0,9,0,-9
7831,1,0,58,0,-58
7832,1,1,149,1595,1446
7833,0,0,6,0,-6
7834,1,1,303,1651,1348
7835,0,0,18,0,-18
7836,1,0,3,0,-3
7837,1,0,31,0,-31
7838,0,0,6,0,-6
7839,1,1,468,1323,855
7840,1,0,54,0,-54
7841,0,0,10,0,-10
7842,0,0,29,0,-29
7843,1,1,325,1689,1364
7844,1,1,1234,1643,409
7845,1,0,94,0,-94
7846,1,0,87,0,-87
7847,1,0,53,0,-53
7848,0,0,19,0,-19
7849,1,1,312,1366,1054
7850,1,0,60,0,-60
7851,1,0,32,0,-32
7852,0,0,23,0,-23
7853,1,1,871,1285,414
7854,1,0,35,0,-35
7855,1,0,13,0,-13
7856,0,0,64,0,-64
7857,0,0,23,0,-23
7858,0,0,81,0,-81
7859,1,1,55,1450,1395
7860,1,0,61,0,-61
7861,0,0,103,0,-103
7862,1,1,146,1203,1057
7863,1,1,201,1592,1391
7864,1,1,653,1357,704
7865,1,0,15,0,-15
7866,0,0,20,0,-20
7867,1,1,363,1218,855
7868,1,1,912,1505,593
7869,1,0,68,0,-68
7870,1,0,2,0,-2
7871,0,0,79,0,-79
7872,1,1,204,1864,1660
7873,1,0,30,0,-30
7874,1,0,27,0,-27
7875,0,0,77,0,-77
7876,1,1,186,1237,1051
7877,1,1,396,1334,938
7878,0,0,44,0,-44
7879,1,0,11,0,-11
7880,0,0,0,0,0
7881,1,1,235,1703,1468
7882,1,0,119,0,-119
7883,0,0,81,0,-81
7884,0,0,142,0,-142
7885,1,0,3,0,-3
7886,0,0,122,0,-122
7887,1,0,8,0,-8
7888,0,0,10,0,-10
7889,1,0,74,0,-74
7890,1,1,180,1302,1122
7891,0,0,14,0,-14
7892,0,0,198,0,-198
7893,0,0,65,0,-65
7894,1,1,440,1562,1122
7895,0,0,8,0,-8
7896,1,0,23,0,-23
7897,1,0,44,0,-44
7898,1,1,16,1883,1867
7899,1,0,13,0,-13
7900,0,0,2,0,-2
7901,1,0,18,0,-18
7902,0,0,3,0,-3
7903,1,0,226,0,-226
7904,0,0,51,0,-51
7905,1,1,910,1395,485
7906,0,0,2,0,-2
7907,1,1,114,1359,1245
7908,1,0,189,0,-189
7909,0,0,78,0,-78
7910,1,0,25,0,-25
7911,0,0,136,0,-136
7912,0,0,5,0,-5
7913,0,0,39,0,-39
7914,1,0,33,0,-33
7915,0,0,18,0,-18
7916,0,0,36,0,-36
7917,1,0,11,0,-11
7918,0,0,173,0,-173
7919,0,0,68,0,-68
7920,0,0,6,0,-6
7921,1,1,1904,1273,-631
7922,1,1,173,1588,1415
7923,0,0,38,0,-38
7924,0,0,185,0,-185
7925,0,0,31,0,-31
7926,1,1,1646,1696,50
7927,0,0,127,0,-127
7928,1,1,269,2932,2663
7929,1,0,66,0,-66
7930,1,0,30,0,-30
7931,1,0,35,0,-35
7932,0,0,9,0,-9
7933,1,1,212,1830,1618
7934,0,0,33,0,-33
7935,1,1,138,1286,1148
7936,0,0,6,0,-6
7937,1,1,53,3723,3670
7938,0,0,60,0,-60
7939,1,1,1599,5789,4190
7940,1,1,418,1540,1122
7941,0,0,28,0,-28
7942,1,0,78,0,-78
7943,0,0,195,0,-195
7944,0,0,12,0,-12
7945,0,0,67,0,-67
7946,1,1,708,1200,492
7947,0,0,69,0,-69
7948,1,0,3,0,-3
7949,0,0,10,0,-10
7950,1,1,1957,2054,97
7951,0,0,96,0,-96
7952,1,0,45,0,-45
7953,1,1,81,1348,1267
7954,0,0,75,0,-75
7955,1,0,65,0,-65
7956,0,0,27,0,-27
7957,1,1,435,1715,1280
7958,1,1,479,2680,2201
7959,0,0,21,0,-21
7960,1,1,380,1446,1066
7961,1,0,31,0,-31
7962,0,0,8,0,-8
7963,0,0,0,0,0
7964,0,0,46,0,-46
7965,1,0,8,0,-8
7966,0,0,32,0,-32
7967,0,0,3,0,-3
7968,1,0,22,0,-22
7969,0,0,76,0,-76
7970,0,0,15,0,-15
7971,1,1,1234,1213,-21
7972,1,1,106,1359,1253
7973,1,0,9,0,-9
7974,1,1,470,1543,1073
7975,1,0,4,0,-4
7976,1,1,753,1304,551
7977,1,0,107,0,-107
7978,0,0,13,0,-13
7979,1,1,122,1238,1116
7980,1,1,93,1282,1189
7981,1,0,24,0,-24
7982,1,1,314,2114,1800
7983,1,0,81,0,-81
7984,0,0,36,0,-36
7985,0,0,36,0,-36
7986,0,0,31,0,-31
7987,1,1,889,1396,507
7988,1,1,332,1224,892
7989,1,0,63,0,-63
7990,1,0,92,0,-92
7991,0,0,62,0,-62
7992,1,1,616,1337,721
7993,0,0,63,0,-63
7994,1,1,14,1958,1944
7995,1,0,54,0,-54
7996,1,0,28,0,-28
7997,1,1,841,1816,975
7998,1,1,807,1200,393
7999,1,1,349,1962,1613
8000,0,0,113,0,-113
8001,0,0,240,0,-240
8002,1,1,205,2101,1896
8003,0,0,10,0,-10
8004,1,1,60,1379,1319
8005,1,1,87,1499,1412
8006,1,0,25,0,-25
8007,0,0,4,0,-4
8008,0,0,38,0,-38
8009,0,0,64,0,-64
8010,1,0,84,0,-84
8011,0,0,69,0,-69
8012,0,0,82,0,-82
8013,0,0,35,0,-35
8014,1,0,36,0,-36
8015,1,1,655,1648,993
8016,1,0,26,0,-26
8017,1,0,35,0,-35
8018,0,0,156,0,-156
8019,1,1,286,1364,1078
8020,1,0,110,0,-110
8021,0,0,12,0,-12
8022,0,0,4,0,-4
8023,1,0,141,0,-141
8024,0,0,7,0,-7
8025,1,1,109,1212,1103
8026,0,0,82,0,-82
8027,0,0,23,0,-23
8028,1,1,602,2251,1649
8029,0,0,26,0,-26
8030,1,0,9,0,-9
8031,1,1,212,1224,1012
8032,1,1,726,1564,838
8033,1,1,217,1313,1096
8034,0,0,22,0,-22
8035,0,0,189,0,-189
8036,1,1,397,1420,1023
8037,0,0,44,0,-44
8038,1,0,1,0,-1
8039,1,1,108,1285,1177
8040,1,1,548,1511,963
8041,1,0,102,0,-102
8042,0,0,22,0,-22
8043,1,1,335,1418,1083
8044,1,1,1965,1426,-539
8045,1,1,426,1450,1024
8046,0,0,57,0,-57
8047,1,1,164,1209,1045
8048,1,1,767,1576,809
8049,1,1,996,1445,449
8050,0,0,22,0,-22
8051,1,1,260,1216,956
8052,1,0,5,0,-5
8053,0,0,27,0,-27
8054,1,1,717,3665,2948
8055,0,0,76,0,-76
8056,0,0,30,0,-30
8057,0,0,16,0,-16
8058,1,1,152,2060,1908
8059,1,1,375,2048,1673
8060,1,0,61,0,-61
8061,0,0,0,0,0
8062,0,0,60,0,-60
8063,0,0,17,0,-17
8064,1,1,444,1248,804
8065,1,0,12,0,-12
8066,0,0,124,0,-124
8067,0,0,0,0,0
8068,0,0,13,0,-13
8069,1,1,336,1700,1364
8070,1,0,58,0,-58
8071,0,0,63,0,-63
8072,1,0,3,0,-3
8073,1,0,39,0,-39
8074,1,0,24,0,-24
8075,1,0,24,0,-24
8076,1,0,125,0,-125
8077,0,0,29,0,-29
8078,0,0,18,0,-18
8079,0,0,48,0,-48
8080,1,1,315,1226,911
8081,1,0,34,0,-34
8082,1,0,33,0,-33
8083,1,0,16,0,-16
8084,0,0,14,0,-14
8085,1,0,63,0,-63
8086,1,1,45,3543,3498
8087,0,0,34,0,-34
8088,1,0,51,0,-51
8089,1,0,202,0,-202
8090,0,0,37,0,-37
8091,0,0,15,0,-15
8092,0,0,31,0,-31
8093,0,0,61,0,-61
8094,1,0,88,0,-88
8095,0,0,17,0,-17
8096,0,0,75,0,-75
8097,0,0,1,0,-1
8098,0,0,41,0,-41
8099,1,0,66,0,-66
8100,1,0,75,0,-75
8101,1,0,8,0,-8
8102,0,0,30,0,-30
8103,0,0,58,0,-58
8104,0,0,33,0,-33
8105,1,0,48,0,-48
8106,0,0,26,0,-26
8107,0,0,8,0,-8
8108,0,0,93,0,-93
8109,1,0,4,0,-4
8110,1,1,365,1532,1167
8111,1,1,273,1267,994
8112,0,0,200,0,-200
8113,1,0,0,0,0
8114,0,0,28,0,-28
8115,0,0,8,0,-8
8116,1,1,475,2656,2181
8117,0,0,15,0,-15
8118,1,0,40,0,-40
8119,1,1,1000,2849,1849
8120,0,0,80,0,-80
8121,0,0,21,0,-21
8122,1,1,119,1368,1249
8123,0,0,33,0,-33
8124,1,1,909,1272,363
8125,0,0,27,0,-27
8126,1,0,0,0,0
8127,1,1,494,2807,2313
8128,1,0,21,0,-21
8129,0,0,51,0,-51
8130,1,1,1392,1899,507
8131,1,0,11,0,-11
8132,1,1,326,1588,1262
8133,1,1,280,2052,1772
8134,0,0,65,0,-65
8135,0,0,34,0,-34
8136,0,0,47,0,-47
8137,1,1,127,1351,1224
8138,1,1,122,1379,1257
8139,1,1,358,1207,849
8140,0,0,9,0,-9
8141,1,1,139,1996,1857
8142,0,0,63,0,-63
8143,0,0,24,0,-24
8144,0,0,5,0,-5
8145,0,0,86,0,-86
8146,1,0,18,0,-18
8147,1,1,3109,1312,-1797
8148,0,0,54,0,-54
8149,0,0,73,0,-73
8150,1,0,56,0,-56
8151,1,1,171,1560,1389
8152,1,0,40,0,-40
8153,0,0,43,0,-43
8154,1,0,13,0,-13
8155,1,1,358,1750,1392
8156,1,1,1338,1326,-12
8157,0,0,126,0,-126
8158,0,0,14,0,-14
8159,0,0,3,0,-3
8160,0,0,10,0,-10
8161,1,0,0,0,0
8162,1,1,708,2857,2149
8163,1,0,29,0,-29
8164,1,0,4,0,-4
8165,0,0,105,0,-105
8166,1,0,145,0,-145
8167,1,1,423,1660,1237
8168,1,1,213,1894,1681
8169,0,0,1,0,-1
8170,1,1,1106,1442,336
8171,1,1,600,1273,673
8172,0,0,49,0,-49
8173,1,0,24,0,-24
8174,1,0,40,0,-40
8175,0,0,31,0,-31
8176,0,0,36,0,-36
8177,0,0,29,0,-29
8178,0,0,75,0,-75
8179,1,1,1281,1317,36
8180,1,1,219,1225,1006
8181,1,0,22,0,-22
8182,1,1,479,1679,1200
8183,0,0,13,0,-13
8184,1,1,760,1317,557
8185,0,0,9,0,-9
8186,1,1,20,1834,1814
8187,1,0,131,0,-131
8188,0,0,4,0,-4
8189,1,1,322,1279,957
8190,0,0,59,0,-59
8191,1,0,46,0,-46
8192,1,1,667,1941,1274
8193,0,0,10,0,-10
8194,1,1,24,1423,1399
8195,0,0,60,0,-60
8196,1,0,106,0,-106
8197,0,0,28,0,-28
8198,0,0,79,0,-79
8199,0,0,20,0,-20
8200,0,0,142,0,-142
8201,1,0,25,0,-25
8202,1,0,86,0,-86
8203,0,0,18,0,-18
8204,1,1,871,1286,415
8205,1,0,17,0,-17
8206,0,0,35,0,-35
8207,1,0,13,0,-13
8208,1,0,66,0,-66
8209,1,0,50,0,-50
8210,0,0,3,0,-3
8211,1,1,89,1597,1508
8212,1,0,78,0,-78
8213,1,1,111,1295,1184
8214,0,0,25,0,-25
8215,1,0,198,0,-198
8216,0,0,14,0,-14
8217,1,1,10,1282,1272
8218,0,0,118,0,-118
8219,1,0,67,0,-67
8220,0,0,107,0,-107
8221,1,1,935,1626,691
8222,1,1,1077,1332,255
8223,0,0,10,0,-10
8224,0,0,43,0,-43
8225,1,1,372,1396,1024
8226,1,0,13,0,-13
8227,1,1,211,1680,1469
8228,0,0,21,0,-21
8229,1,1,421,1330,909
8230,1,1,952,2338,1386
8231,0,0,13,0,-13
8232,1,1,907,1211,304
8233,1,0,88,0,-88
8234,0,0,59,0,-59
8235,1,1,1043,1687,644
8236,1,1,404,1426,1022
8237,1,0,98,0,-98
8238,0,0,35,0,-35
8239,1,0,23,0,-23
8240,1,0,4,0,-4
8241,0,0,14,0,-14
8242,1,1,244,1254,1010
8243,1,0,103,0,-103
8244,1,1,119,1217,1098
8245,1,1,1067,1496,429
8246,0,0,16,0,-16
8247,0,0,9,0,-9
8248,1,0,150,0,-150
8249,0,0,141,0,-141
8250,1,1,330,1211,881
8251,0,0,17,0,-17
8252,1,0,174,0,-174
8253,0,0,68,0,-68
8254,1,0,19,0,-19
8255,0,0,88,0,-88
8256,0,0,79,0,-79
8257,0,0,1,0,-1
8258,1,0,75,0,-75
8259,0,0,41,0,-41
8260,1,1,463,1265,802
8261,0,0,3,0,-3
8262,1,1,481,1608,1127
8263,0,0,24,0,-24
8264,1,0,163,0,-163
8265,1,0,37,0,-37
8266,1,1,1030,2237,1207
8267,1,1,1032,1475,443
8268,0,0,41,0,-41
8269,1,0,190,0,-190
8270,1,1,221,2416,2195
8271,0,0,10,0,-10
8272,0,0,74,0,-74
8273,1,0,70,0,-70
8274,0,0,76,0,-76
8275,1,0,85,0,-85
8276,0,0,60,0,-60
8277,0,0,37,0,-37
8278,0,0,52,0,-52
8279,0,0,32,0,-32
8280,1,0,112,0,-112
8281,1,1,600,1985,1385
8282,0,0,9,0,-9
8283,1,0,17,0,-17
8284,1,0,0,0,0
8285,1,0,18,0,-18
8286,0,0,21,0,-21
8287,0,0,0,0,0
8288,1,0,26,0,-26
8289,1,1,261,1426,1165
8290,0,0,19,0,-19
8291,0,0,54,0,-54
8292,1,1,47,1285,1238
8293,1,1,1839,1208,-631
8294,1,1,483,1280,797
8295,0,0,58,0,-58
8296,1,1,210,1679,1469
8297,1,0,4,0,-4
8298,0,0,10,0,-10
8299,0,0,141,0,-141
8300,0,0,4,0,-4
8301,0,0,2,0,-2
8302,0,0,8,0,-8
8303,0,0,40,0,-40
8304,1,1,237,1446,1209
8305,1,1,1013,1792,779
8306,0,0,8,0,-8
8307,1,0,7,0,-7
8308,1,0,12,0,-12
8309,1,1,374,1798,1424
8310,0,0,11,0,-11
8311,1,1,1153,2333,1180
8312,0,0,0,0,0
8313,1,1,233,1205,972
8314,0,0,12,0,-12
8315,0,0,52,0,-52
8316,1,1,113,1376,1263
8317,1,0,75,0,-75
8318,0,0,75,0,-75
8319,1,1,211,1626,1415
8320,1,0,0,0,0
8321,1,1,182,1285,1103
8322,1,1,839,1268,429
8323,0,0,43,0,-43
8324,1,1,1361,2304,943
8325,1,1,1365,1357,-8
8326,1,1,205,1612,1407
8327,1,1,958,1242,284
8328,1,1,96,1238,1142
8329,0,0,162,0,-162
8330,0,0,14,0,-14
8331,1,0,70,0,-70
8332,0,0,22,0,-22
8333,0,0,54,0,-54
8334,0,0,25,0,-25
8335,0,0,6,0,-6
8336,1,1,437,2011,1574
8337,1,0,113,0,-113
8338,0,0,197,0,-197
8339,1,1,141,1209,1068
8340,1,0,25,0,-25
8341,1,0,24,0,-24
8342,1,0,45,0,-45
8343,0,0,9,0,-9
8344,1,1,220,1299,1079
8345,0,0,21,0,-21
8346,0,0,24,0,-24
8347,1,0,57,0,-57
8348,1,0,207,0,-207
8349,1,1,859,1214,355
8350,1,0,10,0,-10
8351,1,1,597,1471,874
8352,1,0,25,0,-25
8353,1,0,75,0,-75
8354,0,0,13,0,-13
8355,0,0,3,0,-3
8356,1,1,834,1216,382
8357,0,0,21,0,-21
8358,1,1,1175,1259,84
8359,0,0,3,0,-3
8360,0,0,55,0,-55
8361,1,1,717,1892,1175
8362,1,0,66,0,-66
8363,1,1,618,1279,661
8364,0,0,33,0,-33
8365,1,1,272,1443,1171
8366,1,0,30,0,-30
8367,1,1,165,1254,1089
8368,0,0,24,0,-24
8369,1,1,58,1495,1437
8370,1,1,567,1289,722
8371,1,0,105,0,-105
8372,1,0,75,0,-75
8373,1,1,210,1293,1083
8374,1,0,163,0,-163
8375,1,1,168,1376,1208
8376,1,1,87,2047,1960
8377,1,1,207,1209,1002
8378,1,1,660,5267,4607
8379,1,1,2099,1435,-664
8380,1,0,87,0,-87
8381,1,0,21,0,-21
8382,1,1,382,1223,841
8383,1,1,95,1931,1836
8384,1,0,201,0,-201
8385,0,0,36,0,-36
8386,0,0,252,0,-252
8387,0,0,18,0,-18
8388,1,1,389,1209,820
8389,1,0,55,0,-55
8390,0,0,83,0,-83
8391,1,1,478,1735,1257
8392,1,0,104,0,-104
8393,0,0,33,0,-33
8394,0,0,20,0,-20
8395,1,1,1897,1220,-677
8396,1,0,87,0,-87
8397,0,0,12,0,-12
8398,1,1,182,1667,1485
8399,1,0,1,0,-1
8400,0,0,71,0,-71
8401,0,0,2,0,-2
8402,0,0,44,0,-44
8403,0,0,76,0,-76
8404,1,1,719,1213,494
8405,1,1,64,1374,1310
8406,0,0,42,0,-42
8407,0,0,34,0,-34
8408,1,1,289,1232,943
8409,0,0,3,0,-3
8410,1,1,1236,1301,65
8411,1,0,41,0,-41
8412,0,0,34,0,-34
8413,1,0,66,0,-66
8414,1,0,14,0,-14
8415,0,0,73,0,-73
8416,1,0,95,0,-95
8417,1,1,236,1210,974
8418,1,1,110,2528,2418
8419,0,0,4,0,-4
8420,1,1,415,1316,901
8421,1,0,33,0,-33
8422,1,1,200,2112,1912
8423,0,0,6,0,-6
8424,0,0,1,0,-1
8425,1,0,3,0,-3
8426,1,1,1557,1274,-283
8427,0,0,23,0,-23
8428,0,0,15,0,-15
8429,1,1,67,1209,1142
8430,1,0,60,0,-60
8431,0,0,62,0,-62
8432,0,0,54,0,-54
8433,0,0,104,0,-104
8434,1,0,25,0,-25
8435,1,0,32,0,-32
8436,1,1,834,1453,619
8437,0,0,40,0,-40
8438,1,1,54,1213,1159
8439,1,1,168,1419,1251
8440,1,1,1192,1209,17
8441,0,0,5,0,-5
8442,1,1,1144,1392,248
8443,1,0,58,0,-58
8444,0,0,4,0,-4
8445,1,0,42,0,-42
8446,1,0,4,0,-4
8447,1,1,361,1490,1129
8448,0,0,13,0,-13
8449,1,0,29,0,-29
8450,1,0,74,0,-74
8451,0,0,119,0,-119
8452,1,0,1,0,-1
8453,1,1,303,1575,1272
8454,1,1,189,1203,1014
8455,0,0,43,0,-43
8456,1,1,57,2026,1969
8457,0,0,88,0,-88
8458,1,0,134,0,-134
8459,0,0,81,0,-81
8460,0,0,34,0,-34
8461,1,0,10,0,-10
8462,1,0,28,0,-28
8463,0,0,36,0,-36
8464,1,1,332,1509,1177
8465,0,0,9,0,-9
8466,0,0,113,0,-113
8467,1,0,148,0,-148
8468,0,0,45,0,-45
8469,0,0,70,0,-70
8470,1,1,174,1311,1137
8471,1,1,175,1868,1693
8472,0,0,5,0,-5
8473,1,0,60,0,-60
8474,1,1,302,1458,1156
8475,1,1,1202,1243,41
8476,1,0,22,0,-22
8477,1,1,286,1982,1696
8478,0,0,69,0,-69
8479,1,0,55,0,-55
8480,1,1,84,1343,1259
8481,0,0,4,0,-4
8482,1,1,278,2170,1892
8483,1,1,120,1353,1233
8484,1,1,1819,1364,-455
8485,1,0,13,0,-13
8486,1,0,58,0,-58
8487,0,0,8,0,-8
8488,0,0,10,0,-10
8489,1,0,31,0,-31
8490,0,0,7,0,-7
8491,1,0,23,0,-23
8492,1,0,5,0,-5
8493,1,1,31,1690,1659
8494,1,1,475,1645,1170
8495,0,0,64,0,-64
8496,1,1,981,2619,1638
8497,1,1,33,1231,1198
8498,0,0,59,0,-59
8499,1,1,786,2546,1760
8500,1,1,831,2312,1481
8501,0,0,18,0,-18
8502,1,1,1194,1744,550
8503,1,0,3,0,-3
8504,1,1,908,1211,303
8505,0,0,59,0,-59
8506,1,1,345,2039,1694
8507,1,1,268,2019,1751
8508,1,1,545,1226,681
8509,0,0,171,0,-171
8510,1,1,442,2019,1577
8511,1,0,10,0,-10
8512,1,0,5,0,-5
8513,0,0,1,0,-1
8514,0,0,78,0,-78
8515,1,1,304,1555,1251
8516,1,1,1139,1216,77
8517,0,0,9,0,-9
8518,0,0,77,0,-77
8519,0,0,23,0,-23
8520,1,0,40,0,-40
8521,1,1,644,1513,869
8522,0,0,53,0,-53
8523,0,0,22,0,-22
8524,1,1,123,1664,1541
8525,0,0,27,0,-27
8526,1,0,9,0,-9
8527,0,0,151,0,-151
8528,1,0,7,0,-7
8529,0,0,185,0,-185
8530,1,0,38,0,-38
8531,0,0,17,0,-17
8532,1,1,213,1470,1257
8533,0,0,51,0,-51
8534,1,1,189,1280,1091
8535,1,0,25,0,-25
8536,0,0,23,0,-23
8537,0,0,32,0,-32
8538,1,1,679,2056,1377
8539,1,0,85,0,-85
8540,1,1,376,1206,830
8541,0,0,39,0,-39
8542,1,1,705,1294,589
8543,0,0,132,0,-132
8544,0,0,33,0,-33
8545,0,0,36,0,-36
8546,1,0,21,0,-21
8547,1,0,17,0,-17
8548,1,0,63,0,-63
8549,0,0,29,0,-29
8550,1,0,28,0,-28
8551,1,0,58,0,-58
8552,1,0,75,0,-75
8553,1,1,836,2068,1232
8554,0,0,1,0,-1
8555,0,0,70,0,-70
8556,1,0,20,0,-20
8557,1,1,462,1412,950
8558,0,0,11,0,-11
8559,1,1,820,1312,492
8560,0,0,36,0,-36
8561,1,1,1756,1453,-303
8562,1,0,32,0,-32
8563,1,1,119,1576,1457
8564,1,1,1477,1508,31
8565,1,0,7,0,-7
8566,0,0,246,0,-246
8567,0,0,109,0,-109
8568,0,0,143,0,-143
8569,1,0,98,0,-98
8570,0,0,18,0,-18
8571,1,1,296,1556,1260
8572,1,0,65,0,-65
8573,1,0,49,0,-49
8574,1,1,556,1429,873
8575,0,0,17,0,-17
8576,1,0,33,0,-33
8577,0,0,15,0,-15
8578,1,0,9,0,-9
8579,0,0,28,0,-28
8580,1,0,10,0,-10
8581,0,0,77,0,-77
8582,1,0,68,0,-68
8583,1,1,125,1838,1713
8584,1,1,180,2354,2174
8585,0,0,59,0,-59
8586,0,0,67,0,-67
8587,1,0,12,0,-12
8588,0,0,57,0,-57
8589,0,0,4,0,-4
8590,0,0,7,0,-7
8591,1,1,808,1276,468
8592,0,0,7,0,-7
8593,1,1,199,1567,1368
8594,1,1,172,1472,1300
8595,1,0,28,0,-28
8596,0,0,22,0,-22
8597,1,0,72,0,-72
8598,1,1,415,1412,997
8599,0,0,37,0,-37
8600,1,0,104,0,-104
8601,1,0,11,0,-11
8602,1,0,216,0,-216
8603,1,1,251,1474,1223
8604,0,0,121,0,-121
8605,1,1,700,1863,1163
8606,0,0,15,0,-15
8607,0,0,48,0,-48
8608,0,0,87,0,-87
8609,0,0,16,0,-16
8610,0,0,0,0,0
8611,0,0,5,0,-5
8612,0,0,15,0,-15
8613,1,0,48,0,-48
8614,0,0,26,0,-26
8615,1,1,283,3683,3400
8616,0,0,9,0,-9
8617,0,0,6,0,-6
8618,0,0,54,0,-54
8619,1,0,20,0,-20
8620,0,0,56,0,-56
8621,1,0,42,0,-42
8622,0,0,17,0,-17
8623,0,0,12,0,-12
8624,0,0,54,0,-54
8625,0,0,23,0,-23
8626,1,0,8,0,-8
8627,0,0,36,0,-36
8628,0,0,29,0,-29
8629,1,0,48,0,-48
8630,1,1,71,1258,1187
8631,1,1,450,1384,934
8632,1,1,221,1653,1432
8633,1,1,160,1243,1083
8634,0,0,12,0,-12
8635,1,0,48,0,-48
8636,0,0,62,0,-62
8637,0,0,29,0,-29
8638,1,0,55,0,-55
8639,0,0,16,0,-16
8640,0,0,55,0,-55
8641,1,0,17,0,-17
8642,1,0,104,0,-104
8643,0,0,71,0,-71
8644,0,0,19,0,-19
8645,0,0,28,0,-28
8646,1,1,1151,1371,220
8647,1,1,574,1211,637
8648,1,1,130,1254,1124
8649,1,1,730,2111,1381
8650,1,0,7,0,-7
8651,0,0,113,0,-113
8652,1,0,62,0,-62
8653,1,0,32,0,-32
8654,1,0,28,0,-28
8655,0,0,29,0,-29
8656,1,1,366,1369,1003
8657,0,0,37,0,-37
8658,1,1,748,1649,901
8659,0,0,62,0,-62
8660,1,0,9,0,-9
8661,0,0,1,0,-1
8662,1,1,1436,1814,378
8663,0,0,6,0,-6
8664,1,0,129,0,-129
8665,1,1,824,1555,731
8666,1,1,1017,1309,292
8667,1,1,385,1258,873
8668,0,0,100,0,-100
8669,1,1,314,1498,1184
8670,1,1,372,1684,1312
8671,1,1,15,1215,1200
8672,1,1,534,1256,722
8673,1,0,80,0,-80
8674,1,0,6,0,-6
8675,1,1,189,1211,1022
8676,0,0,97,0,-97
8677,1,1,93,1674,1581
8678,1,0,70,0,-70
8679,0,0,4,0,-4
8680,1,1,349,1556,1207
8681,0,0,10,0,-10
8682,1,0,73,0,-73
8683,1,0,123,0,-123
8684,1,1,804,1463,659
8685,1,0,12,0,-12
8686,1,1,706,1375,669
8687,1,0,45,0,-45
8688,0,0,21,0,-21
8689,0,0,37,0,-37
8690,0,0,45,0,-45
8691,0,0,13,0,-13
8692,1,0,37,0,-37
8693,1,0,11,0,-11
8694,0,0,32,0,-32
8695,0,0,3,0,-3
8696,1,0,395,0,-395
8697,1,1,261,1272,1011
8698,1,1,391,1679,1288
8699,1,0,11,0,-11
8700,1,1,1012,1288,276
8701,1,1,824,1233,409
8702,1,1,224,1671,1447
8703,0,0,9,0,-9
8704,0,0,7,0,-7
8705,1,0,20,0,-20
8706,0,0,2,0,-2
8707,0,0,1,0,-1
8708,1,1,521,1272,751
8709,1,0,26,0,-26
8710,1,0,38,0,-38
8711,1,1,305,1350,1045
8712,0,0,21,0,-21
8713,1,0,115,0,-115
8714,1,0,334,0,-334
8715,0,0,1,0,-1
8716,1,1,326,1733,1407
8717,1,0,52,0,-52
8718,1,1,422,3774,3352
8719,0,0,21,0,-21
8720,1,0,57,0,-57
8721,1,1,326,2300,1974
8722,1,1,917,1772,855
8723,1,1,1573,1201,-372
8724,0,0,204,0,-204
8725,0,0,2,0,-2
8726,0,0,67,0,-67
8727,0,0,0,0,0
8728,0,0,97,0,-97
8729,1,0,41,0,-41
8730,0,0,138,0,-138
8731,1,0,178,0,-178
8732,1,1,541,2549,2008
8733,1,1,366,1631,1265
8734,1,0,34,0,-34
8735,0,0,11,0,-11
8736,0,0,76,0,-76
8737,0,0,66,0,-66
8738,0,0,11,0,-11
8739,1,1,466,1303,837
8740,1,0,61,0,-61
8741,1,1,188,2939,2751
8742,0,0,2,0,-2
8743,0,0,39,0,-39
8744,0,0,37,0,-37
8745,1,1,958,1521,563
8746,1,1,661,1252,591
8747,1,1,316,1296,980
8748,1,1,329,1481,1152
8749,0,0,34,0,-34
8750,0,0,9,0,-9
8751,1,0,17,0,-17
8752,1,0,67,0,-67
8753,0,0,20,0,-20
8754,1,1,861,1217,356
8755,1,0,18,0,-18
8756,0,0,42,0,-42
8757,1,1,435,1273,838
8758,1,1,1059,1778,719
8759,1,1,741,1364,623
8760,1,1,576,1299,723
8761,1,1,250,1302,1052
8762,0,0,34,0,-34
8763,0,0,20,0,-20
8764,1,0,43,0,-43
8765,0,0,65,0,-65
8766,0,0,48,0,-48
8767,0,0,87,0,-87
8768,1,1,1224,1241,17
8769,0,0,23,0,-23
8770,0,0,41,0,-41
8771,1,0,19,0,-19
8772,0,0,44,0,-44
8773,1,1,502,1347,845
8774,0,0,40,0,-40
8775,0,0,12,0,-12
8776,0,0,105,0,-105
8777,0,0,118,0,-118
8778,0,0,133,0,-133
8779,0,0,14,0,-14
8780,0,0,58,0,-58
8781,0,0,32,0,-32
8782,1,0,162,0,-162
8783,1,1,298,1318,1020
8784,1,1,2223,1570,-653
8785,1,1,321,1604,1283
8786,1,0,6,0,-6
8787,0,0,4,0,-4
8788,1,0,0,0,0
8789,1,0,11,0,-11
8790,0,0,20,0,-20
8791,0,0,164,0,-164
8792,1,1,172,1228,1056
8793,1,0,1,0,-1
8794,1,1,377,1799,1422
8795,1,1,190,1243,1053
8796,0,0,17,0,-17
8797,0,0,8,0,-8
8798,1,0,19,0,-19
8799,0,0,10,0,-10
8800,1,0,114,0,-114
8801,1,0,132,0,-132
8802,1,1,1137,1223,86
8803,1,0,32,0,-32
8804,1,1,605,1347,742
8805,1,1,1221,1224,3
8806,1,1,1010,1512,502
8807,1,1,90,1596,1506
8808,0,0,28,0,-28
8809,0,0,117,0,-117
8810,0,0,78,0,-78
8811,0,0,35,0,-35
8812,1,1,213,1318,1105
8813,1,0,1,0,-1
8814,1,0,48,0,-48
8815,1,0,316,0,-316
8816,0,0,11,0,-11
8817,1,1,118,1516,1398
8818,0,0,38,0,-38
8819,1,0,18,0,-18
8820,0,0,109,0,-109
8821,1,1,485,1330,845
8822,1,1,750,1893,1143
8823,0,0,10,0,-10
8824,1,0,92,0,-92
8825,0,0,133,0,-133
8826,1,0,13,0,-13
8827,1,0,16,0,-16
8828,0,0,97,0,-97
8829,0,0,11,0,-11
8830,0,0,75,0,-75
8831,1,1,261,1477,1216
8832,1,1,262,1896,1634
8833,1,1,206,1759,1553
8834,1,1,1162,1240,78
8835,0,0,72,0,-72
8836,0,0,116,0,-116
8837,0,0,9,0,-9
8838,0,0,70,0,-70
8839,0,0,1,0,-1
8840,0,0,17,0,-17
8841,0,0,26,0,-26
8842,0,0,26,0,-26
8843,1,1,1299,1682,383
8844,1,1,807,1486,679
8845,0,0,1,0,-1
8846,1,0,31,0,-31
8847,1,0,10,0,-10
8848,1,0,31,0,-31
8849,1,1,71,2868,2797
8850,1,1,104,1440,1336
8851,1,1,67,1302,1235
8852,1,0,83,0,-83
8853,1,1,181,1434,1253
8854,1,0,3,0,-3
8855,1,1,451,1902,1451
8856,0,0,54,0,-54
8857,0,0,0,0,0
8858,0,0,70,0,-70
8859,0,0,42,0,-42
8860,1,1,609,1219,610
8861,1,0,22,0,-22
8862,0,0,71,0,-71
8863,0,0,47,0,-47
8864,1,0,21,0,-21
8865,1,0,53,0,-53
8866,0,0,8,0,-8
8867,0,0,6,0,-6
8868,1,1,682,1685,1003
8869,1,1,183,1374,1191
8870,1,0,6,0,-6
8871,1,1,743,2342,1599
8872,0,0,28,0,-28
8873,0,0,5,0,-5
8874,1,1,308,2721,2413
8875,0,0,4,0,-4
8876,1,0,58,0,-58
8877,1,1,1004,1494,490
8878,1,0,69,0,-69
8879,0,0,4,0,-4
8880,1,0,17,0,-17
8881,0,0,83,0,-83
8882,1,0,4,0,-4
8883,1,0,0,0,0
8884,1,0,79,0,-79
8885,1,0,44,0,-44
8886,0,0,14,0,-14
8887,0,0,133,0,-133
8888,1,0,15,0,-15
8889,0,0,31,0,-31
8890,1,1,812,1626,814
8891,1,0,84,0,-84
8892,0,0,8,0,-8
8893,0,0,50,0,-50
8894,1,1,468,1328,860
8895,0,0,1,0,-1
8896,0,0,7,0,-7
8897,0,0,82,0,-82
8898,0,0,69,0,-69
8899,1,0,19,0,-19
8900,1,1,1002,1670,668
8901,1,1,1372,1454,82
8902,1,1,116,1565,1449
8903,1,0,34,0,-34
8904,1,1,665,1264,599
8905,1,0,85,0,-85
8906,1,0,10,0,-10
8907,0,0,1,0,-1
8908,0,0,49,0,-49
8909,1,0,117,0,-117
8910,0,0,69,0,-69
8911,0,0,75,0,-75
8912,1,1,122,1449,1327
8913,0,0,9,0,-9
8914,0,0,61,0,-61
8915,1,1,267,1787,1520
8916,1,1,260,1470,1210
8917,0,0,80,0,-80
8918,1,0,192,0,-192
8919,1,0,19,0,-19
8920,1,0,15,0,-15
8921,0,0,49,0,-49
8922,1,1,517,1215,698
8923,0,0,62,0,-62
8924,0,0,133,0,-133
8925,0,0,2,0,-2
8926,1,1,1073,1604,531
8927,1,0,6,0,-6
8928,0,0,3,0,-3
8929,0,0,170,0,-170
8930,1,1,197,1491,1294
8931,1,0,136,0,-136
8932,1,0,17,0,-17
8933,1,1,2352,1550,-802
8934,0,0,70,0,-70
8935,1,0,60,0,-60
8936,1,0,16,0,-16
8937,0,0,45,0,-45
8938,0,0,80,0,-80
8939,1,0,109,0,-109
8940,0,0,52,0,-52
8941,1,0,1,0,-1
8942,0,0,77,0,-77
8943,0,0,55,0,-55
8944,0,0,17,0,-17
8945,0,0,5,0,-5
8946,0,0,130,0,-130
8947,1,0,75,0,-75
8948,1,1,949,1445,496
8949,0,0,42,0,-42
8950,0,0,42,0,-42
8951,1,0,134,0,-134
8952,0,0,49,0,-49
8953,1,1,762,1207,445
8954,0,0,40,0,-40
8955,1,0,14,0,-14
8956,1,1,82,1248,1166
8957,1,0,75,0,-75
8958,1,1,83,1261,1178
8959,0,0,7,0,-7
8960,1,1,419,1909,1490
8961,0,0,83,0,-83
8962,0,0,50,0,-50
8963,1,0,3,0,-3
8964,1,0,35,0,-35
8965,0,0,35,0,-35
8966,0,0,42,0,-42
8967,1,1,318,1484,1166
8968,0,0,3,0,-3
8969,0,0,20,0,-20
8970,1,1,194,1929,1735
8971,1,0,23,0,-23
8972,1,0,31,0,-31
8973,1,1,1137,2067,930
8974,1,1,503,2030,1527
8975,0,0,4,0,-4
8976,1,0,39,0,-39
8977,1,0,51,0,-51
8978,0,0,52,0,-52
8979,0,0,6,0,-6
8980,0,0,19,0,-19
8981,1,0,76,0,-76
8982,0,0,4,0,-4
8983,0,0,0,0,0
8984,0,0,111,0,-111
8985,1,1,1780,1709,-71
8986,0,0,22,0,-22
8987,1,0,26,0,-26
8988,1,1,155,2341,2186
8989,1,0,2,0,-2
8990,0,0,47,0,-47
8991,1,1,475,1329,854
8992,0,0,11,0,-11
8993,1,1,191,1257,1066
8994,1,1,304,2269,1965
8995,0,0,9,0,-9
8996,1,1,437,1320,883
8997,1,0,5,0,-5
8998,1,1,99,1435,1336
8999,0,0,6,0,-6
9000,1,1,486,1607,1121
9001,1,1,581,1947,1366
9002,0,0,7,0,-7
9003,1,0,12,0,-12
9004,0,0,16,0,-16
9005,1,1,251,1243,992
9006,1,1,783,1421,638
9007,0,0,65,0,-65
9008,0,0,8,0,-8
9009,0,0,13,0,-13
9010,1,1,904,1365,461
9011,0,0,4,0,-4
9012,0,0,163,0,-163
9013,0,0,20,0,-20
9014,1,1,541,1435,894
9015,0,0,17,0,-17
9016,1,0,139,0,-139
9017,0,0,180,0,-180
9018,0,0,52,0,-52
9019,0,0,44,0,-44
9020,0,0,130,0,-130
9021,1,1,250,1805,1555
9022,0,0,69,0,-69
9023,0,0,14,0,-14
9024,1,0,88,0,-88
9025,1,0,37,0,-37
9026,1,1,85,1238,1153
9027,1,0,17,0,-17
9028,1,1,1279,1367,88
9029,1,0,64,0,-64
9030,0,0,38,0,-38
9031,1,0,31,0,-31
9032,1,0,1,0,-1
9033,0,0,48,0,-48
9034,0,0,48,0,-48
9035,0,0,110,0,-110
9036,1,0,1,0,-1
9037,0,0,6,0,-6
9038,1,0,16,0,-16
9039,0,0,9,0,-9
9040,1,0,6,0,-6
9041,1,1,598,1360,762
9042,0,0,18,0,-18
9043,0,0,11,0,-11
9044,1,1,234,1217,983
9045,1,1,863,1324,461
9046,1,1,356,1772,1416
9047,1,0,21,0,-21
9048,1,0,17,0,-17
9049,1,1,2695,1413,-1282
9050,1,0,69,0,-69
9051,1,0,6,0,-6
9052,0,0,49,0,-49
9053,0,0,54,0,-54
9054,1,0,62,0,-62
9055,1,0,49,0,-49
9056,1,1,791,2152,1361
9057,0,0,1,0,-1
9058,1,0,92,0,-92
9059,0,0,95,0,-95
9060,0,0,1,0,-1
9061,1,1,181,1211,1030
9062,0,0,18,0,-18
9063,0,0,7,0,-7
9064,1,0,80,0,-80
9065,1,0,57,0,-57
9066,0,0,33,0,-33
9067,1,0,72,0,-72
9068,1,0,55,0,-55
9069,1,0,41,0,-41
9070,1,0,24,0,-24
9071,0,0,28,0,-28
9072,0,0,24,0,-24
9073,1,0,82,0,-82
9074,1,0,14,0,-14
9075,0,0,25,0,-25
9076,0,0,168,0,-168
9077,0,0,37,0,-37
9078,1,0,25,0,-25
9079,1,1,377,4803,4426
9080,0,0,139,0,-139
9081,0,0,5,0,-5
9082,1,1,218,1556,1338
9083,1,1,337,1512,1175
9084,1,0,55,0,-55
9085,1,1,220,1420,1200
9086,1,1,510,1688,1178
9087,1,0,6,0,-6
9088,1,1,267,1295,1028
9089,0,0,28,0,-28
9090,0,0,18,0,-18
9091,1,1,359,2338,1979
9092,1,0,66,0,-66
9093,1,1,1271,1412,141
9094,1,1,193,1864,1671
9095,1,0,18,0,-18
9096,1,1,71,1248,1177
9097,1,0,5,0,-5
9098,1,1,94,1204,1110
9099,0,0,43,0,-43
9100,1,1,421,1466,1045
9101,1,1,1144,1407,263
9102,1,0,59,0,-59
9103,1,1,794,1765,971
9104,1,1,36,1404,1368
9105,0,0,82,0,-82
9106,1,0,66,0,-66
9107,1,0,1,0,-1
9108,1,0,149,0,-149
9109,1,0,27,0,-27
9110,1,1,1104,2782,1678
9111,1,1,1661,1722,61
9112,0,0,8,0,-8
9113,1,0,13,0,-13
9114,0,0,22,0,-22
9115,1,0,56,0,-56
9116,1,1,585,1224,639
9117,1,1,150,1387,1237
9118,1,0,107,0,-107
9119,0,0,35,0,-35
9120,0,0,67,0,-67
9121,0,0,73,0,-73
9122,0,0,19,0,-19
9123,1,0,16,0,-16
9124,1,1,1185,1458,273
9125,0,0,11,0,-11
9126,0,0,33,0,-33
9127,1,0,24,0,-24
9128,1,1,24,1285,1261
9129,0,0,339,0,-339
9130,0,0,14,0,-14
9131,0,0,23,0,-23
9132,1,1,801,2612,1811
9133,1,1,442,1370,928
9134,1,0,12,0,-12
9135,0,0,130,0,-130
9136,1,1,570,2631,2061
9137,0,0,1,0,-1
9138,0,0,56,0,-56
9139,1,0,30,0,-30
9140,0,0,6,0,-6
9141,1,1,618,1820,1202
9142,0,0,81,0,-81
9143,0,0,19,0,-19
9144,0,0,121,0,-121
9145,1,1,283,1259,976
9146,1,0,50,0,-50
9147,1,1,430,2145,1715
9148,0,0,73,0,-73
9149,0,0,32,0,-32
9150,1,1,616,1897,1281
9151,1,1,868,1240,372
9152,1,0,32,0,-32
9153,1,1,23,1276,1253
9154,1,0,25,0,-25
9155,1,1,271,2030,1759
9156,1,0,69,0,-69
9157,0,0,104,0,-104
9158,1,1,152,1567,1415
9159,1,0,2,0,-2
9160,1,0,46,0,-46
9161,1,1,1477,1282,-195
9162,1,0,118,0,-118
9163,1,1,93,1641,1548
9164,1,1,420,1312,892
9165,1,1,343,1560,1217
9166,1,0,2,0,-2
9167,0,0,72,0,-72
9168,1,0,36,0,-36
9169,0,0,10,0,-10
9170,0,0,74,0,-74
9171,0,0,16,0,-16
9172,1,0,34,0,-34
9173,1,0,105,0,-105
9174,1,0,23,0,-23
9175,0,0,99,0,-99
9176,1,0,0,0,0
9177,1,1,896,2262,1366
9178,1,1,133,2145,2012
9179,0,0,219,0,-219
9180,1,0,209,0,-209
9181,1,0,52,0,-52
9182,1,1,173,2461,2288
9183,0,0,22,0,-22
9184,1,0,17,0,-17
9185,0,0,39,0,-39
9186,1,0,39,0,-39
9187,1,0,34,0,-34
9188,1,1,806,1358,552
9189,1,0,149,0,-149
9190,1,1,44,2084,2040
9191,0,0,62,0,-62
9192,1,0,25,0,-25
9193,1,0,36,0,-36
9194,0,0,28,0,-28
9195,0,0,7,0,-7
9196,1,0,72,0,-72
9197,1,0,34,0,-34
9198,0,0,2,0,-2
9199,0,0,21,0,-21
9200,0,0,25,0,-25
9201,0,0,0,0,0
9202,0,0,52,0,-52
9203,1,0,20,0,-20
9204,0,0,72,0,-72
9205,1,0,145,0,-145
9206,1,1,472,1560,1088
9207,1,1,649,1928,1279
9208,0,0,19,0,-19
9209,1,0,6,0,-6
9210,0,0,17,0,-17
9211,1,0,18,0,-18
9212,1,0,53,0,-53
9213,1,0,46,0,-46
9214,1,1,437,1310,873
9215,1,1,573,2080,1507
9216,0,0,9,0,-9
9217,0,0,127,0,-127
9218,1,1,282,1218,936
9219,1,0,30,0,-30
9220,1,1,1409,1240,-169
9221,1,0,65,0,-65
9222,0,0,148,0,-148
9223,0,0,33,0,-33
9224,1,1,987,1687,700
9225,1,0,33,0,-33
9226,1,0,36,0,-36
9227,0,0,25,0,-25
9228,1,0,49,0,-49
9229,1,1,1308,1214,-94
9230,1,1,522,1573,1051
9231,0,0,13,0,-13
9232,1,1,811,1826,1015
9233,0,0,160,0,-160
9234,1,0,243,0,-243
9235,1,1,332,1810,1478
9236,1,1,110,1887,1777
9237,0,0,63,0,-63
9238,1,0,55,0,-55
9239,0,0,84,0,-84
9240,0,0,55,0,-55
9241,1,0,68,0,-68
9242,1,1,1701,1288,-413
9243,1,1,122,1264,1142
9244,1,1,13,1652,1639
9245,1,1,838,1927,1089
9246,1,0,11,0,-11
9247,1,0,106,0,-106
9248,0,0,71,0,-71
9249,1,0,11,0,-11
9250,0,0,6,0,-6
9251,1,0,7,0,-7
9252,0,0,56,0,-56
9253,1,0,106,0,-106
9254,1,1,2016,1577,-439
9255,0,0,6,0,-6
9256,1,0,7,0,-7
9257,1,1,641,1470,829
9258,1,0,233,0,-233
9259,0,0,89,0,-89
9260,1,1,478,1258,780
9261,1,0,19,0,-19
9262,0,0,11,0,-11
9263,1,1,121,1893,1772
9264,0,0,2,0,-2
9265,0,0,83,0,-83
9266,0,0,75,0,-75
9267,0,0,9,0,-9
9268,1,1,865,1414,549
9269,1,0,60,0,-60
9270,0,0,9,0,-9
9271,1,0,57,0,-57
9272,1,1,91,1676,1585
9273,0,0,18,0,-18
9274,1,1,192,1736,1544
9275,0,0,7,0,-7
9276,0,0,44,0,-44
9277,0,0,23,0,-23
9278,0,0,64,0,-64
9279,1,0,115,0,-115
9280,0,0,209,0,-209
9281,1,0,9,0,-9
9282,0,0,16,0,-16
9283,1,1,1164,2360,1196
9284,1,0,99,0,-99
9285,1,1,312,1598,1286
9286,1,1,1116,1215,99
9287,1,1,1074,1443,369
9288,0,0,81,0,-81
9289,0,0,20,0,-20
9290,1,0,47,0,-47
9291,1,0,91,0,-91
9292,0,0,5,0,-5
9293,1,1,502,1393,891
9294,0,0,26,0,-26
9295,1,1,448,1274,826
9296,1,1,1187,1314,127
9297,1,0,9,0,-9
9298,1,1,78,1426,1348
9299,0,0,45,0,-45
9300,1,1,44,1280,1236
9301,1,1,1059,1691,632
9302,1,0,8,0,-8
9303,1,0,199,0,-199
9304,0,0,13,0,-13
9305,0,0,35,0,-35
9306,1,0,93,0,-93
9307,1,0,30,0,-30
9308,0,0,137,0,-137
9309,1,1,740,1814,1074
9310,0,0,246,0,-246
9311,1,1,1712,1731,19
9312,1,0,148,0,-148
9313,0,0,35,0,-35
9314,1,1,91,1220,1129
9315,1,0,36,0,-36
9316,0,0,17,0,-17
9317,0,0,11,0,-11
9318,1,0,5,0,-5
9319,1,1,924,1801,877
9320,0,0,54,0,-54
9321,0,0,81,0,-81
9322,0,0,80,0,-80
9323,1,1,469,1891,1422
9324,1,1,507,1457,950
9325,1,0,33,0,-33
9326,0,0,8,0,-8
9327,1,0,3,0,-3
9328,1,0,2,0,-2
9329,0,0,33,0,-33
9330,1,0,53,0,-53
9331,0,0,34,0,-34
9332,1,1,1206,1209,3
9333,0,0,106,0,-106
9334,1,0,46,0,-46
9335,1,1,634,1322,688
9336,1,1,1240,1245,5
9337,0,0,1,0,-1
9338,1,1,749,1445,696
9339,1,0,58,0,-58
9340,1,0,2,0,-2
9341,0,0,14,0,-14
9342,1,0,74,0,-74
9343,1,0,34,0,-34
9344,1,1,295,1894,1599
9345,1,0,43,0,-43
9346,1,1,191,1297,1106
9347,0,0,143,0,-143
9348,0,0,26,0,-26
9349,1,1,14,1299,1285
9350,1,0,114,0,-114
9351,1,0,59,0,-59
9352,1,1,383,1323,940
9353,1,0,13,0,-13
9354,1,1,1444,1208,-236
9355,0,0,89,0,-89
9356,1,0,16,0,-16
9357,1,0,79,0,-79
9358,0,0,173,0,-173
9359,0,0,5,0,-5
9360,1,0,3,0,-3
9361,1,0,20,0,-20
9362,1,0,30,0,-30
9363,1,0,38,0,-38
9364,1,0,59,0,-59
9365,1,0,14,0,-14
9366,1,1,1387,1299,-88
9367,0,0,4,0,-4
9368,1,1,826,1744,918
9369,1,0,11,0,-11
9370,0,0,45,0,-45
9371,0,0,138,0,-138
9372,0,0,81,0,-81
9373,1,0,216,0,-216
9374,1,0,9,0,-9
9375,1,1,282,2433,2151
9376,0,0,38,0,-38
9377,1,1,1142,1308,166
9378,1,0,8,0,-8
9379,1,0,38,0,-38
9380,1,0,62,0,-62
9381,0,0,26,0,-26
9382,1,0,13,0,-13
9383,0,0,39,0,-39
9384,1,1,723,1740,1017
9385,1,1,774,1271,497
9386,1,0,1,0,-1
9387,1,0,24,0,-24
9388,1,1,662,1799,1137
9389,0,0,65,0,-65
9390,1,1,763,1320,557
9391,1,1,220,1367,1147
9392,0,0,3,0,-3
9393,1,0,29,0,-29
9394,1,0,107,0,-107
9395,0,0,65,0,-65
9396,0,0,3,0,-3
9397,0,0,149,0,-149
9398,1,1,445,1491,1046
9399,0,0,1,0,-1
9400,1,0,13,0,-13
9401,1,0,37,0,-37
9402,1,0,25,0,-25
9403,1,1,408,1256,848
9404,0,0,55,0,-55
9405,1,0,18,0,-18
9406,0,0,60,0,-60
9407,1,0,31,0,-31
9408,1,1,848,1246,398
9409,0,0,103,0,-103
9410,1,1,74,1768,1694
9411,0,0,87,0,-87
9412,1,0,13,0,-13
9413,1,1,890,1407,517
9414,0,0,195,0,-195
9415,1,0,10,0,-10
9416,1,1,685,1236,551
9417,0,0,239,0,-239
9418,1,0,100,0,-100
9419,0,0,9,0,-9
9420,1,1,1047,1427,380
9421,0,0,50,0,-50
9422,1,0,9,0,-9
9423,0,0,1,0,-1
9424,1,1,267,1459,1192
9425,1,1,55,1230,1175
9426,0,0,5,0,-5
9427,1,0,20,0,-20
9428,0,0,21,0,-21
9429,1,1,358,1996,1638
9430,0,0,130,0,-130
9431,1,0,26,0,-26
9432,1,1,90,1590,1500
9433,0,0,11,0,-11
9434,1,0,41,0,-41
9435,0,0,113,0,-113
9436,1,1,195,1281,1086
9437,1,0,7,0,-7
9438,0,0,17,0,-17
9439,1,1,126,1241,1115
9440,0,0,0,0,0
9441,1,1,992,3013,2021
9442,1,0,6,0,-6
9443,0,0,30,0,-30
9444,1,1,899,1332,433
9445,1,0,135,0,-135
9446,0,0,33,0,-33
9447,1,0,0,0,0
9448,1,0,3,0,-3
9449,0,0,169,0,-169
9450,1,1,1138,1205,67
9451,1,1,42,1266,1224
9452,1,0,62,0,-62
9453,1,0,40,0,-40
9454,1,0,1,0,-1
9455,1,0,8,0,-8
9456,0,0,89,0,-89
9457,1,1,81,1279,1198
9458,1,1,173,1219,1046
9459,1,0,148,0,-148
9460,1,1,366,1236,870
9461,0,0,72,0,-72
9462,0,0,114,0,-114
9463,0,0,129,0,-129
9464,1,1,93,1258,1165
9465,0,0,19,0,-19
9466,0,0,109,0,-109
9467,0,0,88,0,-88
9468,1,0,31,0,-31
9469,1,1,0,1986,1986
9470,1,1,313,1853,1540
9471,1,1,1114,1316,202
9472,0,0,130,0,-130
9473,0,0,11,0,-11
9474,0,0,32,0,-32
9475,1,1,289,1304,1015
9476,0,0,161,0,-161
9477,1,0,14,0,-14
9478,0,0,48,0,-48
9479,1,0,5,0,-5
9480,0,0,36,0,-36
9481,1,1,1102,1483,381
9482,0,0,20,0,-20
9483,1,0,80,0,-80
9484,1,1,375,1428,1053
9485,1,0,33,0,-33
9486,1,0,27,0,-27
9487,1,0,290,0,-290
9488,1,1,2029,1346,-683
9489,1,0,40,0,-40
9490,1,0,5,0,-5
9491,1,1,802,1843,1041
9492,0,0,67,0,-67
9493,1,0,110,0,-110
9494,1,1,1334,2104,770
9495,1,1,790,1592,802
9496,1,1,429,1702,1273
9497,1,0,7,0,-7
9498,0,0,1,0,-1
9499,1,1,335,1240,905
9500,0,0,21,0,-21
9501,1,0,41,0,-41
9502,0,0,27,0,-27
9503,0,0,11,0,-11
9504,1,1,261,1520,1259
9505,1,1,40,1476,1436
9506,1,1,113,1370,1257
9507,0,0,45,0,-45
9508,1,1,570,1250,680
9509,0,0,84,0,-84
9510,1,0,23,0,-23
9511,1,1,1506,1285,-221
9512,1,1,669,1299,630
9513,0,0,34,0,-34
9514,1,0,47,0,-47
9515,0,0,18,0,-18
9516,0,0,11,0,-11
9517,1,1,1268,1455,187
9518,1,0,8,0,-8
9519,1,0,12,0,-12
9520,0,0,178,0,-178
9521,1,1,214,1472,1258
9522,1,0,8,0,-8
9523,0,0,18,0,-18
9524,0,0,130,0,-130
9525,0,0,42,0,-42
9526,0,0,38,0,-38
9527,1,0,9,0,-9
9528,0,0,0,0,0
9529,0,0,72,0,-72
9530,1,1,1017,1347,330
9531,0,0,30,0,-30
9532,1,1,1609,1490,-119
9533,1,1,218,1407,1189
9534,0,0,76,0,-76
9535,0,0,96,0,-96
9536,0,0,11,0,-11
9537,1,1,452,1716,1264
9538,1,0,4,0,-4
9539,0,0,32,0,-32
9540,0,0,44,0,-44
9541,1,1,453,1723,1270
9542,0,0,6,0,-6
9543,1,0,181,0,-181
9544,1,1,1067,1239,172
9545,1,1,742,1218,476
9546,0,0,25,0,-25
9547,1,1,291,1220,929
9548,1,0,9,0,-9
9549,0,0,104,0,-104
9550,1,0,1,0,-1
9551,1,0,26,0,-26
9552,1,1,204,1769,1565
9553,0,0,2,0,-2
9554,0,0,113,0,-113
9555,0,0,58,0,-58
9556,0,0,24,0,-24
9557,1,1,1454,1320,-134
9558,1,1,97,1278,1181
9559,0,0,40,0,-40
9560,1,1,41,1413,1372
9561,1,1,439,1270,831
9562,0,0,140,0,-140
9563,1,0,17,0,-17
9564,0,0,2,0,-2
9565,1,1,148,1292,1144
9566,0,0,97,0,-97
9567,1,1,844,1720,876
9568,1,0,24,0,-24
9569,1,1,164,1252,1088
9570,1,1,617,1550,933
9571,1,0,0,0,0
9572,0,0,28,0,-28
9573,0,0,9,0,-9
9574,1,0,33,0,-33
9575,1,1,711,1266,555
9576,0,0,23,0,-23
9577,1,1,1007,3173,2166
9578,1,1,28,1282,1254
9579,1,1,900,1410,510
9580,1,1,285,1573,1288
9581,1,0,18,0,-18
9582,1,1,499,1639,1140
9583,1,0,83,0,-83
9584,0,0,22,0,-22
9585,1,0,120,0,-120
9586,0,0,31,0,-31
9587,0,0,2,0,-2
9588,0,0,11,0,-11
9589,1,0,6,0,-6
9590,1,1,513,1629,1116
9591,1,1,327,1240,913
9592,1,1,349,1431,1082
9593,0,0,18,0,-18
9594,1,1,258,1393,1135
9595,1,1,279,1236,957
9596,1,0,23,0,-23
9597,1,1,150,1399,1249
9598,1,0,39,0,-39
9599,0,0,16,0,-16
9600,1,0,5,0,-5
9601,1,1,142,1282,1140
9602,0,0,98,0,-98
9603,0,0,2,0,-2
9604,1,1,382,1491,1109
9605,0,0,49,0,-49
9606,0,0,36,0,-36
9607,0,0,157,0,-157
9608,0,0,47,0,-47
9609,0,0,40,0,-40
9610,0,0,71,0,-71
9611,1,0,9,0,-9
9612,1,0,24,0,-24
9613,0,0,51,0,-51
9614,1,0,58,0,-58
9615,0,0,11,0,-11
9616,0,0,66,0,-66
9617,1,0,65,0,-65
9618,0,0,46,0,-46
9619,1,1,400,1232,832
9620,1,1,928,2799,1871
9621,1,0,17,0,-17
9622,1,0,29,0,-29
9623,0,0,103,0,-103
9624,1,1,321,1836,1515
9625,1,0,74,0,-74
9626,0,0,36,0,-36
9627,1,1,302,2424,2122
9628,1,0,108,0,-108
9629,0,0,114,0,-114
9630,1,1,52,1563,1511
9631,0,0,98,0,-98
9632,1,1,1614,2676,1062
9633,1,1,683,2172,1489
9634,0,0,11,0,-11
9635,1,0,97,0,-97
9636,0,0,30,0,-30
9637,1,0,31,0,-31
9638,0,0,19,0,-19
9639,1,1,234,1471,1237
9640,1,0,114,0,-114
9641,0,0,11,0,-11
9642,1,1,922,1513,591
9643,1,1,1289,1404,115
9644,0,0,64,0,-64
9645,0,0,27,0,-27
9646,1,0,28,0,-28
9647,1,1,403,2091,1688
9648,1,1,392,2355,1963
9649,1,1,305,2416,2111
9650,1,0,115,0,-115
9651,0,0,0,0,0
9652,1,0,62,0,-62
9653,0,0,24,0,-24
9654,1,0,8,0,-8
9655,0,0,33,0,-33
9656,0,0,171,0,-171
9657,0,0,224,0,-224
9658,1,1,269,3712,3443
9659,1,0,16,0,-16
9660,1,0,24,0,-24
9661,1,1,196,1402,1206
9662,1,0,5,0,-5
9663,1,1,475,1307,832
9664,1,1,230,2112,1882
9665,0,0,54,0,-54
9666,0,0,70,0,-70
9667,0,0,49,0,-49
9668,0,0,33,0,-33
9669,1,0,88,0,-88
9670,0,0,38,0,-38
9671,1,0,19,0,-19
9672,1,1,100,2162,2062
9673,0,0,56,0,-56
9674,1,0,1,0,-1
9675,1,0,6,0,-6
9676,1,1,1039,2031,992
9677,1,1,453,1279,826
9678,1,0,54,0,-54
9679,1,0,19,0,-19
9680,1,1,628,1233,605
9681,0,0,25,0,-25
9682,1,1,798,1295,497
9683,1,1,164,2142,1978
9684,1,1,294,1469,1175
9685,1,1,160,1376,1216
9686,1,1,148,1541,1393
9687,1,1,343,1948,1605
9688,1,0,48,0,-48
9689,1,1,172,1408,1236
9690,1,0,49,0,-49
9691,1,1,1442,1261,-181
9692,0,0,22,0,-22
9693,1,1,209,1300,1091
9694,1,0,92,0,-92
9695,1,1,222,2077,1855
9696,1,1,167,1485,1318
9697,0,0,22,0,-22
9698,0,0,0,0,0
9699,1,1,136,1790,1654
9700,1,1,92,1322,1230
9701,1,0,60,0,-60
9702,1,0,17,0,-17
9703,0,0,68,0,-68
9704,1,0,59,0,-59
9705,0,0,33,0,-33
9706,1,1,107,1339,1232
9707,0,0,5,0,-5
9708,1,0,59,0,-59
9709,1,0,14,0,-14
9710,1,1,609,1226,617
9711,0,0,47,0,-47
9712,1,1,846,1339,493
9713,1,1,1321,1263,-58
9714,1,1,1296,2229,933
9715,0,0,34,0,-34
9716,1,0,34,0,-34
9717,0,0,67,0,-67
9718,1,1,289,1637,1348
9719,1,1,122,1493,1371
9720,0,0,59,0,-59
9721,1,1,310,1251,941
9722,0,0,57,0,-57
9723,1,0,72,0,-72
9724,1,1,290,1223,933
9725,0,0,16,0,-16
9726,1,0,79,0,-79
9727,1,1,147,1399,1252
9728,1,1,157,1605,1448
9729,1,0,104,0,-104
9730,0,0,7,0,-7
9731,0,0,95,0,-95
9732,0,0,17,0,-17
9733,1,1,70,1204,1134
9734,1,1,2633,1330,-1303
9735,1,1,332,1248,916
9736,1,0,61,0,-61
9737,0,0,9,0,-9
9738,1,1,775,1245,470
9739,0,0,2,0,-2
9740,0,0,0,0,0
9741,0,0,22,0,-22
9742,0,0,74,0,-74
9743,0,0,7,0,-7
9744,1,0,185,0,-185
9745,0,0,256,0,-256
9746,1,1,628,1895,1267
9747,1,1,145,1648,1503
9748,1,0,304,0,-304
9749,1,0,45,0,-45
9750,0,0,41,0,-41
9751,1,0,65,0,-65
9752,1,1,197,1479,1282
9753,1,1,364,1279,915
9754,1,1,244,1415,1171
9755,1,0,24,0,-24
9756,0,0,67,0,-67
9757,1,1,258,1765,1507
9758,1,1,58,1307,1249
9759,1,1,193,1668,1475
9760,0,0,21,0,-21
9761,0,0,22,0,-22
9762,1,0,95,0,-95
9763,0,0,108,0,-108
9764,1,0,6,0,-6
9765,0,0,2,0,-2
9766,1,0,11,0,-11
9767,0,0,12,0,-12
9768,1,1,54,1559,1505
9769,0,0,106,0,-106
9770,1,0,2,0,-2
9771,0,0,31,0,-31
9772,0,0,0,0,0
9773,0,0,38,0,-38
9774,1,1,1642,1299,-343
9775,0,0,53,0,-53
9776,1,0,15,0,-15
9777,1,0,40,0,-40
9778,0,0,74,0,-74
9779,0,0,155,0,-155
9780,1,1,866,1334,468
9781,1,1,187,1217,1030
9782,0,0,51,0,-51
9783,1,1,1004,1467,463
9784,1,1,648,2087,1439
9785,1,1,636,3331,2695
9786,1,1,79,1632,1553
9787,1,1,632,1348,716
9788,1,0,25,0,-25
9789,0,0,8,0,-8
9790,1,0,0,0,0
9791,1,0,72,0,-72
9792,1,0,60,0,-60
9793,0,0,45,0,-45
9794,0,0,28,0,-28
9795,0,0,14,0,-14
9796,0,0,130,0,-130
9797,1,1,386,3420,3034
9798,1,0,51,0,-51
9799,1,0,20,0,-20
9800,0,0,10,0,-10
9801,1,1,739,1209,470
9802,1,0,105,0,-105
9803,1,0,19,0,-19
9804,0,0,33,0,-33
9805,1,0,330,0,-330
9806,0,0,65,0,-65
9807,1,0,26,0,-26
9808,1,1,513,1484,971
9809,1,1,1961,1655,-306
9810,1,0,28,0,-28
9811,0,0,23,0,-23
9812,0,0,11,0,-11
9813,0,0,4,0,-4
9814,0,0,2,0,-2
9815,0,0,11,0,-11
9816,1,0,16,0,-16
9817,1,1,1108,1561,453
9818,0,0,18,0,-18
9819,0,0,44,0,-44
9820,1,0,59,0,-59
9821,0,0,5,0,-5
9822,0,0,60,0,-60
9823,0,0,26,0,-26
9824,1,0,24,0,-24
9825,0,0,60,0,-60
9826,1,1,472,1717,1245
9827,0,0,131,0,-131
9828,1,0,10,0,-10
9829,0,0,11,0,-11
9830,1,0,27,0,-27
9831,1,0,0,0,0
9832,1,0,65,0,-65
9833,1,0,26,0,-26
9834,1,1,659,1447,788
9835,0,0,1,0,-1
9836,1,0,8,0,-8
9837,1,0,88,0,-88
9838,1,1,232,1212,980
9839,1,1,80,1687,1607
9840,1,0,150,0,-150
9841,1,0,12,0,-12
9842,1,1,286,1370,1084
9843,1,0,30,0,-30
9844,1,0,5,0,-5
9845,0,0,142,0,-142
9846,0,0,73,0,-73
9847,1,1,88,1237,1149
9848,1,0,61,0,-61
9849,0,0,30,0,-30
9850,1,0,32,0,-32
9851,0,0,30,0,-30
9852,0,0,11,0,-11
9853,1,1,405,1499,1094
9854,0,0,4,0,-4
9855,0,0,39,0,-39
9856,1,1,1658,2035,377
9857,1,0,73,0,-73
9858,0,0,61,0,-61
9859,0,0,4,0,-4
9860,0,0,87,0,-87
9861,1,1,187,1299,1112
9862,1,1,193,1779,1586
9863,0,0,1,0,-1
9864,0,0,6,0,-6
9865,1,0,9,0,-9
9866,1,1,169,1650,1481
9867,0,0,25,0,-25
9868,1,0,103,0,-103
9869,0,0,12,0,-12
9870,1,0,46,0,-46
9871,1,0,31,0,-31
9872,0,0,12,0,-12
9873,0,0,10,0,-10
9874,1,0,25,0,-25
9875,1,1,71,1252,1181
9876,1,1,669,1291,622
9877,1,0,12,0,-12
9878,0,0,145,0,-145
9879,1,0,81,0,-81
9880,1,0,168,0,-168
9881,0,0,25,0,-25
9882,1,0,1,0,-1
9883,0,0,26,0,-26
9884,0,0,85,0,-85
9885,1,0,60,0,-60
9886,1,0,19,0,-19
9887,1,0,6,0,-6
9888,1,0,105,0,-105
9889,0,0,203,0,-203
9890,1,0,46,0,-46
9891,1,1,96,1582,1486
9892,1,1,875,1230,355
9893,1,0,49,0,-49
9894,1,0,14,0,-14
9895,1,1,240,1574,1334
9896,0,0,69,0,-69
9897,1,1,611,2030,1419
9898,1,1,598,1587,989
9899,1,0,58,0,-58
9900,0,0,25,0,-25
9901,0,0,8,0,-8
9902,1,0,2,0,-2
9903,1,0,4,0,-4
9904,1,0,47,0,-47
9905,0,0,31,0,-31
9906,1,1,377,1348,971
9907,0,0,22,0,-22
9908,0,0,9,0,-9
9909,1,1,1619,1215,-404
9910,0,0,156,0,-156
9911,1,0,202,0,-202
9912,1,1,206,2376,2170
9913,1,1,1032,1240,208
9914,1,0,38,0,-38
9915,0,0,33,0,-33
9916,1,0,4,0,-4
9917,1,1,254,1340,1086
9918,1,1,820,1682,862
9919,0,0,73,0,-73
9920,0,0,5,0,-5
9921,0,0,1,0,-1
9922,1,1,723,1765,1042
9923,0,0,150,0,-150
9924,1,1,131,1545,1414
9925,1,0,45,0,-45
9926,1,0,17,0,-17
9927,1,0,41,0,-41
9928,1,1,356,1321,965
9929,1,1,643,2039,1396
9930,0,0,59,0,-59
9931,0,0,27,0,-27
9932,1,0,49,0,-49
9933,1,1,1121,1256,135
9934,0,0,20,0,-20
9935,1,0,0,0,0
9936,0,0,23,0,-23
9937,1,1,129,1280,1151
9938,0,0,24,0,-24
9939,0,0,7,0,-7
9940,1,1,201,1354,1153
9941,0,0,1,0,-1
9942,0,0,71,0,-71
9943,0,0,57,0,-57
9944,0,0,4,0,-4
9945,0,0,0,0,0
9946,1,1,312,1272,960
9947,1,1,558,1905,1347
9948,0,0,22,0,-22
9949,0,0,69,0,-69
9950,0,0,57,0,-57
9951,0,0,15,0,-15
9952,1,0,25,0,-25
9953,1,1,461,1349,888
9954,1,1,217,1426,1209
9955,1,0,75,0,-75
9956,1,0,63,0,-63
9957,0,0,57,0,-57
9958,1,1,926,2505,1579
9959,1,0,60,0,-60
9960,0,0,4,0,-4
9961,1,1,830,1408,578
9962,0,0,51,0,-51
9963,1,0,9,0,-9
9964,0,0,71,0,-71
9965,1,1,226,1268,1042
9966,1,1,687,1234,547
9967,1,0,0,0,0
9968,1,0,63,0,-63
9969,0,0,68,0,-68
9970,1,0,92,0,-92
9971,1,0,6,0,-6
9972,1,1,755,1285,530
9973,1,0,26,0,-26
9974,1,1,859,2767,1908
9975,0,0,137,0,-137
9976,1,1,1484,1254,-230
9977,1,1,368,1260,892
9978,0,0,66,0,-66
9979,1,0,47,0,-47
9980,1,0,13,0,-13
9981,1,1,344,1768,1424
9982,1,1,362,1495,1133
9983,1,0,62,0,-62
9984,1,0,95,0,-95
9985,1,0,3,0,-3
9986,1,1,214,1392,1178
9987,1,0,84,0,-84
9988,0,0,73,0,-73
9989,1,1,2077,1312,-765
9990,0,0,173,0,-173
9991,0,0,7,0,-7
9992,0,0,104,0,-104
9993,1,1,638,1574,936
9994,0,0,20,0,-20
9995,1,0,88,0,-88
9996,1,1,651,1224,573
9997,1,0,31,0,-31
9998,0,0,32,0,-32
9999,1,1,390,2029,1639
10000,0,0,1,0,-1
10001,1,0,42,0,-42
10002,1,0,41,0,-41
10003,0,0,13,0,-13
10004,1,1,100,1421,1321
10005,1,0,42,0,-42
10006,0,0,55,0,-55
10007,0,0,58,0,-58
10008,1,1,266,1626,1360
10009,1,1,1362,1516,154
10010,1,1,636,1217,581
10011,0,0,12,0,-12
10012,1,1,384,1979,1595
10013,0,0,16,0,-16
10014,1,0,61,0,-61
10015,0,0,12,0,-12
10016,1,1,455,2362,1907
10017,1,0,62,0,-62
10018,1,1,627,1216,589
10019,0,0,6,0,-6
10020,1,0,62,0,-62
10021,1,0,71,0,-71
10022,1,0,7,0,-7
10023,1,0,0,0,0
10024,0,0,122,0,-122
10025,1,1,575,1352,777
10026,1,0,30,0,-30
10027,0,0,9,0,-9
10028,0,0,24,0,-24
10029,0,0,51,0,-51
10030,1,0,226,0,-226
10031,1,1,4,1516,1512
10032,1,1,543,1480,937
10033,0,0,0,0,0
10034,0,0,75,0,-75
10035,1,1,1159,1614,455
10036,1,0,63,0,-63
10037,1,1,318,1492,1174
10038,0,0,95,0,-95
10039,1,0,5,0,-5
10040,1,1,939,2295,1356
10041,1,0,45,0,-45
10042,0,0,1,0,-1
10043,1,1,203,1391,1188
10044,0,0,14,0,-14
10045,0,0,192,0,-192
10046,1,0,15,0,-15
10047,1,1,726,2279,1553
10048,0,0,36,0,-36
10049,0,0,15,0,-15
10050,1,1,215,1641,1426
10051,0,0,119,0,-119
10052,0,0,80,0,-80
10053,0,0,5,0,-5
10054,1,0,42,0,-42
10055,1,1,124,2001,1877
10056,0,0,236,0,-236
10057,0,0,31,0,-31
10058,1,1,260,1408,1148
10059,0,0,127,0,-127
10060,0,0,15,0,-15
10061,1,1,129,1335,1206
10062,1,1,337,1362,1025
10063,0,0,18,0,-18
10064,1,1,113,1430,1317
10065,1,0,4,0,-4
10066,1,1,603,1520,917
10067,0,0,39,0,-39
10068,0,0,7,0,-7
10069,1,0,6,0,-6
10070,0,0,153,0,-153
10071,1,1,410,1237,827
10072,1,1,837,1335,498
10073,0,0,82,0,-82
10074,1,0,15,0,-15
10075,1,0,62,0,-62
10076,1,0,122,0,-122
10077,0,0,55,0,-55
10078,1,1,353,1543,1190
10079,1,0,50,0,-50
10080,0,0,32,0,-32
10081,1,1,510,1314,804
10082,1,1,561,3248,2687
10083,1,0,9,0,-9
10084,1,1,815,1518,703
10085,0,0,23,0,-23
10086,1,1,811,2048,1237
10087,1,1,2164,1298,-866
10088,0,0,45,0,-45
10089,0,0,46,0,-46
10090,1,0,100,0,-100
10091,0,0,38,0,-38
10092,1,1,481,1277,796
10093,1,0,24,0,-24
10094,1,1,114,1888,1774
10095,0,0,44,0,-44
10096,0,0,37,0,-37
10097,1,0,110,0,-110
10098,1,0,13,0,-13
10099,1,1,835,1239,404
10100,1,1,309,1273,964
10101,0,0,43,0,-43
10102,0,0,183,0,-183
10103,0,0,41,0,-41
10104,0,0,20,0,-20
10105,1,1,241,1257,1016
10106,1,0,35,0,-35
10107,1,0,121,0,-121
10108,1,0,21,0,-21
10109,1,0,84,0,-84
10110,1,1,292,2388,2096
10111,0,0,25,0,-25
10112,1,0,73,0,-73
10113,0,0,58,0,-58
10114,1,1,114,1749,1635
10115,1,0,183,0,-183
10116,1,0,147,0,-147
10117,1,0,20,0,-20
10118,1,0,66,0,-66
10119,0,0,96,0,-96
10120,1,1,255,1252,997
10121,0,0,475,0,-475
10122,0,0,17,0,-17
10123,1,1,233,1532,1299
10124,1,1,6,2089,2083
10125,1,1,25,1243,1218
10126,0,0,3,0,-3
10127,1,1,1196,1468,272
10128,0,0,85,0,-85
10129,0,0,32,0,-32
10130,1,1,562,1206,644
10131,1,0,58,0,-58
10132,1,0,1,0,-1
10133,1,1,86,1919,1833
10134,0,0,19,0,-19
10135,1,1,251,1600,1349
10136,1,0,18,0,-18
10137,1,0,85,0,-85
10138,0,0,35,0,-35
10139,1,1,386,1434,1048
10140,0,0,9,0,-9
10141,1,1,230,1449,1219
10142,1,0,4,0,-4
10143,1,0,3,0,-3
10144,1,1,801,2188,1387
10145,1,1,243,1525,1282
10146,0,0,34,0,-34
10147,1,1,925,1579,654
10148,1,1,113,1547,1434
10149,0,0,15,0,-15
10150,0,0,96,0,-96
10151,0,0,6,0,-6
10152,1,1,146,1284,1138
10153,0,0,38,0,-38
10154,0,0,29,0,-29
10155,0,0,38,0,-38
10156,0,0,42,0,-42
10157,1,0,48,0,-48
10158,1,0,45,0,-45
10159,0,0,33,0,-33
10160,1,1,354,1765,1411
10161,1,0,35,0,-35
10162,1,1,302,1557,1255
10163,1,1,45,1422,1377
10164,1,1,1017,1551,534
10165,1,1,2303,1592,-711
10166,0,0,4,0,-4
10167,1,1,567,1529,962
10168,0,0,4,0,-4
10169,0,0,0,0,0
10170,0,0,60,0,-60
10171,0,0,24,0,-24
10172,1,0,80,0,-80
10173,0,0,34,0,-34
10174,0,0,2,0,-2
10175,1,1,714,1645,931
10176,0,0,84,0,-84
10177,0,0,33,0,-33
10178,0,0,7,0,-7
10179,1,0,4,0,-4
10180,1,0,22,0,-22
10181,1,1,200,1289,1089
10182,0,0,13,0,-13
10183,1,1,68,2872,2804
10184,1,1,183,1548,1365
10185,0,0,12,0,-12
10186,1,1,554,1400,846
10187,1,0,10,0,-10
10188,1,1,163,1336,1173
10189,1,0,68,0,-68
10190,0,0,55,0,-55
10191,1,1,80,1630,1550
10192,1,1,436,1285,849
10193,1,1,865,1713,848
10194,1,1,202,1590,1388
10195,0,0,27,0,-27
10196,0,0,225,0,-225
10197,1,1,679,1848,1169
10198,0,0,29,0,-29
10199,0,0,84,0,-84
10200,1,0,50,0,-50
10201,0,0,81,0,-81
10202,1,1,129,2450,2321
10203,1,1,2493,1263,-1230
10204,0,0,73,0,-73
10205,1,0,21,0,-21
10206,0,0,54,0,-54
10207,1,1,484,2053,1569
10208,0,0,37,0,-37
10209,0,0,177,0,-177
10210,1,0,0,0,0
10211,1,1,874,1823,949
10212,1,0,18,0,-18
10213,0,0,63,0,-63
10214,0,0,42,0,-42
10215,1,0,3,0,-3
10216,1,1,112,1260,1148
10217,1,0,64,0,-64
10218,0,0,166,0,-166
10219,0,0,36,0,-36
10220,0,0,134,0,-134
10221,0,0,32,0,-32
10222,0,0,103,0,-103
10223,0,0,69,0,-69
10224,0,0,123,0,-123
10225,0,0,9,0,-9
10226,0,0,14,0,-14
10227,1,0,9,0,-9
10228,0,0,8,0,-8
10229,1,0,47,0,-47
10230,0,0,30,0,-30
10231,1,1,2676,1779,-897
10232,1,1,692,1201,509
10233,1,0,42,0,-42
10234,1,1,1279,2192,913
10235,1,0,40,0,-40
10236,0,0,6,0,-6
10237,1,0,42,0,-42
10238,1,1,523,1221,698
10239,0,0,5,0,-5
10240,1,1,371,1209,838
10241,1,0,47,0,-47
10242,1,1,879,1914,1035
10243,0,0,5,0,-5
10244,1,0,80,0,-80
10245,0,0,98,0,-98
10246,1,0,27,0,-27
10247,0,0,63,0,-63
10248,1,0,7,0,-7
10249,1,1,1020,1329,309
10250,1,1,135,1284,1149
10251,0,0,38,0,-38
10252,1,1,282,1757,1475
10253,1,1,446,1273,827
10254,1,0,22,0,-22
10255,0,0,136,0,-136
10256,1,0,3,0,-3
10257,1,1,106,1514,1408
10258,0,0,1,0,-1
10259,1,0,11,0,-11
10260,0,0,56,0,-56
10261,0,0,4,0,-4
10262,0,0,12,0,-12
10263,1,0,18,0,-18
10264,0,0,220,0,-220
10265,0,0,57,0,-57
10266,0,0,17,0,-17
10267,0,0,96,0,-96
10268,1,1,253,1883,1630
10269,0,0,1,0,-1
10270,0,0,1,0,-1
10271,1,0,140,0,-140
10272,1,1,524,1232,708
10273,1,1,492,1317,825
10274,0,0,49,0,-49
10275,0,0,47,0,-47
10276,0,0,99,0,-99
10277,1,0,9,0,-9
10278,0,0,13,0,-13
10279,1,1,75,2043,1968
10280,0,0,23,0,-23
10281,1,0,14,0,-14
10282,1,1,117,1473,1356
10283,0,0,68,0,-68
10284,1,0,12,0,-12
10285,1,0,28,0,-28
10286,1,1,37,1329,1292
10287,1,1,393,1847,1454
10288,0,0,25,0,-25
10289,0,0,44,0,-44
10290,1,0,1,0,-1
10291,0,0,26,0,-26
10292,0,0,90,0,-90
10293,0,0,57,0,-57
10294,1,1,1267,1787,520
10295,1,0,23,0,-23
10296,0,0,224,0,-224
10297,0,0,145,0,-145
10298,0,0,71,0,-71
10299,0,0,35,0,-35
10300,0,0,37,0,-37
10301,1,1,218,1315,1097
10302,0,0,12,0,-12
10303,1,0,49,0,-49
10304,1,1,527,1555,1028
10305,0,0,48,0,-48
10306,0,0,26,0,-26
10307,0,0,39,0,-39
10308,0,0,7,0,-7
10309,1,0,25,0,-25
10310,1,1,144,1313,1169
10311,1,1,588,1672,1084
10312,0,0,35,0,-35
10313,0,0,26,0,-26
10314,1,1,1827,1625,-202
10315,0,0,47,0,-47
10316,0,0,5,0,-5
10317,1,0,24,0,-24
10318,1,0,17,0,-17
10319,0,0,16,0,-16
10320,1,1,449,1788,1339
10321,0,0,45,0,-45
10322,0,0,27,0,-27
10323,1,1,1903,1457,-446
10324,0,0,120,0,-120
10325,1,0,85,0,-85
10326,1,0,112,0,-112
10327,0,0,2,0,-2
10328,1,0,21,0,-21
10329,0,0,45,0,-45
10330,0,0,43,0,-43
10331,1,1,116,1356,1240
10332,0,0,41,0,-41
10333,0,0,26,0,-26
10334,1,1,485,1257,772
10335,0,0,122,0,-122
10336,1,1,127,1485,1358
10337,0,0,154,0,-154
10338,0,0,70,0,-70
10339,0,0,49,0,-49
10340,1,0,4,0,-4
10341,1,0,66,0,-66
10342,1,0,108,0,-108
10343,1,0,5,0,-5
10344,1,1,161,1849,1688
10345,1,1,1639,1217,-422
10346,0,0,9,0,-9
10347,1,0,19,0,-19
10348,1,0,114,0,-114
10349,1,1,257,1497,1240
10350,1,0,26,0,-26
10351,1,0,169,0,-169
10352,1,0,50,0,-50
10353,1,1,271,1539,1268
10354,0,0,4,0,-4
10355,1,1,334,1385,1051
10356,1,1,679,1349,670
10357,1,1,19,1365,1346
10358,0,0,15,0,-15
10359,1,0,44,0,-44
10360,1,0,28,0,-28
10361,0,0,16,0,-16
10362,1,1,619,2116,1497
10363,1,0,110,0,-110
10364,1,0,2,0,-2
10365,0,0,65,0,-65
10366,1,0,39,0,-39
10367,1,0,118,0,-118
10368,1,1,700,1213,513
10369,0,0,53,0,-53
10370,1,0,96,0,-96
10371,1,0,253,0,-253
10372,0,0,2,0,-2
10373,0,0,81,0,-81
10374,0,0,8,0,-8
10375,0,0,51,0,-51
10376,1,1,325,1372,1047
10377,1,1,390,1499,1109
10378,1,1,1174,1346,172
10379,1,1,693,1241,548
10380,1,1,136,1526,1390
10381,0,0,222,0,-222
10382,0,0,38,0,-38
10383,0,0,2,0,-2
10384,1,0,139,0,-139
10385,0,0,175,0,-175
10386,0,0,128,0,-128
10387,0,0,23,0,-23
10388,1,0,97,0,-97
10389,1,0,31,0,-31
10390,1,0,85,0,-85
10391,1,0,26,0,-26
10392,1,1,103,1899,1796
10393,1,1,1084,1666,582
10394,0,0,182,0,-182
10395,1,0,13,0,-13
10396,1,0,36,0,-36
10397,1,1,78,2563,2485
10398,1,0,29,0,-29
10399,0,0,30,0,-30
10400,1,0,35,0,-35
10401,0,0,42,0,-42
10402,1,0,45,0,-45
10403,1,0,19,0,-19
10404,1,1,1668,1203,-465
10405,1,1,99,4339,4240
10406,1,1,739,1304,565
10407,0,0,12,0,-12
10408,1,0,31,0,-31
10409,1,1,733,1360,627
10410,1,0,10,0,-10
10411,0,0,61,0,-61
10412,1,1,248,2221,1973
10413,0,0,71,0,-71
10414,0,0,84,0,-84
10415,1,0,2,0,-2
10416,1,0,28,0,-28
10417,1,1,96,1609,1513
10418,0,0,118,0,-118
10419,0,0,20,0,-20
10420,1,1,194,1262,1068
10421,0,0,17,0,-17
10422,1,1,799,1402,603
10423,0,0,80,0,-80
10424,1,1,417,1368,951
10425,0,0,106,0,-106
10426,0,0,65,0,-65
10427,0,0,29,0,-29
10428,0,0,0,0,0
10429,0,0,89,0,-89
10430,1,0,8,0,-8
10431,1,0,117,0,-117
10432,1,0,66,0,-66
10433,0,0,18,0,-18
10434,0,0,30,0,-30
10435,0,0,13,0,-13
10436,0,0,43,0,-43
10437,1,1,627,3594,2967
10438,1,1,288,1303,1015
10439,0,0,104,0,-104
10440,0,0,49,0,-49
10441,0,0,91,0,-91
10442,0,0,4,0,-4
10443,1,1,263,1283,1020
10444,1,1,321,1534,1213
10445,1,1,692,1595,903
10446,1,1,67,1787,1720
10447,0,0,9,0,-9
10448,1,0,17,0,-17
10449,1,1,208,1564,1356
10450,0,0,41,0,-41
10451,0,0,59,0,-59
10452,1,1,1536,1256,-280
10453,1,1,365,1373,1008
10454,0,0,7,0,-7
10455,0,0,194,0,-194
10456,0,0,164,0,-164
10457,1,1,920,1606,686
10458,1,1,546,1573,1027
10459,0,0,33,0,-33
10460,0,0,22,0,-22
10461,1,0,17,0,-17
10462,0,0,6,0,-6
10463,1,1,346,1201,855
10464,1,0,7,0,-7
10465,0,0,4,0,-4
10466,0,0,25,0,-25
10467,0,0,43,0,-43
10468,1,0,217,0,-217
10469,1,0,22,0,-22
10470,0,0,28,0,-28
10471,1,1,613,1219,606
10472,0,0,42,0,-42
10473,1,0,26,0,-26
10474,0,0,97,0,-97
10475,0,0,4,0,-4
10476,1,1,176,1942,1766
10477,1,0,40,0,-40
10478,0,0,33,0,-33
10479,1,1,48,1577,1529
10480,0,0,32,0,-32
10481,1,0,74,0,-74
10482,0,0,14,0,-14
10483,1,0,0,0,0
10484,0,0,2,0,-2
10485,0,0,18,0,-18
10486,0,0,90,0,-90
10487,0,0,3,0,-3
10488,1,0,74,0,-74
10489,1,1,2829,1277,-1552
10490,1,0,60,0,-60
10491,0,0,231,0,-231
10492,1,0,27,0,-27
10493,1,1,1038,1300,262
10494,1,0,105,0,-105
10495,0,0,115,0,-115
10496,1,1,275,1359,1084
10497,1,1,191,1588,1397
10498,1,1,126,1428,1302
10499,1,0,1,0,-1
10500,0,0,11,0,-11
10501,1,0,25,0,-25
10502,1,0,21,0,-21
10503,0,0,19,0,-19
10504,0,0,27,0,-27
10505,0,0,10,0,-10
10506,1,0,101,0,-101
10507,1,0,4,0,-4
10508,1,1,275,1297,1022
10509,0,0,41,0,-41
10510,1,1,342,1749,1407
10511,0,0,67,0,-67
10512,1,1,123,1240,1117
10513,1,1,192,1524,1332
10514,1,1,804,1406,602
10515,1,1,288,1248,960
10516,1,0,88,0,-88
10517,0,0,14,0,-14
10518,1,0,77,0,-77
10519,1,0,41,0,-41
10520,1,1,474,1494,1020
10521,1,1,34,1348,1314
10522,1,1,750,1623,873
10523,0,0,31,0,-31
10524,1,1,218,1401,1183
10525,0,0,49,0,-49
10526,0,0,17,0,-17
10527,0,0,37,0,-37
10528,1,1,1423,1398,-25
10529,1,1,1055,1222,167
10530,1,1,503,1411,908
10531,1,0,75,0,-75
10532,1,1,1445,1370,-75
10533,1,1,125,1322,1197
10534,0,0,96,0,-96
10535,0,0,63,0,-63
10536,0,0,22,0,-22
10537,1,1,501,1251,750
10538,1,1,990,1282,292
10539,0,0,84,0,-84
10540,1,0,34,0,-34
10541,1,1,104,1667,1563
10542,1,1,317,1429,1112
10543,0,0,48,0,-48
10544,0,0,15,0,-15
10545,1,1,732,1217,485
10546,1,1,2139,1308,-831
10547,0,0,12,0,-12
10548,0,0,107,0,-107
10549,0,0,5,0,-5
10550,0,0,43,0,-43
10551,1,1,1392,2178,786
10552,1,1,630,1372,742
10553,1,1,116,1475,1359
10554,1,1,234,1286,1052
10555,1,0,25,0,-25
10556,0,0,43,0,-43
10557,1,0,77,0,-77
10558,0,0,31,0,-31
10559,1,1,169,2154,1985
10560,1,0,40,0,-40
10561,1,0,102,0,-102
10562,1,0,67,0,-67
10563,0,0,35,0,-35
10564,1,0,32,0,-32
10565,1,0,14,0,-14
10566,1,1,253,1293,1040
10567,1,1,183,1434,1251
10568,1,1,381,1248,867
10569,0,0,15,0,-15
10570,1,0,18,0,-18
10571,0,0,46,0,-46
10572,1,1,1147,1213,66
10573,1,1,865,1615,750
10574,1,1,672,1207,535
10575,0,0,142,0,-142
10576,1,1,363,1662,1299
10577,1,0,9,0,-9
10578,1,0,25,0,-25
10579,1,0,99,0,-99
10580,1,1,223,2203,1980
10581,1,0,16,0,-16
10582,1,0,80,0,-80
10583,1,1,110,1203,1093
10584,1,0,18,0,-18
10585,1,0,11,0,-11
10586,1,1,93,3909,3816
10587,1,1,100,2404,2304
10588,1,0,129,0,-129
10589,0,0,46,0,-46
10590,0,0,9,0,-9
10591,1,1,510,1204,694
10592,1,0,7,0,-7
10593,1,0,217,0,-217
10594,0,0,31,0,-31
10595,1,0,10,0,-10
10596,1,0,10,0,-10
10597,0,0,7,0,-7
10598,0,0,24,0,-24
10599,1,0,70,0,-70
10600,1,0,45,0,-45
10601,1,0,4,0,-4
10602,1,1,1786,1304,-482
10603,1,1,1016,1488,472
10604,1,0,22,0,-22
10605,1,1,94,1209,1115
10606,1,1,923,1694,771
10607,1,0,8,0,-8
10608,1,1,397,3409,3012
10609,0,0,90,0,-90
10610,0,0,3,0,-3
10611,1,0,20,0,-20
10612,1,1,170,2786,2616
10613,1,1,514,1736,1222
10614,0,0,65,0,-65
10615,1,0,3,0,-3
10616,1,0,44,0,-44
10617,0,0,1,0,-1
10618,1,1,1703,1228,-475
10619,0,0,121,0,-121
10620,1,0,36,0,-36
10621,0,0,44,0,-44
10622,1,0,3,0,-3
10623,0,0,4,0,-4
10624,1,0,3,0,-3
10625,0,0,102,0,-102
10626,1,1,102,1316,1214
10627,1,0,3,0,-3
10628,0,0,11,0,-11
10629,0,0,8,0,-8
10630,0,0,13,0,-13
10631,1,1,36,1403,1367
10632,0,0,62,0,-62
10633,0,0,40,0,-40
10634,1,1,196,1565,1369
10635,1,1,137,1327,1190
10636,1,0,2,0,-2
10637,0,0,16,0,-16
10638,1,0,8,0,-8
10639,0,0,35,0,-35
10640,1,1,704,1249,545
10641,0,0,106,0,-106
10642,0,0,23,0,-23
10643,0,0,5,0,-5
10644,1,0,43,0,-43
10645,0,0,3,0,-3
10646,1,1,708,1442,734
10647,0,0,0,0,0
10648,1,1,121,1901,1780
10649,1,0,61,0,-61
10650,0,0,26,0,-26
10651,1,0,83,0,-83
10652,1,1,256,1238,982
10653,1,0,24,0,-24
10654,1,0,53,0,-53
10655,0,0,20,0,-20
10656,1,1,367,1301,934
10657,1,0,16,0,-16
10658,0,0,42,0,-42
10659,1,1,837,1204,367
10660,1,0,33,0,-33
10661,0,0,34,0,-34
10662,1,1,554,1928,1374
10663,1,1,465,1274,809
10664,1,1,522,1655,1133
10665,1,0,14,0,-14
10666,1,1,764,1341,577
10667,1,0,1,0,-1
10668,0,0,35,0,-35
10669,0,0,41,0,-41
10670,0,0,15,0,-15
10671,1,0,25,0,-25
10672,1,0,6,0,-6
10673,0,0,15,0,-15
10674,0,0,6,0,-6
10675,0,0,0,0,0
10676,1,0,77,0,-77
10677,0,0,29,0,-29
10678,0,0,83,0,-83
10679,1,0,1,0,-1
10680,0,0,41,0,-41
10681,1,1,872,1201,329
10682,0,0,52,0,-52
10683,1,0,20,0,-20
10684,0,0,18,0,-18
10685,1,1,497,1240,743
10686,1,1,113,1287,1174
10687,1,0,30,0,-30
10688,1,1,100,2285,2185
10689,1,0,6,0,-6
10690,1,1,1031,1830,799
10691,0,0,110,0,-110
10692,1,0,139,0,-139
10693,0,0,74,0,-74
10694,1,0,80,0,-80
10695,0,0,6,0,-6
10696,1,1,314,1515,1201
10697,0,0,20,0,-20
10698,1,1,521,1203,682
10699,1,0,33,0,-33
10700,0,0,205,0,-205
10701,0,0,145,0,-145
10702,1,1,97,1452,1355
10703,0,0,4,0,-4
10704,0,0,25,0,-25
10705,1,1,132,1429,1297
10706,1,1,745,1266,521
10707,1,0,92,0,-92
10708,0,0,3,0,-3
10709,1,0,3,0,-3
10710,1,0,35,0,-35
10711,1,1,774,1378,604
10712,1,0,9,0,-9
10713,1,0,167,0,-167
10714,0,0,20,0,-20
10715,1,0,30,0,-30
10716,1,0,113,0,-113
10717,1,1,307,1469,1162
10718,1,1,567,1226,659
10719,1,0,6,0,-6
10720,1,0,70,0,-70
10721,1,0,0,0,0
10722,1,0,7,0,-7
10723,1,1,374,1553,1179
10724,0,0,12,0,-12
10725,1,0,0,0,0
10726,1,1,1756,1440,-316
10727,1,1,333,1562,1229
10728,0,0,9,0,-9
10729,0,0,75,0,-75
10730,1,0,21,0,-21
10731,1,0,3,0,-3
10732,1,0,87,0,-87
10733,1,0,35,0,-35
10734,1,1,691,1558,867
10735,0,0,11,0,-11
10736,1,1,2849,1936,-913
10737,0,0,3,0,-3
10738,0,0,37,0,-37
10739,0,0,19,0,-19
10740,0,0,103,0,-103
10741,0,0,46,0,-46
10742,1,0,48,0,-48
10743,1,0,45,0,-45
10744,1,1,340,1505,1165
10745,1,1,722,1472,750
10746,1,0,146,0,-146
10747,1,0,26,0,-26
10748,1,1,197,1653,1456
10749,1,0,7,0,-7
10750,0,0,117,0,-117
10751,1,1,145,1823,1678
10752,1,0,172,0,-172
10753,1,0,11,0,-11
10754,1,0,24,0,-24
10755,0,0,89,0,-89
10756,1,0,33,0,-33
10757,0,0,84,0,-84
10758,0,0,34,0,-34
10759,1,1,550,1385,835
10760,1,1,662,1383,721
10761,1,1,370,1622,1252
10762,1,1,564,1706,1142
10763,1,1,794,1621,827
10764,1,0,15,0,-15
10765,1,1,1156,2700,1544
10766,1,1,307,1421,1114
10767,1,0,60,0,-60
10768,1,1,717,1751,1034
10769,1,1,1721,1321,-400
10770,1,1,570,1887,1317
10771,1,0,1,0,-1
10772,0,0,33,0,-33
10773,1,1,971,1255,284
10774,0,0,67,0,-67
10775,1,1,2003,1854,-149
10776,1,1,467,1727,1260
10777,0,0,63,0,-63
10778,0,0,54,0,-54
10779,0,0,13,0,-13
10780,1,0,40,0,-40
10781,0,0,7,0,-7
10782,1,0,98,0,-98
10783,0,0,92,0,-92
10784,0,0,1,0,-1
10785,1,1,83,1486,1403
10786,1,1,229,1804,1575
10787,0,0,58,0,-58
10788,1,0,96,0,-96
10789,1,1,1664,1375,-289
10790,1,0,29,0,-29
10791,1,1,92,1712,1620
10792,1,1,1122,1242,120
10793,1,1,325,1669,1344
10794,0,0,26,0,-26
10795,0,0,135,0,-135
10796,1,0,8,0,-8
10797,1,0,4,0,-4
10798,0,0,37,0,-37
10799,1,1,370,1401,1031
10800,1,1,180,1269,1089
10801,1,0,13,0,-13
10802,1,0,48,0,-48
10803,0,0,291,0,-291
10804,1,0,5,0,-5
10805,1,1,925,1299,374
10806,1,0,78,0,-78
10807,1,1,714,1282,568
10808,1,0,2,0,-2
10809,1,1,429,2291,1862
10810,1,1,405,1298,893
10811,1,1,1513,1580,67
10812,0,0,10,0,-10
10813,1,0,6,0,-6
10814,0,0,2,0,-2
10815,0,0,178,0,-178
10816,1,0,0,0,0
10817,1,1,1103,1371,268
10818,1,0,32,0,-32
10819,0,0,0,0,0
10820,1,1,247,1906,1659
10821,1,1,152,1256,1104
10822,1,0,39,0,-39
10823,1,0,62,0,-62
10824,1,0,26,0,-26
10825,0,0,0,0,0
10826,0,0,150,0,-150
10827,1,1,668,1350,682
10828,1,1,188,1434,1246
10829,1,1,703,1244,541
10830,1,0,24,0,-24
10831,0,0,88,0,-88
10832,0,0,121,0,-121
10833,0,0,39,0,-39
10834,1,1,1130,1333,203
10835,0,0,21,0,-21
10836,0,0,274,0,-274
10837,1,1,641,1297,656
10838,1,1,353,1609,1256
10839,1,1,369,1224,855
10840,1,0,151,0,-151
10841,0,0,9,0,-9
10842,0,0,54,0,-54
10843,1,0,166,0,-166
10844,1,1,149,1419,1270
10845,0,0,10,0,-10
10846,1,1,59,1467,1408
10847,1,0,64,0,-64
10848,1,0,4,0,-4
10849,1,1,116,1676,1560
10850,0,0,21,0,-21
10851,1,1,208,4555,4347
10852,0,0,30,0,-30
10853,1,1,261,2032,1771
10854,0,0,105,0,-105
10855,0,0,2,0,-2
10856,1,0,47,0,-47
10857,1,0,186,0,-186
10858,1,0,5,0,-5
10859,1,1,312,1768,1456
10860,0,0,4,0,-4
10861,1,1,274,3432,3158
10862,1,1,5,1223,1218
10863,1,1,739,1311,572
10864,1,0,28,0,-28
10865,1,0,80,0,-80
10866,0,0,12,0,-12
10867,0,0,19,0,-19
10868,1,1,433,1258,825
10869,1,1,324,1218,894
10870,1,1,416,2929,2513
10871,1,1,333,1297,964
10872,1,0,202,0,-202
10873,0,0,9,0,-9
10874,1,1,1063,1658,595
10875,1,1,973,2615,1642
10876,0,0,9,0,-9
10877,1,1,659,1445,786
10878,0,0,66,0,-66
10879,1,0,9,0,-9
10880,0,0,73,0,-73
10881,1,0,35,0,-35
10882,0,0,14,0,-14
10883,1,1,371,3210,2839
10884,1,1,358,1608,1250
10885,0,0,23,0,-23
10886,0,0,58,0,-58
10887,0,0,51,0,-51
10888,1,1,1983,1366,-617
10889,0,0,4,0,-4
10890,1,1,740,1355,615
10891,1,0,7,0,-7
10892,0,0,12,0,-12
10893,1,0,12,0,-12
10894,0,0,2,0,-2
10895,0,0,18,0,-18
10896,1,0,1,0,-1
10897,0,0,3,0,-3
10898,1,1,824,1717,893
10899,0,0,50,0,-50
10900,1,1,555,1263,708
10901,1,0,2,0,-2
10902,1,1,406,1611,1205
10903,0,0,32,0,-32
10904,0,0,56,0,-56
10905,0,0,113,0,-113
10906,1,1,426,2136,1710
10907,1,1,270,1214,944
10908,1,0,65,0,-65
10909,0,0,23,0,-23
10910,1,0,137,0,-137
10911,0,0,16,0,-16
10912,0,0,140,0,-140
10913,0,0,37,0,-37
10914,0,0,85,0,-85
10915,1,1,193,1241,1048
10916,1,1,329,1772,1443
10917,0,0,0,0,0
10918,0,0,2,0,-2
10919,1,1,428,1263,835
10920,0,0,1,0,-1
10921,1,0,79,0,-79
10922,0,0,20,0,-20
10923,0,0,22,0,-22
10924,1,0,94,0,-94
10925,0,0,0,0,0
10926,0,0,32,0,-32
10927,1,1,123,1861,1738
10928,1,1,710,1212,502
10929,1,0,127,0,-127
10930,1,1,51,1720,1669
10931,0,0,33,0,-33
10932,1,0,77,0,-77
10933,1,1,784,1223,439
10934,0,0,21,0,-21
10935,0,0,53,0,-53
10936,1,0,6,0,-6
10937,0,0,36,0,-36
10938,0,0,49,0,-49
10939,0,0,125,0,-125
10940,1,1,66,1248,1182
10941,1,0,34,0,-34
10942,1,1,180,1228,1048
10943,1,0,28,0,-28
10944,1,1,1873,1651,-222
10945,1,0,70,0,-70
10946,1,0,32,0,-32
10947,1,0,12,0,-12
10948,1,0,29,0,-29
10949,1,1,464,1288,824
10950,0,0,1,0,-1
10951,1,1,2277,1403,-874
10952,1,1,66,1232,1166
10953,1,0,36,0,-36
10954,0,0,116,0,-116
10955,0,0,27,0,-27
10956,1,0,0,0,0
10957,0,0,26,0,-26
10958,0,0,77,0,-77
10959,1,0,63,0,-63
10960,1,0,171,0,-171
10961,1,0,6,0,-6
10962,0,0,62,0,-62
10963,1,0,23,0,-23
10964,0,0,1,0,-1
10965,0,0,7,0,-7
10966,1,1,1535,1298,-237
10967,0,0,204,0,-204
10968,0,0,0,0,0
10969,1,0,68,0,-68
10970,1,1,156,1281,1125
10971,0,0,2,0,-2
10972,1,1,298,1515,1217
10973,1,0,33,0,-33
10974,1,0,37,0,-37
10975,0,0,168,0,-168
10976,1,0,7,0,-7
10977,0,0,57,0,-57
10978,1,0,8,0,-8
10979,1,1,145,1251,1106
10980,0,0,86,0,-86
10981,0,0,3,0,-3
10982,0,0,48,0,-48
10983,0,0,14,0,-14
10984,0,0,100,0,-100
10985,1,0,11,0,-11
10986,0,0,37,0,-37
10987,1,0,8,0,-8
10988,0,0,8,0,-8
10989,1,0,34,0,-34
10990,1,1,218,1254,1036
10991,1,1,581,1633,1052
10992,1,1,735,1374,639
10993,1,1,36,1879,1843
10994,0,0,12,0,-12
10995,0,0,4,0,-4
10996,1,0,29,0,-29
10997,1,0,9,0,-9
10998,1,0,22,0,-22
10999,0,0,110,0,-110
11000,1,0,64,0,-64
11001,1,0,0,0,0
11002,0,0,11,0,-11
11003,1,1,1079,1497,418
11004,1,0,11,0,-11
11005,1,1,1742,1289,-453
11006,1,1,483,2044,1561
11007,1,0,0,0,0
11008,1,0,30,0,-30
11009,1,0,79,0,-79
11010,1,0,29,0,-29
11011,0,0,1,0,-1
11012,1,0,170,0,-170
11013,1,0,24,0,-24
11014,0,0,2,0,-2
11015,0,0,10,0,-10
11016,0,0,5,0,-5
11017,0,0,28,0,-28
11018,1,0,21,0,-21
11019,0,0,11,0,-11
11020,0,0,31,0,-31
11021,1,1,352,1325,973
11022,1,1,1084,3021,1937
11023,1,1,651,1205,554
11024,0,0,69,0,-69
11025,1,1,342,1459,1117
11026,0,0,55,0,-55
11027,1,1,671,1408,737
11028,1,1,235,1812,1577
11029,1,1,153,2112,1959
11030,1,0,22,0,-22
11031,1,1,2051,1206,-845
11032,1,0,21,0,-21
11033,0,0,62,0,-62
11034,0,0,24,0,-24
11035,1,0,10,0,-10
11036,1,0,13,0,-13
11037,1,0,46,0,-46
11038,0,0,41,0,-41
11039,1,0,11,0,-11
11040,1,0,20,0,-20
11041,0,0,37,0,-37
11042,0,0,36,0,-36
11043,0,0,20,0,-20
11044,1,1,116,1265,1149
11045,0,0,148,0,-148
11046,1,1,791,1568,777
11047,1,1,333,1368,1035
11048,1,0,58,0,-58
11049,0,0,55,0,-55
11050,0,0,52,0,-52
11051,0,0,55,0,-55
11052,1,0,5,0,-5
11053,1,0,2,0,-2
11054,1,0,206,0,-206
11055,1,0,124,0,-124
11056,1,0,36,0,-36
11057,1,0,17,0,-17
11058,1,1,452,1303,851
11059,1,0,1,0,-1
11060,0,0,12,0,-12
11061,1,0,22,0,-22
11062,0,0,74,0,-74
11063,1,1,84,1245,1161
11064,1,0,7,0,-7
11065,1,0,216,0,-216
11066,1,1,615,1543,928
11067,0,0,46,0,-46
11068,1,1,129,2540,2411
11069,0,0,141,0,-141
11070,0,0,76,0,-76
11071,0,0,36,0,-36
11072,1,1,205,1544,1339
11073,1,1,1196,1257,61
11074,0,0,38,0,-38
11075,1,1,1467,1651,184
11076,1,1,192,2057,1865
11077,1,1,255,1989,1734
11078,0,0,8,0,-8
11079,1,0,11,0,-11
11080,1,0,55,0,-55
11081,0,0,75,0,-75
11082,1,0,28,0,-28
11083,0,0,39,0,-39
11084,0,0,143,0,-143
11085,1,1,774,1645,871
11086,0,0,0,0,0
11087,1,1,1072,1425,353
11088,1,0,69,0,-69
11089,0,0,50,0,-50
11090,0,0,38,0,-38
11091,0,0,28,0,-28
11092,0,0,7,0,-7
11093,1,1,521,1251,730
11094,1,1,47,1299,1252
11095,1,1,492,1215,723
11096,0,0,57,0,-57
11097,1,1,191,1873,1682
11098,1,0,33,0,-33
11099,0,0,3,0,-3
11100,0,0,13,0,-13
11101,1,0,10,0,-10
11102,0,0,47,0,-47
11103,0,0,12,0,-12
11104,1,0,29,0,-29
11105,1,1,1660,1373,-287
11106,0,0,175,0,-175
11107,1,0,127,0,-127
11108,1,1,244,1219,975
11109,1,0,1,0,-1
11110,0,0,81,0,-81
11111,1,1,2317,1780,-537
11112,1,1,1284,2572,1288
11113,0,0,25,0,-25
11114,1,1,780,1408,628
11115,1,1,232,1536,1304
11116,1,1,817,1939,1122
11117,0,0,111,0,-111
11118,0,0,6,0,-6
11119,1,1,668,1250,582
11120,0,0,128,0,-128
11121,1,0,4,0,-4
11122,0,0,84,0,-84
11123,1,0,143,0,-143
11124,1,0,198,0,-198
11125,1,0,1,0,-1
11126,1,1,256,1476,1220
11127,1,0,14,0,-14
11128,1,0,5,0,-5
11129,1,1,919,1352,433
11130,1,0,33,0,-33
11131,1,0,16,0,-16
11132,1,0,50,0,-50
11133,1,0,4,0,-4
11134,0,0,47,0,-47
11135,0,0,46,0,-46
11136,0,0,21,0,-21
11137,1,1,420,1459,1039
11138,1,1,556,1241,685
11139,1,0,25,0,-25
11140,0,0,18,0,-18
11141,0,0,67,0,-67
11142,0,0,102,0,-102
11143,1,1,1015,1300,285
11144,1,1,125,1394,1269
11145,0,0,9,0,-9
11146,0,0,46,0,-46
11147,1,1,774,1416,642
11148,1,0,23,0,-23
11149,1,1,123,1332,1209
11150,0,0,3,0,-3
11151,0,0,25,0,-25
11152,0,0,152,0,-152
11153,0,0,37,0,-37
11154,0,0,32,0,-32
11155,0,0,5,0,-5
11156,1,1,88,1300,1212
11157,1,0,115,0,-115
11158,0,0,8,0,-8
11159,0,0,106,0,-106
11160,1,1,48,1752,1704
11161,0,0,119,0,-119
11162,0,0,11,0,-11
11163,1,1,778,1410,632
11164,1,1,216,1225,1009
11165,1,1,59,1575,1516
11166,1,1,130,1222,1092
11167,0,0,16,0,-16
11168,0,0,60,0,-60
11169,1,1,270,2339,2069
11170,1,0,61,0,-61
11171,1,1,123,1428,1305
11172,0,0,66,0,-66
11173,1,0,1,0,-1
11174,1,0,133,0,-133
11175,1,0,104,0,-104
11176,0,0,21,0,-21
11177,1,0,100,0,-100
11178,1,0,0,0,0
11179,0,0,36,0,-36
11180,0,0,52,0,-52
11181,0,0,137,0,-137
11182,0,0,97,0,-97
11183,1,0,78,0,-78
11184,1,1,1255,1630,375
11185,1,1,727,1267,540
11186,1,1,1096,1478,382
11187,1,1,295,1948,1653
11188,1,0,97,0,-97
11189,1,1,502,1766,1264
11190,1,1,52,1726,1674
11191,0,0,75,0,-75
11192,1,0,92,0,-92
11193,0,0,19,0,-19
11194,1,0,8,0,-8
11195,1,1,392,1300,908
11196,0,0,17,0,-17
11197,1,1,666,1468,802
11198,0,0,24,0,-24
11199,0,0,10,0,-10
11200,0,0,25,0,-25
11201,1,0,133,0,-133
11202,0,0,17,0,-17
11203,0,0,13,0,-13
11204,1,0,114,0,-114
11205,1,1,216,1417,1201
11206,1,1,13,1262,1249
11207,0,0,73,0,-73
11208,1,0,28,0,-28
11209,1,0,25,0,-25
11210,1,1,356,1608,1252
11211,0,0,8,0,-8
11212,1,1,374,1838,1464
11213,0,0,18,0,-18
11214,0,0,20,0,-20
11215,1,0,70,0,-70
11216,1,0,42,0,-42
11217,1,0,16,0,-16
11218,0,0,0,0,0
11219,0,0,91,0,-91
11220,0,0,75,0,-75
11221,1,1,389,2712,2323
11222,1,1,343,1598,1255
11223,0,0,16,0,-16
11224,0,0,10,0,-10
11225,0,0,15,0,-15
11226,1,0,18,0,-18
11227,1,0,32,0,-32
11228,0,0,58,0,-58
11229,1,1,1484,1258,-226
11230,1,1,999,1229,230
11231,1,0,5,0,-5
11232,0,0,17,0,-17
11233,1,0,41,0,-41
11234,1,1,987,1355,368
11235,1,0,76,0,-76
11236,1,0,18,0,-18
11237,1,0,81,0,-81
11238,1,1,975,1669,694
11239,0,0,3,0,-3
11240,1,0,39,0,-39
11241,1,0,7,0,-7
11242,1,1,365,1893,1528
11243,1,0,124,0,-124
11244,0,0,2,0,-2
11245,1,1,729,2543,1814
11246,0,0,42,0,-42
11247,1,1,301,1360,1059
11248,1,1,733,2265,1532
11249,0,0,3,0,-3
11250,0,0,62,0,-62
11251,1,1,2190,1530,-660
11252,1,1,286,1275,989
11253,0,0,42,0,-42
11254,1,1,320,1288,968
11255,1,1,65,1710,1645
11256,1,0,72,0,-72
11257,1,0,22,0,-22
11258,0,0,41,0,-41
11259,1,1,475,1392,917
11260,1,1,750,1359,609
11261,0,0,171,0,-171
11262,0,0,14,0,-14
11263,0,0,61,0,-61
11264,1,1,248,1636,1388
11265,1,1,1253,1359,106
11266,0,0,7,0,-7
11267,1,0,92,0,-92
11268,1,1,1245,1320,75
11269,1,1,177,1246,1069
11270,1,1,218,1203,985
11271,0,0,26,0,-26
11272,1,0,28,0,-28
11273,1,0,3,0,-3
11274,0,0,20,0,-20
11275,1,0,12,0,-12
11276,0,0,1,0,-1
11277,0,0,94,0,-94
11278,0,0,160,0,-160
11279,0,0,48,0,-48
11280,0,0,24,0,-24
11281,1,0,13,0,-13
11282,0,0,87,0,-87
11283,1,0,9,0,-9
11284,1,1,361,2129,1768
11285,1,1,305,1400,1095
11286,0,0,58,0,-58
11287,0,0,149,0,-149
11288,1,0,42,0,-42
11289,1,0,57,0,-57
11290,1,0,68,0,-68
11291,1,0,212,0,-212
11292,1,0,4,0,-4
11293,1,1,129,2719,2590
11294,1,1,498,1578,1080
11295,0,0,5,0,-5
11296,0,0,56,0,-56
11297,0,0,5,0,-5
11298,1,0,26,0,-26
11299,1,1,1072,2267,1195
11300,0,0,3,0,-3
11301,0,0,8,0,-8
11302,0,0,6,0,-6
11303,0,0,80,0,-80
11304,0,0,16,0,-16
11305,1,1,405,1761,1356
11306,1,0,59,0,-59
11307,0,0,15,0,-15
11308,1,1,424,1372,948
11309,1,0,41,0,-41
11310,0,0,46,0,-46
11311,0,0,56,0,-56
11312,1,1,530,1421,891
11313,1,1,1211,1280,69
11314,0,0,39,0,-39
11315,1,0,24,0,-24
11316,0,0,9,0,-9
11317,0,0,9,0,-9
11318,0,0,74,0,-74
11319,1,0,13,0,-13
11320,1,1,1097,1778,681
11321,1,0,44,0,-44
11322,0,0,11,0,-11
11323,1,1,1196,1662,466
11324,1,0,22,0,-22
11325,1,1,331,1569,1238
11326,1,1,95,1460,1365
11327,1,0,46,0,-46
11328,0,0,37,0,-37
11329,0,0,60,0,-60
11330,1,0,95,0,-95
11331,0,0,78,0,-78
11332,1,0,25,0,-25
11333,1,0,2,0,-2
11334,1,1,1285,1240,-45
11335,0,0,13,0,-13
11336,1,1,274,1595,1321
11337,0,0,2,0,-2
11338,1,1,1540,1281,-259
11339,0,0,7,0,-7
11340,1,1,343,1714,1371
11341,1,0,23,0,-23
11342,1,1,213,1478,1265
11343,1,1,395,2055,1660
11344,1,0,18,0,-18
11345,1,0,94,0,-94
11346,0,0,244,0,-244
11347,1,0,50,0,-50
11348,1,1,1020,1841,821
11349,0,0,0,0,0
11350,1,1,213,1229,1016
11351,1,0,5,0,-5
11352,1,0,66,0,-66
11353,1,1,295,1309,1014
11354,0,0,36,0,-36
11355,1,1,309,1464,1155
11356,1,1,72,1259,1187
11357,1,0,28,0,-28
11358,0,0,34,0,-34
11359,1,1,138,1303,1165
11360,1,1,347,1791,1444
11361,1,0,22,0,-22
11362,0,0,111,0,-111
11363,0,0,19,0,-19
11364,0,0,13,0,-13
11365,1,0,55,0,-55
11366,0,0,287,0,-287
11367,0,0,13,0,-13
11368,1,1,47,2426,2379
11369,1,0,23,0,-23
11370,0,0,256,0,-256
11371,0,0,32,0,-32
11372,1,0,0,0,0
11373,0,0,2,0,-2
11374,1,1,770,1392,622
11375,1,0,29,0,-29
11376,0,0,68,0,-68
11377,1,1,230,1272,1042
11378,0,0,60,0,-60
11379,1,0,8,0,-8
11380,0,0,157,0,-157
11381,0,0,127,0,-127
11382,0,0,77,0,-77
11383,1,1,153,1284,1131
11384,0,0,46,0,-46
11385,0,0,283,0,-283
11386,0,0,41,0,-41
11387,1,0,10,0,-10
11388,0,0,77,0,-77
11389,1,0,40,0,-40
11390,1,1,351,1400,1049
11391,1,0,40,0,-40
11392,1,0,110,0,-110
11393,0,0,54,0,-54
11394,1,0,4,0,-4
11395,1,1,464,1485,1021
11396,0,0,70,0,-70
11397,1,1,271,3155,2884
11398,1,1,234,1705,1471
11399,1,0,46,0,-46
11400,1,1,159,5942,5783
11401,0,0,42,0,-42
11402,1,1,1091,3017,1926
11403,1,1,477,4158,3681
11404,1,1,207,1313,1106
11405,0,0,5,0,-5
11406,0,0,4,0,-4
11407,1,0,36,0,-36
11408,0,0,23,0,-23
11409,0,0,88,0,-88
11410,1,0,61,0,-61
11411,1,0,62,0,-62
11412,0,0,17,0,-17
11413,0,0,23,0,-23
11414,1,1,12,2707,2695
11415,1,0,24,0,-24
11416,0,0,61,0,-61
11417,1,1,67,1888,1821
11418,0,0,2,0,-2
11419,0,0,71,0,-71
11420,1,0,16,0,-16
11421,0,0,40,0,-40
11422,1,1,265,1219,954
11423,0,0,1,0,-1
11424,0,0,47,0,-47
11425,1,0,30,0,-30
11426,0,0,63,0,-63
11427,1,0,37,0,-37
11428,0,0,234,0,-234
11429,1,0,30,0,-30
11430,0,0,104,0,-104
11431,0,0,1,0,-1
11432,1,1,99,1513,1414
11433,0,0,45,0,-45
11434,1,1,438,1236,798
11435,0,0,115,0,-115
11436,1,0,38,0,-38
11437,0,0,2,0,-2
11438,1,0,30,0,-30
11439,1,1,268,2227,1959
11440,1,1,403,1271,868
11441,0,0,28,0,-28
11442,1,1,466,1201,735
11443,1,1,264,1442,1178
11444,1,1,1483,1423,-60
11445,1,1,644,1440,796
11446,0,0,12,0,-12
11447,0,0,23,0,-23
11448,1,0,41,0,-41
11449,0,0,70,0,-70
11450,0,0,28,0,-28
11451,1,0,127,0,-127
11452,0,0,155,0,-155
11453,0,0,10,0,-10
11454,0,0,19,0,-19
11455,1,0,41,0,-41
11456,1,0,7,0,-7
11457,1,0,37,0,-37
11458,0,0,57,0,-57
11459,0,0,45,0,-45
11460,0,0,14,0,-14
11461,1,1,206,1256,1050
11462,0,0,31,0,-31
11463,1,0,28,0,-28
11464,1,1,247,1522,1275
11465,0,0,83,0,-83
11466,1,1,35,2326,2291
11467,1,0,104,0,-104
11468,0,0,13,0,-13
11469,0,0,98,0,-98
11470,0,0,13,0,-13
11471,1,0,60,0,-60
11472,0,0,9,0,-9
11473,1,0,22,0,-22
11474,0,0,15,0,-15
11475,0,0,59,0,-59
11476,0,0,9,0,-9
11477,1,1,221,1274,1053
11478,0,0,59,0,-59
11479,1,1,245,1395,1150
11480,1,1,191,1558,1367
11481,1,0,213,0,-213
11482,1,0,80,0,-80
11483,0,0,23,0,-23
11484,1,0,22,0,-22
11485,0,0,43,0,-43
11486,0,0,2,0,-2
11487,1,0,122,0,-122
11488,1,1,1109,1356,247
11489,1,0,67,0,-67
11490,1,0,11,0,-11
11491,1,0,56,0,-56
11492,0,0,41,0,-41
11493,0,0,100,0,-100
11494,1,0,13,0,-13
11495,0,0,71,0,-71
11496,1,0,15,0,-15
11497,0,0,77,0,-77
11498,1,0,33,0,-33
11499,1,0,10,0,-10
11500,1,1,128,1669,1541
11501,1,0,169,0,-169
11502,1,1,201,2072,1871
11503,1,0,20,0,-20
11504,0,0,83,0,-83
11505,1,1,279,1341,1062
11506,0,0,65,0,-65
11507,0,0,46,0,-46
11508,0,0,36,0,-36
11509,0,0,54,0,-54
11510,1,0,31,0,-31
11511,0,0,16,0,-16
11512,0,0,70,0,-70
11513,1,1,145,1459,1314
11514,1,1,1367,1250,-117
11515,1,1,1530,1886,356
11516,1,0,13,0,-13
11517,1,1,245,1282,1037
11518,1,1,896,1575,679
11519,1,0,5,0,-5
11520,1,0,3,0,-3
11521,1,0,103,0,-103
11522,0,0,20,0,-20
11523,1,1,954,1717,763
11524,1,1,638,1245,607
11525,1,0,1,0,-1
11526,0,0,60,0,-60
11527,0,0,49,0,-49
11528,1,0,15,0,-15
11529,1,0,16,0,-16
11530,1,1,162,1841,1679
11531,0,0,47,0,-47
11532,1,0,145,0,-145
11533,1,1,117,2040,1923
11534,1,0,37,0,-37
11535,0,0,79,0,-79
11536,0,0,88,0,-88
11537,1,1,295,1335,1040
11538,1,0,73,0,-73
11539,1,1,417,1299,882
11540,1,0,51,0,-51
11541,1,0,131,0,-131
11542,1,0,81,0,-81
11543,1,1,302,1225,923
11544,0,0,75,0,-75
11545,0,0,53,0,-53
11546,1,1,513,4696,4183
11547,0,0,9,0,-9
11548,1,0,71,0,-71
11549,1,0,35,0,-35
11550,0,0,38,0,-38
11551,1,1,162,1992,1830
11552,1,0,130,0,-130
11553,1,1,261,1363,1102
11554,0,0,24,0,-24
11555,1,0,50,0,-50
11556,0,0,32,0,-32
11557,1,0,16,0,-16
11558,1,1,218,1485,1267
11559,1,0,14,0,-14
11560,0,0,215,0,-215
11561,1,0,9,0,-9
11562,1,1,669,1806,1137
11563,1,0,0,0,0
11564,0,0,17,0,-17
11565,1,0,49,0,-49
11566,0,0,37,0,-37
11567,0,0,15,0,-15
11568,1,1,197,1278,1081
11569,1,0,49,0,-49
11570,1,1,476,1296,820
11571,1,1,700,1353,653
11572,0,0,119,0,-119
11573,0,0,32,0,-32
11574,1,1,278,1788,1510
11575,0,0,6,0,-6
11576,1,0,16,0,-16
11577,0,0,26,0,-26
11578,1,1,293,1345,1052
11579,1,0,41,0,-41
11580,1,1,549,1679,1130
11581,0,0,55,0,-55
11582,0,0,3,0,-3
11583,1,0,14,0,-14
11584,1,0,5,0,-5
11585,1,0,217,0,-217
11586,1,1,185,1254,1069
11587,0,0,2,0,-2
11588,0,0,22,0,-22
11589,1,0,59,0,-59
11590,1,1,77,1311,1234
11591,1,1,1268,1259,-9
11592,1,1,221,2022,1801
11593,0,0,5,0,-5
11594,1,1,184,1352,1168
11595,0,0,54,0,-54
11596,1,1,536,1331,795
11597,0,0,33,0,-33
11598,1,1,152,1397,1245
11599,0,0,14,0,-14
11600,1,1,836,2224,1388
11601,0,0,12,0,-12
11602,1,1,1354,1393,39
11603,1,1,1213,1533,320
11604,1,0,125,0,-125
11605,1,0,2,0,-2
11606,0,0,42,0,-42
11607,1,0,81,0,-81
11608,1,0,4,0,-4
11609,1,0,62,0,-62
11610,1,0,42,0,-42
11611,1,1,683,1268,585
11612,1,0,55,0,-55
11613,1,0,100,0,-100
11614,0,0,12,0,-12
11615,1,0,3,0,-3
11616,1,0,48,0,-48
11617,1,1,1459,1558,99
11618,1,0,144,0,-144
11619,0,0,150,0,-150
11620,1,0,17,0,-17
11621,1,0,100,0,-100
11622,1,1,1377,1348,-29
11623,0,0,8,0,-8
11624,0,0,129,0,-129
11625,1,0,18,0,-18
11626,1,0,34,0,-34
11627,0,0,84,0,-84
11628,0,0,6,0,-6
11629,0,0,31,0,-31
11630,0,0,80,0,-80
11631,0,0,34,0,-34
11632,1,1,640,1219,579
11633,1,0,58,0,-58
11634,0,0,109,0,-109
11635,1,1,25,1928,1903
11636,1,1,360,1899,1539
11637,0,0,10,0,-10
11638,1,1,313,1593,1280
11639,1,0,91,0,-91
11640,1,0,3,0,-3
11641,1,1,937,1408,471
11642,1,1,350,1896,1546
11643,1,1,1770,1287,-483
11644,0,0,55,0,-55
11645,0,0,42,0,-42
11646,0,0,74,0,-74
11647,1,1,283,1303,1020
11648,1,0,35,0,-35
11649,1,1,465,2388,1923
11650,1,1,653,1907,1254
11651,0,0,64,0,-64
11652,1,0,3,0,-3
11653,0,0,9,0,-9
11654,0,0,67,0,-67
11655,0,0,55,0,-55
11656,0,0,42,0,-42
11657,1,0,65,0,-65
11658,1,0,31,0,-31
11659,0,0,9,0,-9
11660,0,0,11,0,-11
11661,1,1,383,1532,1149
11662,1,0,3,0,-3
11663,0,0,9,0,-9
11664,1,1,485,1316,831
11665,1,0,42,0,-42
11666,1,0,42,0,-42
11667,1,1,517,5035,4518
11668,1,1,403,1777,1374
11669,0,0,25,0,-25
11670,1,1,247,1265,1018
11671,1,1,155,1322,1167
11672,1,1,283,2073,1790
11673,1,1,642,1555,913
11674,0,0,40,0,-40
11675,0,0,75,0,-75
11676,0,0,55,0,-55
11677,1,1,130,1989,1859
11678,0,0,131,0,-131
11679,1,0,220,0,-220
11680,1,1,166,1555,1389
11681,0,0,78,0,-78
11682,1,0,58,0,-58
11683,1,1,1492,1802,310
11684,1,1,156,2085,1929
11685,1,0,48,0,-48
11686,1,0,78,0,-78
11687,0,0,31,0,-31
11688,0,0,12,0,-12
11689,1,0,35,0,-35
11690,1,0,30,0,-30
11691,0,0,26,0,-26
11692,1,1,612,5134,4522
11693,1,0,17,0,-17
11694,1,0,53,0,-53
11695,1,0,29,0,-29
11696,1,1,570,1282,712
11697,0,0,12,0,-12
11698,1,1,1099,1274,175
11699,1,1,176,1410,1234
11700,0,0,2,0,-2
11701,0,0,7,0,-7
11702,1,0,27,0,-27
11703,1,1,169,1717,1548
11704,1,1,578,1220,642
11705,0,0,24,0,-24
11706,0,0,20,0,-20
11707,1,0,51,0,-51
11708,0,0,26,0,-26
11709,1,0,68,0,-68
11710,1,1,1587,1560,-27
11711,1,0,94,0,-94
11712,0,0,3,0,-3
11713,1,0,113,0,-113
11714,1,1,663,2313,1650
11715,1,1,490,1397,907
11716,1,1,537,1253,716
11717,0,0,105,0,-105
11718,0,0,75,0,-75
11719,1,1,576,1306,730
11720,1,1,352,1482,1130
11721,0,0,104,0,-104
11722,0,0,1,0,-1
11723,0,0,84,0,-84
11724,0,0,80,0,-80
11725,1,1,192,1699,1507
11726,1,1,1433,2070,637
11727,1,1,1333,1283,-50
11728,0,0,53,0,-53
11729,0,0,76,0,-76
11730,1,0,7,0,-7
11731,1,1,140,1564,1424
11732,1,0,77,0,-77
11733,1,1,82,1339,1257
11734,0,0,6,0,-6
11735,1,1,1686,1513,-173
11736,0,0,2,0,-2
11737,1,1,776,1214,438
11738,1,0,84,0,-84
11739,0,0,93,0,-93
11740,1,1,260,1246,986
11741,1,0,23,0,-23
11742,1,1,364,1234,870
11743,0,0,16,0,-16
11744,0,0,2,0,-2
11745,1,1,499,1524,1025
11746,1,1,762,1311,549
11747,0,0,11,0,-11
11748,1,0,9,0,-9
11749,1,1,212,2354,2142
11750,1,0,10,0,-10
11751,1,0,16,0,-16
11752,0,0,56,0,-56
11753,1,1,706,1806,1100
11754,0,0,16,0,-16
11755,1,1,220,1220,1000
11756,1,1,661,1301,640
11757,0,0,16,0,-16
11758,1,1,509,1262,753
11759,1,1,277,2023,1746
11760,1,0,61,0,-61
11761,1,1,875,1315,440
11762,1,0,50,0,-50
11763,1,1,566,1381,815
11764,1,0,89,0,-89
11765,1,0,43,0,-43
11766,1,0,10,0,-10
11767,1,0,7,0,-7
11768,1,1,164,1264,1100
11769,1,1,66,1295,1229
11770,1,1,390,1302,912
11771,1,1,203,1391,1188
11772,0,0,34,0,-34
11773,0,0,71,0,-71
11774,1,0,148,0,-148
11775,0,0,5,0,-5
11776,1,0,44,0,-44
11777,1,1,475,1654,1179
11778,0,0,118,0,-118
11779,1,0,107,0,-107
11780,0,0,12,0,-12
11781,0,0,30,0,-30
11782,1,0,41,0,-41
11783,1,0,9,0,-9
11784,1,1,655,1221,566
11785,0,0,218,0,-218
11786,1,1,1059,1379,320
11787,0,0,31,0,-31
11788,1,0,17,0,-17
11789,1,1,2144,3519,1375
11790,0,0,7,0,-7
11791,1,0,75,0,-75
11792,1,0,73,0,-73
11793,0,0,24,0,-24
11794,0,0,80,0,-80
11795,1,0,23,0,-23
11796,1,1,375,1578,1203
11797,0,0,38,0,-38
11798,1,0,9,0,-9
11799,0,0,30,0,-30
11800,0,0,28,0,-28
11801,1,1,95,1569,1474
11802,0,0,16,0,-16
11803,1,0,102,0,-102
11804,1,1,1098,1445,347
11805,0,0,63,0,-63
11806,1,1,686,1364,678
11807,1,1,552,1208,656
11808,1,1,212,1274,1062
11809,1,1,101,1210,1109
11810,1,0,58,0,-58
11811,1,0,3,0,-3
11812,0,0,19,0,-19
11813,1,1,564,1288,724
11814,0,0,46,0,-46
11815,1,1,108,1603,1495
11816,1,0,60,0,-60
11817,0,0,1,0,-1
11818,0,0,39,0,-39
11819,1,0,105,0,-105
11820,1,0,49,0,-49
11821,1,0,78,0,-78
11822,1,0,125,0,-125
11823,1,1,83,1787,1704
11824,1,0,5,0,-5
11825,1,0,16,0,-16
11826,0,0,62,0,-62
11827,1,1,449,1379,930
11828,0,0,30,0,-30
11829,0,0,8,0,-8
11830,1,1,826,1460,634
11831,0,0,61,0,-61
11832,1,1,1058,1560,502
11833,0,0,136,0,-136
11834,1,1,547,1630,1083
11835,1,0,146,0,-146
11836,1,0,127,0,-127
11837,1,0,45,0,-45
11838,0,0,4,0,-4
11839,1,0,5,0,-5
11840,1,1,1220,1384,164
11841,1,1,109,1336,1227
11842,1,0,28,0,-28
11843,1,1,351,1380,1029
11844,1,1,214,1226,1012
11845,1,0,83,0,-83
11846,0,0,138,0,-138
11847,1,1,137,1466,1329
11848,1,1,865,1302,437
11849,1,1,294,1704,1410
11850,0,0,13,0,-13
11851,0,0,18,0,-18
11852,1,1,688,1256,568
11853,0,0,5,0,-5
11854,1,0,27,0,-27
11855,0,0,23,0,-23
11856,1,0,73,0,-73
11857,1,0,17,0,-17
11858,1,1,1840,1228,-612
11859,1,1,89,1635,1546
11860,0,0,9,0,-9
11861,0,0,41,0,-41
11862,0,0,34,0,-34
11863,0,0,24,0,-24
11864,0,0,111,0,-111
11865,1,0,3,0,-3
11866,1,1,20,1357,1337
11867,0,0,49,0,-49
11868,1,1,581,1537,956
11869,1,1,31,1306,1275
11870,0,0,65,0,-65
11871,0,0,18,0,-18
11872,0,0,72,0,-72
11873,1,1,327,1301,974
11874,1,0,45,0,-45
11875,0,0,26,0,-26
11876,1,1,266,1253,987
11877,0,0,7,0,-7
11878,0,0,1,0,-1
11879,1,1,552,1393,841
11880,1,1,571,3550,2979
11881,1,0,93,0,-93
11882,0,0,38,0,-38
11883,0,0,2,0,-2
11884,1,0,29,0,-29
11885,0,0,32,0,-32
11886,0,0,79,0,-79
11887,0,0,15,0,-15
11888,0,0,0,0,0
11889,1,0,6,0,-6
11890,0,0,86,0,-86
11891,0,0,14,0,-14
11892,1,0,81,0,-81
11893,0,0,0,0,0
11894,1,1,840,1373,533
11895,0,0,20,0,-20
11896,0,0,61,0,-61
11897,1,0,5,0,-5
11898,1,1,607,1459,852
11899,1,1,33,1448,1415
11900,1,0,37,0,-37
11901,1,1,502,1631,1129
11902,1,0,31,0,-31
11903,1,0,15,0,-15
11904,1,1,267,1552,1285
11905,1,1,422,1605,1183
11906,0,0,22,0,-22
11907,1,1,372,1392,1020
11908,1,1,312,1589,1277
11909,1,1,178,1295,1117
11910,1,1,173,1374,1201
11911,1,1,397,1227,830
11912,0,0,17,0,-17
11913,0,0,12,0,-12
11914,0,0,101,0,-101
11915,0,0,114,0,-114
11916,0,0,39,0,-39
11917,0,0,0,0,0
11918,1,1,784,2043,1259
11919,1,0,29,0,-29
11920,1,0,16,0,-16
11921,0,0,42,0,-42
11922,1,0,126,0,-126
11923,0,0,163,0,-163
11924,0,0,9,0,-9
11925,1,0,0,0,0
11926,1,0,12,0,-12
11927,0,0,9,0,-9
11928,1,1,525,4031,3506
11929,1,0,185,0,-185
11930,0,0,25,0,-25
11931,1,0,50,0,-50
11932,1,0,35,0,-35
11933,1,1,69,1274,1205
11934,0,0,35,0,-35
11935,1,1,160,1792,1632
11936,1,0,13,0,-13
11937,1,1,120,2829,2709
11938,0,0,9,0,-9
11939,1,0,123,0,-123
11940,0,0,23,0,-23
11941,1,0,2,0,-2
11942,1,0,74,0,-74
11943,1,1,1412,1693,281
11944,0,0,53,0,-53
11945,0,0,1,0,-1
11946,1,0,72,0,-72
11947,1,1,1417,1231,-186
11948,0,0,9,0,-9
11949,1,0,71,0,-71
11950,1,0,65,0,-65
11951,0,0,100,0,-100
11952,1,1,35,1331,1296
11953,0,0,79,0,-79
11954,1,0,10,0,-10
11955,1,0,1,0,-1
11956,0,0,64,0,-64
11957,0,0,25,0,-25
11958,1,1,189,1353,1164
11959,1,1,21,1209,1188
11960,1,0,57,0,-57
11961,1,1,1351,1530,179
11962,0,0,50,0,-50
11963,0,0,61,0,-61
11964,0,0,13,0,-13
11965,1,1,242,1309,1067
11966,0,0,97,0,-97
11967,1,1,218,1423,1205
11968,1,0,31,0,-31
11969,1,1,342,1282,940
11970,1,1,159,1200,1041
11971,1,1,410,1201,791
11972,1,1,180,1445,1265
11973,1,0,23,0,-23
11974,1,0,78,0,-78
11975,1,0,7,0,-7
11976,1,1,1300,1295,-5
11977,0,0,26,0,-26
11978,0,0,65,0,-65
11979,1,1,155,1638,1483
11980,0,0,6,0,-6
11981,0,0,26,0,-26
11982,0,0,32,0,-32
11983,0,0,252,0,-252
11984,1,0,23,0,-23
11985,1,0,23,0,-23
11986,1,0,27,0,-27
11987,1,0,20,0,-20
11988,1,1,358,1245,887
11989,0,0,54,0,-54
11990,1,0,115,0,-115
11991,1,1,50,2556,2506
11992,1,0,45,0,-45
11993,1,0,17,0,-17
11994,0,0,78,0,-78
11995,1,1,130,1588,1458
11996,1,0,29,0,-29
11997,1,1,791,1235,444
11998,1,1,2250,1334,-916
11999,0,0,79,0,-79
12000,1,0,17,0,-17
12001,1,1,412,1297,885
12002,1,0,2,0,-2
12003,1,0,1,0,-1
12004,0,0,47,0,-47
12005,1,1,276,1918,1642
12006,1,0,135,0,-135
12007,1,1,417,1512,1095
12008,0,0,76,0,-76
12009,1,1,1401,1716,315
12010,1,0,67,0,-67
12011,1,1,428,1663,1235
12012,0,0,32,0,-32
12013,1,0,23,0,-23
12014,0,0,28,0,-28
12015,0,0,20,0,-20
12016,1,1,435,1291,856
12017,0,0,18,0,-18
12018,0,0,87,0,-87
12019,1,1,1268,1328,60
12020,1,1,562,1208,646
12021,0,0,46,0,-46
12022,1,1,402,1521,1119
12023,0,0,31,0,-31
12024,1,0,19,0,-19
12025,0,0,17,0,-17
12026,1,0,14,0,-14
12027,1,1,32,1372,1340
12028,1,1,323,1488,1165
12029,1,1,123,1209,1086
12030,0,0,16,0,-16
12031,0,0,32,0,-32
12032,0,0,153,0,-153
12033,0,0,48,0,-48
12034,1,0,35,0,-35
12035,1,0,44,0,-44
12036,1,1,229,3010,2781
12037,0,0,48,0,-48
12038,0,0,42,0,-42
12039,0,0,24,0,-24
12040,0,0,59,0,-59
12041,1,0,58,0,-58
12042,1,1,100,1211,1111
12043,0,0,32,0,-32
12044,0,0,9,0,-9
12045,0,0,43,0,-43
12046,0,0,94,0,-94
12047,0,0,37,0,-37
12048,1,0,214,0,-214
12049,1,0,47,0,-47
12050,1,0,20,0,-20
12051,0,0,64,0,-64
12052,0,0,101,0,-101
12053,0,0,137,0,-137
12054,0,0,84,0,-84
12055,0,0,2,0,-2
12056,1,1,50,1265,1215
12057,1,0,23,0,-23
12058,0,0,32,0,-32
12059,0,0,15,0,-15
12060,1,0,84,0,-84
12061,0,0,217,0,-217
12062,1,0,62,0,-62
12063,0,0,67,0,-67
12064,0,0,65,0,-65
12065,1,0,40,0,-40
12066,1,0,19,0,-19
12067,1,1,254,1598,1344
12068,1,0,59,0,-59
12069,1,1,207,1417,1210
12070,1,0,35,0,-35
12071,0,0,142,0,-142
12072,0,0,31,0,-31
12073,1,0,98,0,-98
12074,0,0,43,0,-43
12075,1,1,969,1630,661
12076,1,0,5,0,-5
12077,1,1,113,1409,1296
12078,1,1,380,1218,838
12079,0,0,39,0,-39
12080,0,0,23,0,-23
12081,1,0,14,0,-14
12082,1,1,675,1490,815
12083,1,0,80,0,-80
12084,1,0,241,0,-241
12085,1,0,37,0,-37
12086,0,0,42,0,-42
12087,1,1,951,1214,263
12088,1,0,76,0,-76
12089,0,0,50,0,-50
12090,1,1,579,1874,1295
12091,1,1,1204,1463,259
12092,1,0,64,0,-64
12093,0,0,7,0,-7
12094,0,0,50,0,-50
12095,1,0,26,0,-26
12096,0,0,57,0,-57
12097,1,0,68,0,-68
12098,1,1,336,1784,1448
12099,1,0,84,0,-84
12100,0,0,0,0,0
12101,1,1,195,2386,2191
12102,1,0,17,0,-17
12103,0,0,76,0,-76
12104,1,1,1355,1202,-153
12105,1,0,20,0,-20
12106,0,0,58,0,-58
12107,1,1,151,1220,1069
12108,0,0,83,0,-83
12109,0,0,27,0,-27
12110,0,0,16,0,-16
12111,0,0,29,0,-29
12112,1,0,106,0,-106
12113,0,0,19,0,-19
12114,0,0,92,0,-92
12115,1,1,107,1886,1779
12116,1,1,70,1594,1524
12117,0,0,53,0,-53
12118,0,0,33,0,-33
12119,1,0,158,0,-158
12120,0,0,4,0,-4
12121,0,0,74,0,-74
12122,0,0,63,0,-63
12123,1,1,117,1447,1330
12124,1,0,2,0,-2
12125,1,1,246,1419,1173
12126,1,1,105,2621,2516
12127,0,0,35,0,-35
12128,1,0,7,0,-7
12129,1,0,12,0,-12
12130,0,0,112,0,-112
12131,0,0,165,0,-165
12132,0,0,52,0,-52
12133,1,1,409,1521,1112
12134,0,0,0,0,0
12135,1,0,44,0,-44
12136,1,0,12,0,-12
12137,1,0,204,0,-204
12138,0,0,100,0,-100
12139,0,0,3,0,-3
12140,1,1,124,1257,1133
12141,0,0,43,0,-43
12142,1,1,263,2000,1737
12143,0,0,39,0,-39
12144,0,0,10,0,-10
12145,1,1,813,1322,509
12146,1,0,134,0,-134
12147,0,0,112,0,-112
12148,1,1,261,1310,1049
12149,0,0,25,0,-25
12150,0,0,78,0,-78
12151,0,0,62,0,-62
12152,1,1,194,1523,1329
12153,1,1,1377,2246,869
12154,1,1,536,1612,1076
12155,1,0,31,0,-31
12156,0,0,14,0,-14
12157,0,0,84,0,-84
12158,0,0,109,0,-109
12159,0,0,31,0,-31
12160,0,0,81,0,-81
12161,1,1,331,5602,5271
12162,1,1,53,1480,1427
12163,1,0,18,0,-18
12164,0,0,16,0,-16
12165,1,0,67,0,-67
12166,0,0,96,0,-96
12167,0,0,50,0,-50
12168,1,0,50,0,-50
12169,0,0,16,0,-16
12170,0,0,17,0,-17
12171,1,0,35,0,-35
12172,0,0,41,0,-41
12173,1,1,553,1428,875
12174,1,0,42,0,-42
12175,1,0,43,0,-43
12176,0,0,113,0,-113
12177,1,1,74,2465,2391
12178,0,0,5,0,-5
12179,0,0,7,0,-7
12180,0,0,9,0,-9
12181,1,0,2,0,-2
12182,1,1,494,1247,753
12183,0,0,1,0,-1
12184,0,0,11,0,-11
12185,1,0,101,0,-101
12186,0,0,15,0,-15
12187,0,0,4,0,-4
12188,0,0,8,0,-8
12189,0,0,114,0,-114
12190,1,1,427,1211,784
12191,1,0,16,0,-16
12192,0,0,64,0,-64
12193,0,0,8,0,-8
12194,0,0,80,0,-80
12195,1,0,34,0,-34
12196,0,0,9,0,-9
12197,1,0,75,0,-75
12198,0,0,132,0,-132
12199,1,0,66,0,-66
12200,1,0,42,0,-42
12201,0,0,8,0,-8
12202,1,1,105,2976,2871
12203,1,0,170,0,-170
12204,1,1,105,1262,1157
12205,1,0,15,0,-15
12206,1,1,114,1677,1563
12207,0,0,19,0,-19
12208,1,1,434,1323,889
12209,1,0,23,0,-23
12210,1,1,654,2263,1609
12211,1,0,3,0,-3
12212,0,0,28,0,-28
12213,1,1,779,1691,912
12214,0,0,80,0,-80
12215,1,0,94,0,-94
12216,0,0,73,0,-73
12217,0,0,6,0,-6
12218,1,0,66,0,-66
12219,0,0,50,0,-50
12220,0,0,34,0,-34
12221,0,0,76,0,-76
12222,1,0,13,0,-13
12223,1,1,580,1200,620
12224,0,0,96,0,-96
12225,1,1,912,1623,711
12226,1,1,213,1973,1760
12227,1,1,572,1399,827
12228,1,1,1008,1333,325
12229,0,0,18,0,-18
12230,1,1,516,1533,1017
12231,1,0,46,0,-46
12232,0,0,15,0,-15
12233,1,0,21,0,-21
12234,0,0,18,0,-18
12235,1,1,106,1326,1220
12236,1,0,27,0,-27
12237,1,1,766,1225,459
12238,0,0,19,0,-19
12239,1,0,24,0,-24
12240,1,0,5,0,-5
12241,1,0,1,0,-1
12242,1,0,10,0,-10
12243,0,0,1,0,-1
12244,1,0,29,0,-29
12245,0,0,38,0,-38
12246,0,0,28,0,-28
12247,1,0,78,0,-78
12248,0,0,57,0,-57
12249,0,0,86,0,-86
12250,0,0,105,0,-105
12251,1,1,1397,1384,-13
12252,1,1,1069,2263,1194
12253,1,0,66,0,-66
12254,1,0,2,0,-2
12255,1,1,163,1287,1124
12256,0,0,184,0,-184
12257,0,0,16,0,-16
12258,1,0,10,0,-10
12259,1,0,8,0,-8
12260,0,0,20,0,-20
12261,1,0,5,0,-5
12262,0,0,9,0,-9
12263,1,1,278,1620,1342
12264,1,1,1160,1911,751
12265,0,0,70,0,-70
12266,0,0,5,0,-5
12267,0,0,19,0,-19
12268,0,0,50,0,-50
12269,0,0,28,0,-28
12270,1,1,1542,2356,814
12271,0,0,39,0,-39
12272,0,0,31,0,-31
12273,1,1,722,3964,3242
12274,1,1,448,1204,756
12275,0,0,69,0,-69
12276,0,0,28,0,-28
12277,0,0,61,0,-61
12278,1,1,163,1349,1186
12279,0,0,191,0,-191
12280,1,1,443,1225,782
12281,1,0,36,0,-36
12282,0,0,5,0,-5
12283,0,0,62,0,-62
12284,1,1,848,2175,1327
12285,1,1,575,1688,1113
12286,1,0,43,0,-43
12287,1,1,1296,1294,-2
12288,0,0,0,0,0
12289,0,0,60,0,-60
12290,1,0,146,0,-146
12291,1,1,1807,2349,542
12292,0,0,148,0,-148
12293,1,1,69,2306,2237
12294,1,1,1024,1292,268
12295,1,0,49,0,-49
12296,0,0,1,0,-1
12297,1,0,23,0,-23
12298,0,0,31,0,-31
12299,0,0,26,0,-26
12300,0,0,10,0,-10
12301,1,1,1624,1201,-423
12302,1,1,174,1410,1236
12303,0,0,12,0,-12
12304,0,0,15,0,-15
12305,1,1,197,1239,1042
12306,0,0,38,0,-38
12307,1,1,391,1418,1027
12308,1,0,13,0,-13
12309,0,0,34,0,-34
12310,0,0,0,0,0
12311,0,0,34,0,-34
12312,1,0,10,0,-10
12313,1,1,320,1790,1470
12314,0,0,170,0,-170
12315,0,0,24,0,-24
12316,1,1,1094,1757,663
12317,0,0,12,0,-12
12318,1,0,7,0,-7
12319,0,0,79,0,-79
12320,0,0,6,0,-6
12321,0,0,30,0,-30
12322,1,0,42,0,-42
12323,1,1,102,1940,1838
12324,1,1,127,2357,2230
12325,1,1,722,1581,859
12326,1,1,307,1690,1383
12327,0,0,6,0,-6
12328,1,1,3515,1285,-2230
12329,0,0,90,0,-90
12330,1,0,0,0,0
12331,1,1,75,1388,1313
12332,1,0,1,0,-1
12333,1,1,143,1379,1236
12334,1,1,1202,1662,460
12335,1,0,31,0,-31
12336,1,1,247,1250,1003
12337,0,0,222,0,-222
12338,1,1,102,1358,1256
12339,1,1,60,1287,1227
12340,0,0,313,0,-313
12341,1,1,124,1395,1271
12342,0,0,15,0,-15
12343,1,1,367,1384,1017
12344,1,1,734,1230,496
12345,1,0,86,0,-86
12346,1,1,1755,4607,2852
12347,1,0,0,0,0
12348,1,0,52,0,-52
12349,0,0,65,0,-65
12350,0,0,33,0,-33
12351,1,0,1,0,-1
12352,0,0,5,0,-5
12353,1,1,2168,1204,-964
12354,1,0,81,0,-81
12355,0,0,237,0,-237
12356,0,0,13,0,-13
12357,1,0,50,0,-50
12358,0,0,57,0,-57
12359,1,1,405,1462,1057
12360,0,0,138,0,-138
12361,1,0,46,0,-46
12362,0,0,118,0,-118
12363,0,0,24,0,-24
12364,1,1,1289,1311,22
12365,1,0,17,0,-17
12366,1,1,183,1687,1504
12367,0,0,35,0,-35
12368,0,0,30,0,-30
12369,1,0,63,0,-63
12370,1,0,98,0,-98
12371,0,0,22,0,-22
12372,0,0,75,0,-75
12373,0,0,63,0,-63
12374,0,0,195,0,-195
12375,0,0,48,0,-48
12376,1,1,159,1543,1384
12377,0,0,26,0,-26
12378,1,1,812,1232,420
12379,1,0,0,0,0
12380,1,1,143,1212,1069
12381,1,1,804,1218,414
12382,0,0,97,0,-97
12383,1,1,34,2042,2008
12384,0,0,87,0,-87
12385,1,0,61,0,-61
12386,0,0,93,0,-93
12387,1,0,160,0,-160
12388,0,0,85,0,-85
12389,0,0,39,0,-39
12390,1,1,271,1800,1529
12391,0,0,22,0,-22
12392,0,0,59,0,-59
12393,1,0,2,0,-2
12394,1,0,41,0,-41
12395,0,0,24,0,-24
12396,0,0,97,0,-97
12397,1,1,202,1444,1242
12398,1,1,820,1238,418
12399,1,1,346,1598,1252
12400,1,0,24,0,-24
12401,0,0,85,0,-85
12402,1,0,21,0,-21
12403,1,0,68,0,-68
12404,1,1,308,1314,1006
12405,1,0,20,0,-20
12406,1,0,72,0,-72
12407,1,0,28,0,-28
12408,1,0,36,0,-36
12409,0,0,237,0,-237
12410,1,1,90,1800,1710
12411,0,0,58,0,-58
12412,1,1,183,1671,1488
12413,0,0,7,0,-7
12414,1,0,36,0,-36
12415,1,1,1026,1263,237
12416,1,0,78,0,-78
12417,0,0,0,0,0
12418,1,0,195,0,-195
12419,0,0,57,0,-57
12420,0,0,22,0,-22
12421,0,0,68,0,-68
12422,0,0,39,0,-39
12423,1,1,128,1279,1151
12424,0,0,88,0,-88
12425,1,1,433,1207,774
12426,0,0,14,0,-14
12427,1,0,48,0,-48
12428,1,0,77,0,-77
12429,1,1,639,1932,1293
12430,0,0,13,0,-13
12431,0,0,137,0,-137
12432,1,0,132,0,-132
12433,0,0,70,0,-70
12434,1,1,567,1202,635
12435,0,0,8,0,-8
12436,1,1,49,1269,1220
12437,0,0,184,0,-184
12438,1,1,725,1366,641
12439,1,1,160,1820,1660
12440,0,0,16,0,-16
12441,1,0,1,0,-1
12442,1,0,31,0,-31
12443,1,0,134,0,-134
12444,1,0,11,0,-11
12445,0,0,43,0,-43
12446,1,0,30,0,-30
12447,0,0,11,0,-11
12448,1,1,220,2024,1804
12449,0,0,60,0,-60
12450,1,1,197,1282,1085
12451,0,0,173,0,-173
12452,1,1,421,1860,1439
12453,1,1,472,1344,872
12454,1,0,85,0,-85
12455,0,0,15,0,-15
12456,1,0,24,0,-24
12457,1,1,1497,1289,-208
12458,0,0,1,0,-1
12459,1,0,10,0,-10
12460,0,0,9,0,-9
12461,0,0,89,0,-89
12462,1,0,114,0,-114
12463,1,0,14,0,-14
12464,0,0,50,0,-50
12465,0,0,28,0,-28
12466,0,0,11,0,-11
12467,1,0,50,0,-50
12468,0,0,10,0,-10
12469,1,1,599,1514,915
12470,0,0,36,0,-36
12471,1,1,371,1332,961
12472,1,0,84,0,-84
12473,1,0,21,0,-21
12474,0,0,4,0,-4
12475,0,0,43,0,-43
12476,1,0,6,0,-6
12477,0,0,62,0,-62
12478,0,0,32,0,-32
12479,0,0,80,0,-80
12480,1,0,244,0,-244
12481,1,0,36,0,-36
12482,1,0,179,0,-179
12483,0,0,70,0,-70
12484,1,1,22,1650,1628
12485,0,0,138,0,-138
12486,0,0,5,0,-5
12487,1,0,85,0,-85
12488,0,0,7,0,-7
12489,1,1,250,2342,2092
12490,0,0,17,0,-17
12491,1,0,48,0,-48
12492,0,0,18,0,-18
12493,1,0,0,0,0
12494,1,0,6,0,-6
12495,1,0,67,0,-67
12496,0,0,11,0,-11
12497,0,0,111,0,-111
12498,0,0,15,0,-15
12499,1,1,315,1279,964
12500,0,0,79,0,-79
12501,1,1,484,1324,840
12502,1,1,1202,2435,1233
12503,1,0,89,0,-89
12504,1,0,62,0,-62
12505,1,1,717,1846,1129
12506,1,0,289,0,-289
12507,0,0,3,0,-3
12508,0,0,141,0,-141
12509,1,0,38,0,-38
12510,1,0,103,0,-103
12511,1,0,93,0,-93
12512,0,0,42,0,-42
12513,0,0,130,0,-130
12514,1,1,157,2407,2250
12515,0,0,18,0,-18
12516,1,1,416,1415,999
12517,1,0,69,0,-69
12518,0,0,7,0,-7
12519,0,0,19,0,-19
12520,1,1,235,2576,2341
12521,0,0,62,0,-62
12522,1,0,0,0,0
12523,0,0,8,0,-8
12524,1,0,18,0,-18
12525,1,0,42,0,-42
12526,1,1,200,1280,1080
12527,0,0,180,0,-180
12528,0,0,44,0,-44
12529,1,1,274,1654,1380
12530,1,0,14,0,-14
12531,1,0,18,0,-18
12532,1,1,503,1503,1000
12533,0,0,29,0,-29
12534,1,1,200,1407,1207
12535,1,0,16,0,-16
12536,0,0,71,0,-71
12537,0,0,11,0,-11
12538,0,0,5,0,-5
12539,0,0,32,0,-32
12540,1,1,126,1523,1397
12541,1,0,67,0,-67
12542,1,0,51,0,-51
12543,1,0,0,0,0
12544,0,0,24,0,-24
12545,1,1,1042,1277,235
12546,0,0,49,0,-49
12547,1,0,30,0,-30
12548,1,0,37,0,-37
12549,1,1,1908,1849,-59
12550,1,0,73,0,-73
12551,1,0,98,0,-98
12552,1,1,995,1379,384
12553,0,0,43,0,-43
12554,0,0,331,0,-331
12555,1,0,3,0,-3
12556,1,1,326,1237,911
12557,1,0,51,0,-51
12558,1,1,342,1418,1076
12559,1,1,353,1207,854
12560,1,1,364,1426,1062
12561,1,0,24,0,-24
12562,0,0,24,0,-24
12563,0,0,111,0,-111
12564,0,0,28,0,-28
12565,1,0,6,0,-6
12566,0,0,2,0,-2
12567,0,0,70,0,-70
12568,0,0,4,0,-4
12569,1,0,4,0,-4
12570,1,1,134,1965,1831
12571,0,0,27,0,-27
12572,1,1,339,1916,1577
12573,0,0,46,0,-46
12574,1,1,612,1221,609
12575,1,0,53,0,-53
12576,1,1,59,6359,6300
12577,0,0,9,0,-9
12578,1,1,479,1633,1154
12579,1,1,53,3338,3285
12580,0,0,32,0,-32
12581,0,0,47,0,-47
12582,1,0,7,0,-7
12583,0,0,69,0,-69
12584,0,0,6,0,-6
12585,1,0,72,0,-72
12586,1,1,640,1417,777
12587,0,0,29,0,-29
12588,1,0,143,0,-143
12589,0,0,4,0,-4
12590,0,0,68,0,-68
12591,0,0,41,0,-41
12592,0,0,20,0,-20
12593,1,1,2006,1228,-778
12594,1,1,519,1423,904
12595,1,0,5,0,-5
12596,1,0,10,0,-10
12597,0,0,47,0,-47
12598,0,0,27,0,-27
12599,1,1,1634,1406,-228
12600,1,1,977,1302,325
12601,1,1,1301,1206,-95
12602,0,0,18,0,-18
12603,1,0,101,0,-101
12604,0,0,59,0,-59
12605,1,1,416,1334,918
12606,0,0,153,0,-153
12607,0,0,5,0,-5
12608,1,1,791,3195,2404
12609,1,0,20,0,-20
12610,0,0,0,0,0
12611,0,0,4,0,-4
12612,0,0,2,0,-2
12613,0,0,68,0,-68
12614,1,1,264,1269,1005
12615,1,0,9,0,-9
12616,0,0,27,0,-27
12617,1,1,1203,1754,551
12618,0,0,38,0,-38
12619,0,0,102,0,-102
12620,1,1,385,1920,1535
12621,1,1,137,2098,1961
12622,0,0,9,0,-9
12623,0,0,22,0,-22
12624,1,1,93,1314,1221
12625,1,0,55,0,-55
12626,1,0,4,0,-4
12627,1,0,55,0,-55
12628,0,0,33,0,-33
12629,1,1,241,1352,1111
12630,1,0,11,0,-11
12631,1,1,66,1285,1219
12632,1,0,61,0,-61
12633,1,1,309,5160,4851
12634,0,0,74,0,-74
12635,1,1,266,1377,1111
12636,0,0,8,0,-8
12637,1,1,1498,1348,-150
12638,0,0,5,0,-5
12639,1,0,0,0,0
12640,0,0,103,0,-103
12641,1,1,162,1362,1200
12642,1,1,1257,1624,367
12643,1,0,140,0,-140
12644,0,0,98,0,-98
12645,1,1,90,2085,1995
12646,0,0,231,0,-231
12647,1,0,43,0,-43
12648,1,0,33,0,-33
12649,0,0,28,0,-28
12650,0,0,3,0,-3
12651,0,0,107,0,-107
12652,1,0,52,0,-52
12653,1,1,19,1386,1367
12654,1,0,5,0,-5
12655,1,1,276,1359,1083
12656,1,1,1350,1561,211
12657,0,0,30,0,-30
12658,1,0,39,0,-39
12659,1,1,1289,1260,-29
12660,1,0,42,0,-42
12661,1,0,15,0,-15
12662,0,0,3,0,-3
12663,0,0,28,0,-28
12664,0,0,34,0,-34
12665,1,1,181,1363,1182
12666,0,0,3,0,-3
12667,0,0,8,0,-8
12668,1,1,408,1469,1061
12669,1,0,2,0,-2
12670,0,0,32,0,-32
12671,0,0,22,0,-22
12672,1,0,80,0,-80
12673,1,0,7,0,-7
12674,0,0,13,0,-13
12675,1,1,133,1397,1264
12676,1,1,36,1387,1351
12677,0,0,21,0,-21
12678,1,1,117,1375,1258
12679,0,0,11,0,-11
12680,0,0,5,0,-5
12681,0,0,57,0,-57
12682,1,0,71,0,-71
12683,0,0,4,0,-4
12684,0,0,5,0,-5
12685,1,1,1812,1355,-457
12686,1,0,25,0,-25
12687,1,0,33,0,-33
12688,0,0,200,0,-200
12689,0,0,100,0,-100
12690,1,0,150,0,-150
12691,0,0,2,0,-2
12692,0,0,2,0,-2
12693,0,0,48,0,-48
12694,0,0,17,0,-17
12695,1,1,273,2234,1961
12696,1,0,24,0,-24
12697,0,0,137,0,-137
12698,1,0,20,0,-20
12699,0,0,117,0,-117
12700,0,0,12,0,-12
12701,0,0,11,0,-11
12702,1,0,15,0,-15
12703,1,1,860,1761,901
12704,0,0,72,0,-72
12705,0,0,39,0,-39
12706,0,0,18,0,-18
12707,1,0,5,0,-5
12708,1,1,680,1368,688
12709,0,0,79,0,-79
12710,1,1,49,1626,1577
12711,1,0,12,0,-12
12712,1,1,791,1222,431
12713,1,0,13,0,-13
12714,0,0,48,0,-48
12715,0,0,48,0,-48
12716,1,1,326,1284,958
12717,1,1,847,1887,1040
12718,1,0,18,0,-18
12719,0,0,9,0,-9
12720,0,0,139,0,-139
12721,0,0,47,0,-47
12722,0,0,23,0,-23
12723,0,0,6,0,-6
12724,0,0,81,0,-81
12725,0,0,42,0,-42
12726,1,0,1,0,-1
12727,0,0,24,0,-24
12728,0,0,0,0,0
12729,0,0,115,0,-115
12730,1,0,102,0,-102
12731,0,0,7,0,-7
12732,0,0,61,0,-61
12733,1,1,127,1438,1311
12734,1,1,382,1329,947
12735,0,0,21,0,-21
12736,1,0,15,0,-15
12737,1,1,303,1224,921
12738,1,0,72,0,-72
12739,0,0,100,0,-100
12740,1,0,255,0,-255
12741,1,1,786,1639,853
12742,1,1,156,1353,1197
12743,0,0,1,0,-1
12744,1,1,404,2066,1662
12745,1,1,129,1555,1426
12746,1,0,20,0,-20
12747,1,1,186,1761,1575
12748,1,1,506,1720,1214
12749,0,0,3,0,-3
12750,1,1,59,1393,1334
12751,1,0,31,0,-31
12752,0,0,92,0,-92
12753,0,0,90,0,-90
12754,0,0,43,0,-43
12755,1,1,254,1212,958
12756,1,0,69,0,-69
12757,1,0,4,0,-4
12758,1,0,7,0,-7
12759,0,0,23,0,-23
12760,1,1,287,1528,1241
12761,0,0,219,0,-219
12762,1,1,402,1625,1223
12763,1,0,7,0,-7
12764,1,1,433,1209,776
12765,0,0,269,0,-269
12766,1,0,9,0,-9
12767,1,0,47,0,-47
12768,1,1,183,1254,1071
12769,1,1,625,1758,1133
12770,1,0,39,0,-39
12771,1,0,165,0,-165
12772,0,0,22,0,-22
12773,0,0,39,0,-39
12774,1,1,781,1420,639
12775,0,0,38,0,-38
12776,0,0,7,0,-7
12777,1,0,22,0,-22
12778,1,0,19,0,-19
12779,0,0,7,0,-7
12780,0,0,20,0,-20
12781,1,0,44,0,-44
12782,1,1,113,1217,1104
12783,1,0,11,0,-11
12784,1,1,755,1728,973
12785,0,0,15,0,-15
12786,0,0,1,0,-1
12787,1,0,2,0,-2
12788,1,0,41,0,-41
12789,1,1,137,1247,1110
12790,1,0,247,0,-247
12791,0,0,48,0,-48
12792,1,0,32,0,-32
12793,1,1,74,1213,1139
12794,1,0,16,0,-16
12795,1,1,278,1276,998
12796,1,1,109,1384,1275
12797,1,1,414,1234,820
12798,1,0,0,0,0
12799,1,0,50,0,-50
12800,1,0,96,0,-96
12801,0,0,53,0,-53
12802,1,0,37,0,-37
12803,0,0,7,0,-7
12804,1,0,19,0,-19
12805,1,0,31,0,-31
12806,1,0,5,0,-5
12807,0,0,32,0,-32
12808,1,0,109,0,-109
12809,0,0,40,0,-40
12810,1,1,83,1624,1541
12811,1,0,104,0,-104
12812,1,1,809,1943,1134
12813,1,0,18,0,-18
12814,1,0,6,0,-6
12815,1,0,13,0,-13
12816,0,0,0,0,0
12817,1,0,169,0,-169
12818,1,0,6,0,-6
12819,0,0,0,0,0
12820,0,0,30,0,-30
12821,0,0,0,0,0
12822,1,1,547,2960,2413
12823,1,0,83,0,-83
12824,0,0,2,0,-2
12825,1,0,2,0,-2
12826,1,1,97,1297,1200
12827,0,0,25,0,-25
12828,0,0,31,0,-31
12829,0,0,9,0,-9
12830,1,1,425,1375,950
12831,1,0,132,0,-132
12832,1,0,47,0,-47
12833,1,0,93,0,-93
12834,1,1,1267,1443,176
12835,1,1,677,1498,821
12836,0,0,20,0,-20
12837,1,0,14,0,-14
12838,0,0,28,0,-28
12839,1,1,996,1260,264
12840,1,1,899,1340,441
12841,1,1,123,1271,1148
12842,0,0,55,0,-55
12843,1,1,684,2150,1466
12844,0,0,33,0,-33
12845,0,0,146,0,-146
12846,1,1,384,1567,1183
12847,1,1,307,2467,2160
12848,1,0,93,0,-93
12849,0,0,14,0,-14
12850,1,0,16,0,-16
12851,1,0,0,0,0
12852,0,0,75,0,-75
12853,1,0,45,0,-45
12854,0,0,93,0,-93
12855,0,0,75,0,-75
12856,1,0,31,0,-31
12857,1,1,727,1509,782
12858,1,0,79,0,-79
12859,0,0,6,0,-6
12860,1,0,40,0,-40
12861,0,0,81,0,-81
12862,1,0,142,0,-142
12863,0,0,9,0,-9
12864,0,0,58,0,-58
12865,1,1,139,1366,1227
12866,1,0,12,0,-12
12867,1,0,19,0,-19
12868,1,0,65,0,-65
12869,0,0,56,0,-56
12870,1,1,275,1794,1519
12871,0,0,48,0,-48
12872,0,0,41,0,-41
12873,0,0,128,0,-128
12874,1,1,248,1430,1182
12875,1,0,15,0,-15
12876,1,0,6,0,-6
12877,0,0,14,0,-14
12878,1,0,22,0,-22
12879,1,0,23,0,-23
12880,0,0,70,0,-70
12881,1,1,205,1356,1151
12882,1,0,73,0,-73
12883,0,0,15,0,-15
12884,1,1,392,1431,1039
12885,1,1,854,1310,456
12886,0,0,28,0,-28
12887,0,0,0,0,0
12888,0,0,32,0,-32
12889,0,0,37,0,-37
12890,0,0,33,0,-33
12891,0,0,31,0,-31
12892,1,0,70,0,-70
12893,1,0,46,0,-46
12894,1,1,180,1441,1261
12895,0,0,17,0,-17
12896,0,0,1,0,-1
12897,1,1,913,1829,916
12898,1,0,0,0,0
12899,1,0,9,0,-9
12900,0,0,82,0,-82
12901,1,0,12,0,-12
12902,1,1,860,1201,341
12903,1,0,117,0,-117
12904,0,0,38,0,-38
12905,0,0,120,0,-120
12906,0,0,38,0,-38
12907,1,0,59,0,-59
12908,0,0,40,0,-40
12909,0,0,52,0,-52
12910,1,1,110,1840,1730
12911,1,1,516,1376,860
12912,1,0,19,0,-19
12913,1,0,37,0,-37
12914,0,0,12,0,-12
12915,1,1,563,1364,801
12916,0,0,48,0,-48
12917,0,0,38,0,-38
12918,0,0,5,0,-5
12919,1,0,79,0,-79
12920,1,1,412,1595,1183
12921,1,0,15,0,-15
12922,1,0,10,0,-10
12923,1,0,12,0,-12
12924,1,1,297,1350,1053
12925,1,1,266,1503,1237
12926,0,0,155,0,-155
12927,0,0,126,0,-126
12928,0,0,33,0,-33
12929,0,0,74,0,-74
12930,1,0,19,0,-19
12931,0,0,8,0,-8
12932,1,1,54,1229,1175
12933,0,0,21,0,-21
12934,1,0,29,0,-29
12935,1,1,1127,2051,924
12936,0,0,80,0,-80
12937,0,0,17,0,-17
12938,1,1,282,1509,1227
12939,1,1,201,1446,1245
12940,1,0,22,0,-22
12941,0,0,62,0,-62
12942,0,0,5,0,-5
12943,1,1,395,3964,3569
12944,0,0,15,0,-15
12945,0,0,103,0,-103
12946,0,0,104,0,-104
12947,0,0,48,0,-48
12948,1,1,83,1216,1133
12949,1,0,10,0,-10
12950,1,0,1,0,-1
12951,1,0,21,0,-21
12952,0,0,29,0,-29
12953,0,0,2,0,-2
12954,1,1,160,1403,1243
12955,0,0,47,0,-47
12956,1,0,43,0,-43
12957,0,0,39,0,-39
12958,1,1,893,1632,739
12959,0,0,58,0,-58
12960,1,0,44,0,-44
12961,0,0,84,0,-84
12962,0,0,19,0,-19
12963,1,1,86,1258,1172
12964,1,1,305,1985,1680
12965,1,1,267,1974,1707
12966,1,1,144,1451,1307
12967,0,0,14,0,-14
12968,0,0,60,0,-60
12969,1,0,18,0,-18
12970,1,0,13,0,-13
12971,0,0,151,0,-151
12972,0,0,21,0,-21
12973,1,1,102,1503,1401
12974,1,0,205,0,-205
12975,0,0,109,0,-109
12976,1,1,2245,1274,-971
12977,1,0,59,0,-59
12978,1,0,14,0,-14
12979,1,1,590,1428,838
12980,0,0,140,0,-140
12981,0,0,187,0,-187
12982,1,1,214,1608,1394
12983,1,0,33,0,-33
12984,1,0,137,0,-137
12985,1,1,151,1420,1269
12986,0,0,38,0,-38
12987,1,0,12,0,-12
12988,1,0,56,0,-56
12989,1,1,179,1345,1166
12990,0,0,69,0,-69
12991,1,0,269,0,-269
12992,0,0,52,0,-52
12993,1,1,1076,1469,393
12994,0,0,13,0,-13
12995,0,0,96,0,-96
12996,1,0,37,0,-37
12997,0,0,58,0,-58
12998,1,0,120,0,-120
12999,1,0,18,0,-18
13000,1,0,39,0,-39
13001,1,1,207,1325,1118
13002,1,0,19,0,-19
13003,0,0,13,0,-13
13004,1,0,11,0,-11
13005,0,0,16,0,-16
13006,0,0,21,0,-21
13007,1,0,99,0,-99
13008,0,0,60,0,-60
13009,0,0,42,0,-42
13010,0,0,1,0,-1
13011,0,0,43,0,-43
13012,0,0,20,0,-20
13013,0,0,21,0,-21
13014,0,0,9,0,-9
13015,1,0,36,0,-36
13016,1,0,28,0,-28
13017,1,1,757,1327,570
13018,0,0,53,0,-53
13019,1,1,313,1206,893
13020,1,0,32,0,-32
13021,0,0,72,0,-72
13022,0,0,16,0,-16
13023,1,1,179,1269,1090
13024,0,0,42,0,-42
13025,0,0,37,0,-37
13026,1,1,357,1413,1056
13027,1,1,465,1273,808
13028,1,1,193,1948,1755
13029,1,1,364,1821,1457
13030,1,1,1485,1696,211
13031,1,1,241,3134,2893
13032,1,0,16,0,-16
13033,0,0,36,0,-36
13034,1,1,111,1343,1232
13035,1,0,54,0,-54
13036,1,0,34,0,-34
13037,0,0,61,0,-61
13038,1,0,86,0,-86
13039,1,0,23,0,-23
13040,1,1,716,1591,875
13041,1,1,715,1259,544
13042,0,0,113,0,-113
13043,0,0,41,0,-41
13044,0,0,53,0,-53
13045,1,0,12,0,-12
13046,0,0,62,0,-62
13047,0,0,63,0,-63
13048,1,1,527,1617,1090
13049,1,0,101,0,-101
13050,0,0,82,0,-82
13051,1,0,5,0,-5
13052,1,0,111,0,-111
13053,1,1,4167,1345,-2822
13054,1,0,34,0,-34
13055,0,0,16,0,-16
13056,1,1,1667,1256,-411
13057,0,0,26,0,-26
13058,1,0,214,0,-214
13059,0,0,25,0,-25
13060,1,0,176,0,-176
13061,1,1,123,1343,1220
13062,0,0,117,0,-117
13063,1,0,13,0,-13
13064,1,1,195,2052,1857
13065,1,1,793,1372,579
13066,0,0,123,0,-123
13067,1,0,30,0,-30
13068,1,0,67,0,-67
13069,0,0,4,0,-4
13070,1,1,993,2210,1217
13071,0,0,58,0,-58
13072,1,0,91,0,-91
13073,0,0,12,0,-12
13074,0,0,1,0,-1
13075,1,1,734,1397,663
13076,0,0,11,0,-11
13077,1,0,65,0,-65
13078,1,1,1105,1378,273
13079,0,0,13,0,-13
13080,1,1,874,2595,1721
13081,0,0,57,0,-57
13082,0,0,5,0,-5
13083,0,0,3,0,-3
13084,0,0,3,0,-3
13085,0,0,86,0,-86
13086,0,0,26,0,-26
13087,0,0,52,0,-52
13088,0,0,175,0,-175
13089,0,0,33,0,-33
13090,0,0,72,0,-72
13091,0,0,0,0,0
13092,1,0,1,0,-1
13093,1,1,55,1234,1179
13094,0,0,127,0,-127
13095,1,0,26,0,-26
13096,1,0,4,0,-4
13097,0,0,9,0,-9
13098,0,0,44,0,-44
13099,0,0,58,0,-58
13100,0,0,8,0,-8
13101,0,0,136,0,-136
13102,1,1,797,1268,471
13103,1,0,9,0,-9
13104,1,0,16,0,-16
13105,0,0,29,0,-29
13106,1,0,262,0,-262
13107,1,0,31,0,-31
13108,1,0,34,0,-34
13109,1,1,1403,2105,702
13110,1,1,60,1697,1637
13111,1,0,156,0,-156
13112,0,0,248,0,-248
13113,1,0,152,0,-152
13114,1,0,4,0,-4
13115,1,0,46,0,-46
13116,1,1,86,1856,1770
13117,0,0,29,0,-29
13118,1,1,478,1736,1258
13119,1,1,60,1256,1196
13120,1,1,504,1649,1145
13121,0,0,83,0,-83
13122,1,1,1216,1502,286
13123,1,0,78,0,-78
13124,0,0,72,0,-72
13125,1,0,2,0,-2
13126,1,1,155,1227,1072
13127,0,0,1,0,-1
13128,1,0,102,0,-102
13129,1,1,1227,2241,1014
13130,1,0,64,0,-64
13131,1,0,23,0,-23
13132,0,0,5,0,-5
13133,0,0,66,0,-66
13134,1,1,230,1717,1487
13135,0,0,38,0,-38
13136,1,0,20,0,-20
13137,1,1,804,1307,503
13138,1,1,110,1334,1224
13139,1,1,278,1216,938
13140,1,1,190,1315,1125
13141,1,1,660,1570,910
13142,1,0,14,0,-14
13143,1,1,83,1590,1507
13144,1,1,1326,1708,382
13145,0,0,0,0,0
13146,1,1,965,3103,2138
13147,1,1,150,1227,1077
13148,0,0,2,0,-2
13149,0,0,81,0,-81
13150,0,0,38,0,-38
13151,1,0,150,0,-150
13152,1,0,45,0,-45
13153,1,1,767,2491,1724
13154,0,0,158,0,-158
13155,1,1,329,1378,1049
13156,1,0,61,0,-61
13157,1,1,39,1353,1314
13158,0,0,39,0,-39
13159,0,0,1,0,-1
13160,0,0,111,0,-111
13161,1,0,1,0,-1
13162,1,0,67,0,-67
13163,0,0,3,0,-3
13164,1,1,98,1937,1839
13165,1,1,126,1506,1380
13166,1,0,31,0,-31
13167,1,1,63,1235,1172
13168,1,1,194,2162,1968
13169,1,1,225,1212,987
13170,1,0,42,0,-42
13171,1,1,307,1436,1129
13172,0,0,43,0,-43
13173,1,0,1,0,-1
13174,0,0,22,0,-22
13175,0,0,66,0,-66
13176,0,0,72,0,-72
13177,0,0,165,0,-165
13178,1,1,484,1368,884
13179,1,1,583,1218,635
13180,0,0,39,0,-39
13181,0,0,52,0,-52
13182,1,0,116,0,-116
13183,1,0,165,0,-165
13184,1,0,52,0,-52
13185,0,0,81,0,-81
13186,1,1,93,2239,2146
13187,1,0,92,0,-92
13188,1,1,248,1693,1445
13189,0,0,144,0,-144
13190,1,1,552,1326,774
13191,0,0,64,0,-64
13192,1,1,312,1760,1448
13193,1,0,13,0,-13
13194,1,0,91,0,-91
13195,1,1,84,1267,1183
13196,0,0,68,0,-68
13197,1,0,54,0,-54
13198,0,0,7,0,-7
13199,0,0,175,0,-175
13200,1,0,100,0,-100
13201,1,0,54,0,-54
13202,0,0,73,0,-73
13203,1,0,3,0,-3
13204,0,0,37,0,-37
13205,1,0,4,0,-4
13206,1,1,922,1392,470
13207,1,1,411,1219,808
13208,0,0,46,0,-46
13209,1,0,0,0,0
13210,0,0,24,0,-24
13211,0,0,13,0,-13
13212,1,0,36,0,-36
13213,0,0,41,0,-41
13214,0,0,27,0,-27
13215,0,0,6,0,-6
13216,0,0,12,0,-12
13217,0,0,68,0,-68
13218,1,1,783,1688,905
13219,1,0,40,0,-40
13220,1,0,6,0,-6
13221,1,1,293,1304,1011
13222,0,0,198,0,-198
13223,0,0,32,0,-32
13224,1,0,14,0,-14
13225,1,0,4,0,-4
13226,1,0,108,0,-108
13227,1,1,25,1306,1281
13228,1,1,191,1399,1208
13229,1,0,58,0,-58
13230,1,0,49,0,-49
13231,1,0,38,0,-38
13232,0,0,46,0,-46
13233,0,0,57,0,-57
13234,1,1,192,1543,1351
13235,0,0,44,0,-44
13236,1,0,14,0,-14
13237,1,1,478,1270,792
13238,1,0,44,0,-44
13239,1,1,222,1729,1507
13240,1,0,89,0,-89
13241,0,0,12,0,-12
13242,1,0,45,0,-45
13243,1,0,114,0,-114
13244,0,0,121,0,-121
13245,1,0,67,0,-67
13246,1,1,49,1939,1890
13247,1,0,8,0,-8
13248,1,1,615,3559,2944
13249,1,0,45,0,-45
13250,0,0,7,0,-7
13251,1,0,31,0,-31
13252,0,0,63,0,-63
13253,1,0,17,0,-17
13254,1,1,307,1570,1263
13255,1,1,1148,2467,1319
13256,1,1,170,1545,1375
13257,1,1,2048,1512,-536
13258,1,1,524,2231,1707
13259,0,0,20,0,-20
13260,1,0,1,0,-1
13261,1,1,272,1207,935
13262,0,0,97,0,-97
13263,1,0,200,0,-200
13264,0,0,78,0,-78
13265,1,1,197,1542,1345
13266,0,0,98,0,-98
13267,1,0,312,0,-312
13268,1,1,221,1234,1013
13269,0,0,10,0,-10
13270,1,1,44,1200,1156
13271,1,0,7,0,-7
13272,1,1,134,1289,1155
13273,0,0,27,0,-27
13274,1,0,29,0,-29
13275,0,0,13,0,-13
13276,0,0,12,0,-12
13277,1,1,300,1252,952
13278,1,0,11,0,-11
13279,0,0,111,0,-111
13280,1,0,19,0,-19
13281,1,0,4,0,-4
13282,1,1,201,1230,1029
13283,1,1,460,1384,924
13284,0,0,12,0,-12
13285,1,0,34,0,-34
13286,0,0,10,0,-10
13287,1,1,167,2116,1949
13288,1,0,21,0,-21
13289,1,1,428,1266,838
13290,0,0,2,0,-2
13291,1,0,17,0,-17
13292,1,1,237,1400,1163
13293,0,0,24,0,-24
13294,1,0,3,0,-3
13295,1,0,120,0,-120
13296,1,1,147,1306,1159
13297,1,0,33,0,-33
13298,1,0,19,0,-19
13299,0,0,65,0,-65
13300,1,1,2934,1355,-1579
13301,1,0,1,0,-1
13302,0,0,82,0,-82
13303,1,0,9,0,-9
13304,1,1,469,1348,879
13305,0,0,60,0,-60
13306,0,0,10,0,-10
13307,1,1,153,3760,3607
13308,1,0,16,0,-16
13309,1,0,30,0,-30
13310,1,1,144,1233,1089
13311,1,1,427,1538,1111
13312,1,0,4,0,-4
13313,1,1,1051,2205,1154
13314,0,0,50,0,-50
13315,0,0,25,0,-25
13316,1,1,319,1244,925
13317,0,0,79,0,-79
13318,1,1,609,1440,831
13319,0,0,56,0,-56
13320,0,0,31,0,-31
13321,1,0,46,0,-46
13322,1,0,36,0,-36
13323,0,0,4,0,-4
13324,0,0,16,0,-16
13325,1,1,281,1334,1053
13326,1,1,105,1259,1154
13327,0,0,14,0,-14
13328,1,0,79,0,-79
13329,0,0,5,0,-5
13330,1,0,44,0,-44
13331,0,0,22,0,-22
13332,1,0,24,0,-24
13333,1,0,21,0,-21
13334,0,0,12,0,-12
13335,0,0,30,0,-30
13336,0,0,53,0,-53
13337,0,0,26,0,-26
13338,1,1,173,1203,1030
13339,1,0,37,0,-37
13340,0,0,110,0,-110
13341,1,1,157,1331,1174
13342,1,1,744,1304,560
13343,0,0,81,0,-81
13344,1,1,351,1300,949
13345,1,0,4,0,-4
13346,1,1,959,1245,286
13347,0,0,23,0,-23
13348,0,0,11,0,-11
13349,1,0,189,0,-189
13350,0,0,62,0,-62
13351,0,0,31,0,-31
13352,1,0,43,0,-43
13353,0,0,3,0,-3
13354,1,0,97,0,-97
13355,1,0,58,0,-58
13356,1,0,47,0,-47
13357,0,0,62,0,-62
13358,1,1,386,1371,985
13359,1,1,634,1250,616
13360,1,0,5,0,-5
13361,1,1,392,1320,928
13362,1,0,83,0,-83
13363,1,1,329,1446,1117
13364,1,1,343,2281,1938
13365,0,0,37,0,-37
13366,1,0,0,0,0
13367,1,0,92,0,-92
13368,1,1,914,1275,361
13369,1,0,31,0,-31
13370,0,0,6,0,-6
13371,0,0,20,0,-20
13372,1,0,80,0,-80
13373,1,1,253,1681,1428
13374,0,0,8,0,-8
13375,0,0,16,0,-16
13376,1,1,855,1369,514
13377,0,0,27,0,-27
13378,1,1,1164,1968,804
13379,1,0,30,0,-30
13380,0,0,60,0,-60
13381,1,1,81,1500,1419
13382,0,0,4,0,-4
13383,1,0,111,0,-111
13384,0,0,30,0,-30
13385,1,1,137,1598,1461
13386,0,0,18,0,-18
13387,0,0,5,0,-5
13388,0,0,42,0,-42
13389,1,1,510,1358,848
13390,1,1,1035,2631,1596
13391,0,0,43,0,-43
13392,0,0,31,0,-31
13393,0,0,7,0,-7
13394,0,0,25,0,-25
13395,0,0,72,0,-72
13396,0,0,25,0,-25
13397,1,0,52,0,-52
13398,1,1,618,1865,1247
13399,0,0,10,0,-10
13400,1,1,796,1491,695
13401,0,0,11,0,-11
13402,0,0,71,0,-71
13403,0,0,10,0,-10
13404,0,0,73,0,-73
13405,1,1,187,1433,1246
13406,0,0,74,0,-74
13407,1,0,12,0,-12
13408,1,0,0,0,0
13409,1,0,0,0,0
13410,1,0,53,0,-53
13411,0,0,161,0,-161
13412,0,0,154,0,-154
13413,1,1,125,2134,2009
13414,1,0,67,0,-67
13415,1,1,398,1397,999
13416,0,0,222,0,-222
13417,0,0,52,0,-52
13418,1,0,13,0,-13
13419,0,0,48,0,-48
13420,0,0,45,0,-45
13421,1,0,98,0,-98
13422,1,0,99,0,-99
13423,0,0,91,0,-91
13424,0,0,12,0,-12
13425,1,0,26,0,-26
13426,0,0,155,0,-155
13427,0,0,21,0,-21
13428,1,1,1958,1412,-546
13429,1,1,298,1249,951
13430,1,1,236,1646,1410
13431,1,1,617,1433,816
13432,1,0,8,0,-8
13433,1,0,14,0,-14
13434,0,0,9,0,-9
13435,1,1,540,3863,3323
13436,1,1,50,1220,1170
13437,1,1,513,1384,871
13438,0,0,8,0,-8
13439,0,0,26,0,-26
13440,0,0,125,0,-125
13441,0,0,115,0,-115
13442,1,0,203,0,-203
13443,1,0,45,0,-45
13444,1,0,14,0,-14
13445,1,0,56,0,-56
13446,0,0,27,0,-27
13447,0,0,49,0,-49
13448,0,0,24,0,-24
13449,1,0,75,0,-75
13450,0,0,41,0,-41
13451,1,1,525,2261,1736
13452,1,0,15,0,-15
13453,0,0,68,0,-68
13454,0,0,42,0,-42
13455,1,1,278,1886,1608
13456,1,1,86,1465,1379
13457,1,1,164,1581,1417
13458,1,0,4,0,-4
13459,0,0,66,0,-66
13460,1,1,255,1263,1008
13461,1,1,981,2782,1801
13462,0,0,103,0,-103
13463,0,0,2,0,-2
13464,1,1,524,1243,719
13465,0,0,12,0,-12
13466,0,0,243,0,-243
13467,0,0,61,0,-61
13468,1,1,645,1815,1170
13469,0,0,2,0,-2
13470,0,0,13,0,-13
13471,0,0,158,0,-158
13472,1,1,559,1215,656
13473,1,0,21,0,-21
13474,1,0,53,0,-53
13475,0,0,63,0,-63
13476,0,0,29,0,-29
13477,1,0,1,0,-1
13478,1,0,16,0,-16
13479,0,0,99,0,-99
13480,1,0,9,0,-9
13481,0,0,76,0,-76
13482,1,1,92,1354,1262
13483,1,1,285,1317,1032
13484,1,1,1576,1271,-305
13485,1,0,32,0,-32
13486,1,1,1069,1205,136
13487,1,0,143,0,-143
13488,1,1,67,2670,2603
13489,0,0,157,0,-157
13490,1,1,268,1347,1079
13491,0,0,31,0,-31
13492,0,0,3,0,-3
13493,1,0,9,0,-9
13494,1,0,43,0,-43
13495,1,1,871,1316,445
13496,0,0,6,0,-6
13497,1,1,163,2112,1949
13498,0,0,1,0,-1
13499,0,0,18,0,-18
13500,1,0,4,0,-4
13501,0,0,36,0,-36
13502,0,0,48,0,-48
13503,1,0,0,0,0
13504,1,0,82,0,-82
13505,0,0,93,0,-93
13506,1,0,1,0,-1
13507,1,0,53,0,-53
13508,1,1,166,1436,1270
13509,0,0,25,0,-25
13510,0,0,70,0,-70
13511,0,0,150,0,-150
13512,1,0,87,0,-87
13513,1,0,51,0,-51
13514,1,0,62,0,-62
13515,1,0,35,0,-35
13516,1,0,16,0,-16
13517,1,1,1076,1602,526
13518,0,0,4,0,-4
13519,0,0,92,0,-92
13520,1,0,64,0,-64
13521,1,0,173,0,-173
13522,0,0,124,0,-124
13523,0,0,13,0,-13
13524,1,0,53,0,-53
13525,0,0,12,0,-12
13526,1,1,451,1451,1000
13527,1,0,89,0,-89
13528,1,1,333,1445,1112
13529,1,0,71,0,-71
13530,1,0,6,0,-6
13531,1,1,660,1925,1265
13532,0,0,96,0,-96
13533,1,1,512,1730,1218
13534,1,1,418,1527,1109
13535,1,1,1549,1925,376
13536,1,1,168,1806,1638
13537,1,1,804,1378,574
13538,1,1,468,2711,2243
13539,1,1,236,1436,1200
13540,1,0,1,0,-1
13541,0,0,14,0,-14
13542,1,0,91,0,-91
13543,1,0,61,0,-61
13544,0,0,16,0,-16
13545,0,0,134,0,-134
13546,1,1,640,1298,658
13547,0,0,53,0,-53
13548,0,0,56,0,-56
13549,1,1,240,1396,1156
13550,1,0,14,0,-14
13551,1,1,317,1426,1109
13552,1,0,12,0,-12
13553,0,0,80,0,-80
13554,1,1,217,1709,1492
13555,0,0,21,0,-21
13556,1,1,527,1385,858
13557,1,0,39,0,-39
13558,1,0,92,0,-92
13559,0,0,15,0,-15
13560,0,0,82,0,-82
13561,1,0,21,0,-21
13562,0,0,43,0,-43
13563,0,0,33,0,-33
13564,0,0,76,0,-76
13565,0,0,95,0,-95
13566,1,1,1026,1335,309
13567,1,1,91,1349,1258
13568,0,0,129,0,-129
13569,1,0,16,0,-16
13570,1,1,111,1375,1264
13571,1,1,329,1300,971
13572,1,1,340,1331,991
13573,0,0,230,0,-230
13574,1,1,318,2325,2007
13575,1,0,5,0,-5
13576,0,0,62,0,-62
13577,1,1,1417,1492,75
13578,0,0,26,0,-26
13579,1,1,486,1431,945
13580,0,0,4,0,-4
13581,1,0,28,0,-28
13582,0,0,0,0,0
13583,1,1,158,1509,1351
13584,1,0,11,0,-11
13585,0,0,2,0,-2
13586,1,0,38,0,-38
13587,1,1,293,1300,1007
13588,1,1,243,1263,1020
13589,1,1,820,1436,616
13590,0,0,36,0,-36
13591,0,0,16,0,-16
13592,1,0,52,0,-52
13593,1,1,134,1598,1464
13594,0,0,6,0,-6
13595,1,0,16,0,-16
13596,0,0,3,0,-3
13597,1,1,736,4629,3893
13598,0,0,103,0,-103
13599,1,0,32,0,-32
13600,1,0,157,0,-157
13601,1,1,504,1319,815
13602,0,0,0,0,0
13603,0,0,56,0,-56
13604,0,0,23,0,-23
13605,0,0,19,0,-19
13606,1,1,24,2749,2725
13607,1,0,67,0,-67
13608,0,0,28,0,-28
13609,1,1,1110,1225,115
13610,1,0,15,0,-15
13611,0,0,26,0,-26
13612,0,0,16,0,-16
13613,0,0,41,0,-41
13614,0,0,17,0,-17
13615,0,0,44,0,-44
13616,1,0,100,0,-100
13617,1,0,129,0,-129
13618,0,0,11,0,-11
13619,0,0,14,0,-14
13620,1,1,291,1456,1165
13621,0,0,5,0,-5
13622,1,1,84,1533,1449
13623,0,0,63,0,-63
13624,1,1,143,1272,1129
13625,1,0,144,0,-144
13626,1,1,1046,1514,468
13627,1,1,327,1335,1008
13628,0,0,38,0,-38
13629,1,1,248,1297,1049
13630,1,1,516,1819,1303
13631,1,1,324,1262,938
13632,1,1,428,1906,1478
13633,1,1,714,1596,882
13634,0,0,46,0,-46
13635,0,0,101,0,-101
13636,1,1,238,4082,3844
13637,0,0,130,0,-130
13638,1,0,46,0,-46
13639,0,0,56,0,-56
13640,0,0,46,0,-46
13641,1,1,72,1226,1154
13642,0,0,21,0,-21
13643,1,1,216,1430,1214
13644,0,0,29,0,-29
13645,0,0,53,0,-53
13646,1,0,75,0,-75
13647,1,0,60,0,-60
13648,1,0,11,0,-11
13649,0,0,14,0,-14
13650,1,0,0,0,0
13651,0,0,55,0,-55
13652,1,1,972,2342,1370
13653,0,0,48,0,-48
13654,0,0,123,0,-123
13655,1,1,806,1273,467
13656,0,0,30,0,-30
13657,1,0,14,0,-14
13658,0,0,115,0,-115
13659,0,0,171,0,-171
13660,1,1,247,1491,1244
13661,1,0,13,0,-13
13662,0,0,22,0,-22
13663,0,0,7,0,-7
13664,1,0,179,0,-179
13665,1,1,222,1274,1052
13666,0,0,13,0,-13
13667,1,1,436,1510,1074
13668,0,0,2,0,-2
13669,0,0,53,0,-53
13670,1,0,126,0,-126
13671,1,1,843,1799,956
13672,1,1,1333,1928,595
13673,1,1,1179,1231,52
13674,0,0,21,0,-21
13675,0,0,5,0,-5
13676,0,0,242,0,-242
13677,1,1,867,1781,914
13678,0,0,58,0,-58
13679,0,0,101,0,-101
13680,1,1,713,1233,520
13681,1,1,490,1909,1419
13682,0,0,61,0,-61
13683,1,0,0,0,0
13684,1,0,12,0,-12
13685,0,0,13,0,-13
13686,0,0,5,0,-5
13687,0,0,1,0,-1
13688,0,0,9,0,-9
13689,0,0,60,0,-60
13690,1,1,806,1570,764
13691,1,1,231,1288,1057
13692,1,1,385,1275,890
13693,0,0,3,0,-3
13694,0,0,20,0,-20
13695,0,0,25,0,-25
13696,1,1,596,1304,708
13697,1,0,41,0,-41
13698,0,0,48,0,-48
13699,0,0,33,0,-33
13700,1,1,228,1218,990
13701,1,0,11,0,-11
13702,1,0,61,0,-61
13703,1,1,1068,1575,507
13704,0,0,31,0,-31
13705,0,0,21,0,-21
13706,1,0,77,0,-77
13707,1,0,15,0,-15
13708,1,0,33,0,-33
13709,1,1,2066,1664,-402
13710,1,1,577,1465,888
13711,1,0,21,0,-21
13712,1,0,86,0,-86
13713,1,0,97,0,-97
13714,1,0,31,0,-31
13715,0,0,3,0,-3
13716,1,0,111,0,-111
13717,0,0,12,0,-12
13718,0,0,33,0,-33
13719,0,0,131,0,-131
13720,0,0,68,0,-68
13721,1,0,22,0,-22
13722,1,1,580,1353,773
13723,1,0,16,0,-16
13724,0,0,11,0,-11
13725,1,1,337,1400,1063
13726,0,0,47,0,-47
13727,0,0,30,0,-30
13728,0,0,38,0,-38
13729,0,0,81,0,-81
13730,1,1,175,1278,1103
13731,1,0,70,0,-70
13732,1,0,53,0,-53
13733,0,0,22,0,-22
13734,0,0,48,0,-48
13735,1,1,88,1247,1159
13736,0,0,72,0,-72
13737,1,0,70,0,-70
13738,1,1,74,1287,1213
13739,1,1,599,1286,687
13740,1,1,1826,1464,-362
13741,1,0,25,0,-25
13742,1,1,312,1304,992
13743,1,1,213,1372,1159
13744,0,0,16,0,-16
13745,0,0,73,0,-73
13746,1,1,381,1578,1197
13747,0,0,63,0,-63
13748,1,0,10,0,-10
13749,1,0,94,0,-94
13750,0,0,68,0,-68
13751,1,1,364,1212,848
13752,1,1,318,1383,1065
13753,0,0,73,0,-73
13754,0,0,126,0,-126
13755,1,0,13,0,-13
13756,0,0,20,0,-20
13757,1,1,1874,1202,-672
13758,0,0,15,0,-15
13759,1,1,190,1299,1109
13760,0,0,45,0,-45
13761,0,0,35,0,-35
13762,1,1,1441,1929,488
13763,1,1,32,2037,2005
13764,0,0,35,0,-35
13765,1,0,17,0,-17
13766,1,0,67,0,-67
13767,0,0,0,0,0
13768,1,1,23,1217,1194
13769,0,0,14,0,-14
13770,1,0,5,0,-5
13771,0,0,19,0,-19
13772,0,0,111,0,-111
13773,1,0,31,0,-31
13774,1,1,1299,1218,-81
13775,1,0,161,0,-161
13776,1,1,457,1533,1076
13777,1,1,282,1290,1008
13778,0,0,41,0,-41
13779,1,1,645,1403,758
13780,0,0,44,0,-44
13781,1,1,180,1208,1028
13782,0,0,20,0,-20
13783,1,1,199,1211,1012
13784,0,0,34,0,-34
13785,0,0,133,0,-133
13786,1,1,333,1358,1025
13787,1,1,211,1239,1028
13788,0,0,14,0,-14
13789,0,0,140,0,-140
13790,1,1,129,1598,1469
13791,1,0,42,0,-42
13792,0,0,32,0,-32
13793,1,0,35,0,-35
13794,1,0,58,0,-58
13795,0,0,10,0,-10
13796,0,0,2,0,-2
13797,0,0,19,0,-19
13798,1,0,62,0,-62
13799,1,0,56,0,-56
13800,1,0,2,0,-2
13801,1,1,202,1994,1792
13802,0,0,31,0,-31
13803,1,1,476,1353,877
13804,1,1,48,1301,1253
13805,0,0,4,0,-4
13806,0,0,34,0,-34
13807,1,0,53,0,-53
13808,0,0,119,0,-119
13809,0,0,0,0,0
13810,1,1,1131,1253,122
13811,0,0,2,0,-2
13812,1,0,67,0,-67
13813,0,0,93,0,-93
13814,1,0,60,0,-60
13815,0,0,61,0,-61
13816,0,0,39,0,-39
13817,1,1,129,1782,1653
13818,0,0,12,0,-12
13819,1,0,57,0,-57
13820,1,1,193,1488,1295
13821,1,0,38,0,-38
13822,1,0,79,0,-79
13823,1,1,654,1212,558
13824,1,1,1720,1738,18
13825,1,0,58,0,-58
13826,0,0,14,0,-14
13827,1,1,2267,3015,748
13828,0,0,66,0,-66
13829,1,0,120,0,-120
13830,0,0,21,0,-21
13831,0,0,17,0,-17
13832,0,0,179,0,-179
13833,0,0,10,0,-10
13834,1,0,71,0,-71
13835,1,1,990,1220,230
13836,0,0,44,0,-44
13837,1,0,51,0,-51
13838,1,0,32,0,-32
13839,1,1,943,1562,619
13840,0,0,21,0,-21
13841,0,0,0,0,0
13842,0,0,2,0,-2
13843,1,0,88,0,-88
13844,1,0,45,0,-45
13845,1,0,122,0,-122
13846,1,1,712,1311,599
13847,0,0,132,0,-132
13848,1,0,69,0,-69
13849,1,1,284,1496,1212
13850,1,1,1008,1294,286
13851,0,0,35,0,-35
13852,0,0,53,0,-53
13853,1,0,55,0,-55
13854,1,0,6,0,-6
13855,1,1,259,1415,1156
13856,1,1,360,2350,1990
13857,1,0,17,0,-17
13858,0,0,83,0,-83
13859,0,0,8,0,-8
13860,0,0,15,0,-15
13861,0,0,108,0,-108
13862,0,0,5,0,-5
13863,1,0,170,0,-170
13864,1,0,47,0,-47
13865,1,0,16,0,-16
13866,0,0,24,0,-24
13867,1,1,557,1258,701
13868,1,1,104,1599,1495
13869,1,1,1310,2702,1392
13870,1,0,98,0,-98
13871,1,0,44,0,-44
13872,1,1,1605,1534,-71
13873,0,0,116,0,-116
13874,0,0,65,0,-65
13875,1,0,66,0,-66
13876,1,0,102,0,-102
13877,1,0,125,0,-125
13878,1,1,1412,1879,467
13879,0,0,58,0,-58
13880,0,0,57,0,-57
13881,1,0,12,0,-12
13882,0,0,48,0,-48
13883,1,0,74,0,-74
13884,0,0,17,0,-17
13885,1,1,1416,1232,-184
13886,1,0,59,0,-59
13887,0,0,30,0,-30
13888,1,1,268,1295,1027
13889,0,0,32,0,-32
13890,1,0,64,0,-64
13891,0,0,12,0,-12
13892,1,0,48,0,-48
13893,1,1,366,1510,1144
13894,1,1,3572,2208,-1364
13895,0,0,28,0,-28
13896,1,1,1468,1734,266
13897,0,0,22,0,-22
13898,1,0,9,0,-9
13899,1,0,32,0,-32
13900,0,0,3,0,-3
13901,1,1,484,1923,1439
13902,1,1,350,2317,1967
13903,0,0,82,0,-82
13904,1,0,19,0,-19
13905,0,0,65,0,-65
13906,1,1,86,1239,1153
13907,1,1,1830,1330,-500
13908,1,0,2,0,-2
13909,1,0,14,0,-14
13910,1,1,297,1397,1100
13911,0,0,45,0,-45
13912,0,0,107,0,-107
13913,1,0,147,0,-147
13914,0,0,49,0,-49
13915,0,0,120,0,-120
13916,0,0,17,0,-17
13917,0,0,74,0,-74
13918,1,1,271,1346,1075
13919,1,1,846,1234,388
13920,0,0,275,0,-275
13921,0,0,107,0,-107
13922,1,0,9,0,-9
13923,1,0,123,0,-123
13924,1,1,650,1338,688
13925,0,0,0,0,0
13926,1,1,269,1250,981
13927,1,0,2,0,-2
13928,1,1,266,1225,959
13929,0,0,137,0,-137
13930,0,0,22,0,-22
13931,0,0,4,0,-4
13932,0,0,30,0,-30
13933,1,1,457,1335,878
13934,1,0,123,0,-123
13935,0,0,40,0,-40
13936,1,0,92,0,-92
13937,1,0,56,0,-56
13938,1,1,940,1335,395
13939,1,1,327,1996,1669
13940,0,0,142,0,-142
13941,0,0,32,0,-32
13942,1,1,183,1325,1142
13943,0,0,6,0,-6
13944,1,0,15,0,-15
13945,1,1,240,1875,1635
13946,1,0,27,0,-27
13947,1,1,448,3154,2706
13948,1,1,18,2501,2483
13949,0,0,40,0,-40
13950,0,0,145,0,-145
13951,1,0,12,0,-12
13952,1,1,409,1733,1324
13953,0,0,12,0,-12
13954,0,0,82,0,-82
13955,1,1,282,1486,1204
13956,1,0,13,0,-13
13957,0,0,20,0,-20
13958,1,0,28,0,-28
13959,1,0,6,0,-6
13960,0,0,104,0,-104
13961,1,1,186,1453,1267
13962,1,1,135,1453,1318
13963,0,0,58,0,-58
13964,1,0,17,0,-17
13965,0,0,23,0,-23
13966,0,0,34,0,-34
13967,1,1,164,1391,1227
13968,0,0,175,0,-175
13969,1,0,18,0,-18
13970,0,0,29,0,-29
13971,1,0,9,0,-9
13972,0,0,194,0,-194
13973,1,1,1037,1382,345
13974,1,1,66,1250,1184
13975,1,1,246,1212,966
13976,0,0,10,0,-10
13977,1,0,122,0,-122
13978,1,1,484,1224,740
13979,1,0,20,0,-20
13980,1,0,184,0,-184
13981,1,0,50,0,-50
13982,0,0,60,0,-60
13983,0,0,63,0,-63
13984,1,0,16,0,-16
13985,1,1,224,1407,1183
13986,1,0,125,0,-125
13987,1,0,79,0,-79
13988,1,0,93,0,-93
13989,1,0,5,0,-5
13990,1,0,36,0,-36
13991,0,0,98,0,-98
13992,0,0,23,0,-23
13993,1,1,440,1919,1479
13994,0,0,47,0,-47
13995,0,0,4,0,-4
13996,1,0,111,0,-111
13997,1,0,90,0,-90
13998,1,0,28,0,-28
13999,0,0,24,0,-24
14000,0,0,200,0,-200
14001,0,0,191,0,-191
14002,0,0,25,0,-25
14003,1,1,232,1858,1626
14004,0,0,74,0,-74
14005,1,1,498,1564,1066
14006,1,1,304,2061,1757
14007,1,0,67,0,-67
14008,0,0,9,0,-9
14009,1,1,3575,2272,-1303
14010,0,0,23,0,-23
14011,0,0,90,0,-90
14012,0,0,164,0,-164
14013,1,0,15,0,-15
14014,0,0,18,0,-18
14015,1,0,127,0,-127
14016,0,0,102,0,-102
14017,0,0,136,0,-136
14018,0,0,20,0,-20
14019,1,0,80,0,-80
14020,1,0,44,0,-44
14021,0,0,96,0,-96
14022,1,1,477,1848,1371
14023,0,0,59,0,-59
14024,0,0,32,0,-32
14025,0,0,76,0,-76
14026,1,1,669,1750,1081
14027,0,0,134,0,-134
14028,0,0,72,0,-72
14029,0,0,29,0,-29
14030,1,0,134,0,-134
14031,1,1,1748,1202,-546
14032,0,0,60,0,-60
14033,1,1,902,1639,737
14034,0,0,20,0,-20
14035,1,0,35,0,-35
14036,0,0,22,0,-22
14037,0,0,25,0,-25
14038,1,1,1795,1310,-485
14039,0,0,17,0,-17
14040,1,0,9,0,-9
14041,1,1,80,1240,1160
14042,0,0,75,0,-75
14043,1,0,123,0,-123
14044,1,1,332,1209,877
14045,1,1,1469,1304,-165
14046,1,0,4,0,-4
14047,1,0,108,0,-108
14048,1,1,800,1342,542
14049,1,1,414,1734,1320
14050,0,0,54,0,-54
14051,0,0,21,0,-21
14052,0,0,3,0,-3
14053,1,1,178,1891,1713
14054,1,0,2,0,-2
14055,1,0,67,0,-67
14056,0,0,94,0,-94
14057,0,0,129,0,-129
14058,1,0,11,0,-11
14059,0,0,73,0,-73
14060,0,0,10,0,-10
14061,1,1,1302,1234,-68
14062,0,0,95,0,-95
14063,1,0,25,0,-25
14064,0,0,80,0,-80
14065,1,0,2,0,-2
14066,1,1,472,1241,769
14067,1,0,0,0,0
14068,1,1,180,1355,1175
14069,1,1,448,1426,978
14070,1,1,160,1554,1394
14071,1,1,421,1657,1236
14072,0,0,38,0,-38
14073,0,0,114,0,-114
14074,0,0,2,0,-2
14075,0,0,25,0,-25
14076,0,0,110,0,-110
14077,1,1,182,1305,1123
14078,1,1,557,1267,710
14079,0,0,28,0,-28
14080,1,0,34,0,-34
14081,0,0,60,0,-60
14082,0,0,21,0,-21
14083,1,0,4,0,-4
14084,0,0,43,0,-43
14085,0,0,53,0,-53
14086,0,0,10,0,-10
14087,1,1,461,1784,1323
14088,0,0,9,0,-9
14089,0,0,6,0,-6
14090,1,1,73,1245,1172
14091,0,0,5,0,-5
14092,1,0,21,0,-21
14093,1,0,69,0,-69
14094,0,0,59,0,-59
14095,1,1,1095,2710,1615
14096,0,0,129,0,-129
14097,0,0,3,0,-3
14098,1,0,56,0,-56
14099,0,0,18,0,-18
14100,0,0,123,0,-123
14101,1,1,389,2304,1915
14102,0,0,7,0,-7
14103,1,1,76,1248,1172
14104,1,0,31,0,-31
14105,0,0,20,0,-20
14106,1,1,419,1247,828
14107,1,1,85,1655,1570
14108,0,0,25,0,-25
14109,1,0,1,0,-1
14110,1,1,379,1395,1016
14111,1,0,10,0,-10
14112,0,0,0,0,0
14113,0,0,70,0,-70
14114,1,0,2,0,-2
14115,0,0,11,0,-11
14116,1,0,166,0,-166
14117,1,0,42,0,-42
14118,1,1,381,1270,889
14119,1,0,1,0,-1
14120,0,0,35,0,-35
14121,1,1,429,1441,1012
14122,0,0,57,0,-57
14123,0,0,54,0,-54
14124,0,0,6,0,-6
14125,1,0,42,0,-42
14126,0,0,24,0,-24
14127,1,1,802,1222,420
14128,1,0,105,0,-105
14129,1,0,182,0,-182
14130,0,0,16,0,-16
14131,0,0,70,0,-70
14132,1,1,171,1293,1122
14133,1,1,664,1420,756
14134,0,0,55,0,-55
14135,0,0,20,0,-20
14136,1,0,7,0,-7
14137,0,0,7,0,-7
14138,1,1,473,1224,751
14139,1,1,464,1556,1092
14140,1,0,34,0,-34
14141,0,0,55,0,-55
14142,0,0,120,0,-120
14143,0,0,80,0,-80
14144,1,1,2040,1505,-535
14145,1,0,39,0,-39
14146,0,0,74,0,-74
14147,0,0,163,0,-163
14148,1,0,28,0,-28
14149,1,1,158,1393,1235
14150,1,0,9,0,-9
14151,0,0,45,0,-45
14152,1,0,140,0,-140
14153,1,0,33,0,-33
14154,0,0,114,0,-114
14155,0,0,26,0,-26
14156,0,0,65,0,-65
14157,1,0,2,0,-2
14158,1,1,891,1323,432
14159,0,0,4,0,-4
14160,0,0,32,0,-32
14161,0,0,49,0,-49
14162,0,0,18,0,-18
14163,1,1,908,1276,368
14164,0,0,31,0,-31
14165,0,0,85,0,-85
14166,1,1,222,1260,1038
14167,0,0,28,0,-28
14168,0,0,32,0,-32
14169,0,0,32,0,-32
14170,0,0,84,0,-84
14171,1,0,53,0,-53
14172,1,0,48,0,-48
14173,1,1,295,1695,1400
14174,0,0,15,0,-15
14175,1,1,1561,1263,-298
14176,1,0,87,0,-87
14177,1,0,27,0,-27
14178,1,1,559,1237,678
14179,1,1,611,2998,2387
14180,0,0,45,0,-45
14181,1,0,116,0,-116
14182,1,1,1356,1407,51
14183,1,1,182,2087,1905
14184,1,1,649,1843,1194
14185,1,0,82,0,-82
14186,1,0,68,0,-68
14187,0,0,16,0,-16
14188,0,0,91,0,-91
14189,1,0,19,0,-19
14190,1,1,152,1473,1321
14191,1,1,1452,1277,-175
14192,0,0,21,0,-21
14193,1,1,170,1795,1625
14194,1,1,1112,1249,137
14195,0,0,15,0,-15
14196,0,0,55,0,-55
14197,1,1,296,1278,982
14198,0,0,34,0,-34
14199,1,0,22,0,-22
14200,0,0,23,0,-23
14201,0,0,33,0,-33
14202,0,0,13,0,-13
14203,0,0,5,0,-5
14204,0,0,10,0,-10
14205,1,1,257,2111,1854
14206,1,1,2315,1317,-998
14207,1,0,61,0,-61
14208,1,0,10,0,-10
14209,1,1,96,1260,1164
14210,0,0,37,0,-37
14211,1,1,411,2929,2518
14212,1,0,35,0,-35
14213,1,0,20,0,-20
14214,1,0,71,0,-71
14215,0,0,20,0,-20
14216,0,0,22,0,-22
14217,0,0,83,0,-83
14218,0,0,85,0,-85
14219,1,0,9,0,-9
14220,1,0,9,0,-9
14221,0,0,67,0,-67
14222,0,0,11,0,-11
14223,1,1,327,1715,1388
14224,0,0,9,0,-9
14225,1,1,1372,1274,-98
14226,1,1,921,1674,753
14227,1,0,48,0,-48
14228,1,1,132,1845,1713
14229,1,1,677,1404,727
14230,1,0,75,0,-75
14231,0,0,21,0,-21
14232,1,1,213,1231,1018
14233,1,1,322,1211,889
14234,1,0,30,0,-30
14235,1,1,1370,1830,460
14236,1,0,93,0,-93
14237,0,0,14,0,-14
14238,1,0,1,0,-1
14239,1,1,174,1611,1437
14240,1,1,232,1224,992
14241,0,0,20,0,-20
14242,1,1,228,1275,1047
14243,1,1,223,1331,1108
14244,1,1,122,1380,1258
14245,1,1,1706,1529,-177
14246,1,1,429,1231,802
14247,1,1,322,2446,2124
14248,0,0,62,0,-62
14249,0,0,18,0,-18
14250,0,0,27,0,-27
14251,1,0,162,0,-162
14252,0,0,85,0,-85
14253,0,0,11,0,-11
14254,0,0,299,0,-299
14255,1,0,2,0,-2
14256,1,1,1138,1251,113
14257,1,0,73,0,-73
14258,1,0,4,0,-4
14259,1,1,564,1255,691
14260,0,0,143,0,-143
14261,0,0,4,0,-4
14262,1,0,42,0,-42
14263,0,0,66,0,-66
14264,0,0,1,0,-1
14265,1,0,11,0,-11
14266,0,0,51,0,-51
14267,1,0,91,0,-91
14268,1,0,24,0,-24
14269,0,0,14,0,-14
14270,1,0,40,0,-40
14271,0,0,62,0,-62
14272,1,1,241,1335,1094
14273,1,0,13,0,-13
14274,1,0,73,0,-73
14275,1,0,8,0,-8
14276,1,0,6,0,-6
14277,1,1,273,3199,2926
14278,0,0,65,0,-65
14279,1,1,227,1334,1107
14280,1,0,179,0,-179
14281,1,0,42,0,-42
14282,1,0,29,0,-29
14283,0,0,94,0,-94
14284,1,1,305,1507,1202
14285,0,0,18,0,-18
14286,1,1,384,1218,834
14287,0,0,4,0,-4
14288,0,0,34,0,-34
14289,1,1,148,1392,1244
14290,1,1,1085,2912,1827
14291,0,0,233,0,-233
14292,0,0,30,0,-30
14293,1,1,721,2622,1901
14294,0,0,35,0,-35
14295,0,0,86,0,-86
14296,0,0,180,0,-180
14297,0,0,7,0,-7
14298,1,1,199,1273,1074
14299,1,1,252,1771,1519
14300,1,1,173,1722,1549
14301,1,0,4,0,-4
14302,0,0,10,0,-10
14303,1,0,4,0,-4
14304,0,0,6,0,-6
14305,1,0,46,0,-46
14306,1,0,66,0,-66
14307,0,0,84,0,-84
14308,1,0,29,0,-29
14309,1,0,35,0,-35
14310,1,1,112,1294,1182
14311,0,0,0,0,0
14312,0,0,28,0,-28
14313,0,0,43,0,-43
14314,0,0,164,0,-164
14315,1,1,54,1286,1232
14316,0,0,19,0,-19
14317,1,1,1010,1646,636
14318,0,0,5,0,-5
14319,0,0,81,0,-81
14320,1,0,8,0,-8
14321,0,0,6,0,-6
14322,0,0,3,0,-3
14323,1,0,0,0,0
14324,1,1,506,1335,829
14325,0,0,32,0,-32
14326,1,0,0,0,0
14327,1,0,203,0,-203
14328,1,0,92,0,-92
14329,0,0,281,0,-281
14330,0,0,94,0,-94
14331,1,1,709,1745,1036
14332,1,1,297,1376,1079
14333,0,0,122,0,-122
14334,1,1,246,1882,1636
14335,1,1,263,2130,1867
14336,0,0,14,0,-14
14337,0,0,19,0,-19
14338,0,0,66,0,-66
14339,0,0,19,0,-19
14340,1,0,3,0,-3
14341,1,1,318,1352,1034
14342,0,0,27,0,-27
14343,1,0,11,0,-11
14344,0,0,187,0,-187
14345,0,0,19,0,-19
14346,1,1,697,1342,645
14347,1,1,2640,1416,-1224
14348,1,1,341,1298,957
14349,1,0,38,0,-38
14350,1,0,77,0,-77
14351,1,0,11,0,-11
14352,1,1,704,1268,564
14353,0,0,100,0,-100
14354,1,0,42,0,-42
14355,1,1,363,1521,1158
14356,0,0,54,0,-54
14357,1,1,86,1363,1277
14358,1,0,54,0,-54
14359,0,0,124,0,-124
14360,1,1,2135,1296,-839
14361,1,1,1920,1356,-564
14362,0,0,101,0,-101
14363,1,0,9,0,-9
14364,0,0,9,0,-9
14365,1,1,847,2733,1886
14366,0,0,70,0,-70
14367,1,1,2139,1329,-810
14368,1,0,56,0,-56
14369,1,0,159,0,-159
14370,0,0,32,0,-32
14371,1,1,851,1222,371
14372,1,1,577,1825,1248
14373,0,0,5,0,-5
14374,1,0,17,0,-17
14375,0,0,9,0,-9
14376,0,0,78,0,-78
14377,0,0,31,0,-31
14378,0,0,44,0,-44
14379,1,0,84,0,-84
14380,0,0,20,0,-20
14381,1,1,96,1284,1188
14382,1,0,30,0,-30
14383,0,0,7,0,-7
14384,0,0,82,0,-82
14385,0,0,2,0,-2
14386,1,1,307,1510,1203
14387,1,0,3,0,-3
14388,0,0,120,0,-120
14389,0,0,185,0,-185
14390,0,0,69,0,-69
14391,0,0,22,0,-22
14392,1,0,6,0,-6
14393,1,0,180,0,-180
14394,1,1,605,1594,989
14395,1,0,15,0,-15
14396,1,0,21,0,-21
14397,1,0,12,0,-12
14398,1,1,847,1528,681
14399,1,0,34,0,-34
14400,0,0,23,0,-23
14401,0,0,12,0,-12
14402,1,1,413,1296,883
14403,1,1,973,1464,491
14404,1,1,1193,1338,145
14405,1,1,216,1355,1139
14406,1,1,161,1263,1102
14407,1,0,55,0,-55
14408,0,0,40,0,-40
14409,1,0,173,0,-173
14410,0,0,175,0,-175
14411,0,0,91,0,-91
14412,0,0,85,0,-85
14413,1,1,879,1447,568
14414,1,1,1024,1358,334
14415,0,0,43,0,-43
14416,1,1,991,1518,527
14417,1,0,43,0,-43
14418,0,0,7,0,-7
14419,0,0,31,0,-31
14420,1,1,114,1393,1279
14421,1,0,84,0,-84
14422,1,1,130,4999,4869
14423,0,0,19,0,-19
14424,1,0,4,0,-4
14425,1,0,28,0,-28
14426,1,1,40,1453,1413
14427,0,0,16,0,-16
14428,1,1,1388,1276,-112
14429,0,0,1,0,-1
14430,1,0,24,0,-24
14431,0,0,53,0,-53
14432,1,1,2104,1683,-421
14433,1,1,422,3042,2620
14434,1,1,482,1329,847
14435,1,0,20,0,-20
14436,1,0,17,0,-17
14437,1,1,32,2332,2300
14438,1,1,784,1204,420
14439,0,0,35,0,-35
14440,1,0,19,0,-19
14441,0,0,61,0,-61
14442,1,1,1142,1249,107
14443,1,1,998,1495,497
14444,1,0,143,0,-143
14445,1,1,687,1460,773
14446,0,0,4,0,-4
14447,0,0,141,0,-141
14448,1,0,17,0,-17
14449,0,0,1,0,-1
14450,1,0,128,0,-128
14451,0,0,29,0,-29
14452,0,0,53,0,-53
14453,1,0,11,0,-11
14454,0,0,32,0,-32
14455,0,0,98,0,-98
14456,1,0,50,0,-50
14457,1,1,423,1218,795
14458,1,0,7,0,-7
14459,1,1,1480,1833,353
14460,1,1,259,1213,954
14461,0,0,10,0,-10
14462,1,0,23,0,-23
14463,0,0,91,0,-91
14464,0,0,69,0,-69
14465,1,0,42,0,-42
14466,1,1,1698,2028,330
14467,1,0,23,0,-23
14468,1,0,304,0,-304
14469,1,0,52,0,-52
14470,1,0,22,0,-22
14471,1,0,136,0,-136
14472,0,0,47,0,-47
14473,1,0,180,0,-180
14474,1,1,817,1500,683
14475,0,0,7,0,-7
14476,1,1,701,1585,884
14477,1,1,651,2405,1754
14478,1,1,2231,1683,-548
14479,1,0,233,0,-233
14480,0,0,113,0,-113
14481,1,0,118,0,-118
14482,1,1,2039,1212,-827
14483,1,0,99,0,-99
14484,0,0,24,0,-24
14485,1,0,0,0,0
14486,1,1,208,1241,1033
14487,1,1,1188,1889,701
14488,1,0,7,0,-7
14489,1,1,133,1479,1346
14490,1,1,186,1935,1749
14491,0,0,43,0,-43
14492,0,0,1,0,-1
14493,1,0,56,0,-56
14494,1,1,197,1795,1598
14495,1,1,412,2452,2040
14496,0,0,136,0,-136
14497,1,0,52,0,-52
14498,1,1,33,1986,1953
14499,1,0,41,0,-41
14500,1,0,26,0,-26
14501,1,1,364,1458,1094
14502,0,0,16,0,-16
14503,1,0,3,0,-3
14504,1,1,277,1878,1601
14505,1,1,494,1304,810
14506,1,0,123,0,-123
14507,0,0,9,0,-9
14508,1,1,1029,1388,359
14509,0,0,51,0,-51
14510,1,1,172,1250,1078
14511,0,0,27,0,-27
14512,0,0,100,0,-100
14513,0,0,33,0,-33
14514,1,0,29,0,-29
14515,0,0,88,0,-88
14516,1,1,772,2024,1252
14517,1,1,25,1550,1525
14518,1,1,467,1438,971
14519,1,1,395,1228,833
14520,1,0,122,0,-122
14521,1,1,200,3308,3108
14522,1,1,732,1265,533
14523,1,0,10,0,-10
14524,1,0,308,0,-308
14525,1,1,229,1450,1221
14526,0,0,23,0,-23
14527,1,1,649,1289,640
14528,1,1,88,1424,1336
14529,1,0,66,0,-66
14530,1,1,252,1234,982
14531,0,0,80,0,-80
14532,0,0,77,0,-77
14533,1,0,30,0,-30
14534,1,0,5,0,-5
14535,0,0,27,0,-27
14536,0,0,263,0,-263
14537,1,1,247,1330,1083
14538,1,0,94,0,-94
14539,1,1,147,1222,1075
14540,1,0,7,0,-7
14541,1,1,612,1235,623
14542,0,0,22,0,-22
14543,0,0,48,0,-48
14544,1,0,7,0,-7
14545,1,1,224,1441,1217
14546,0,0,103,0,-103
14547,0,0,12,0,-12
14548,1,0,51,0,-51
14549,1,0,143,0,-143
14550,1,1,440,1516,1076
14551,0,0,13,0,-13
14552,1,0,73,0,-73
14553,0,0,21,0,-21
14554,0,0,126,0,-126
14555,1,1,860,1325,465
14556,1,1,244,1481,1237
14557,0,0,15,0,-15
14558,1,1,198,1994,1796
14559,1,0,107,0,-107
14560,0,0,40,0,-40
14561,0,0,31,0,-31
14562,0,0,55,0,-55
14563,0,0,67,0,-67
14564,1,0,39,0,-39
14565,1,1,65,2095,2030
14566,0,0,27,0,-27
14567,1,1,1126,1596,470
14568,1,1,3214,1658,-1556
14569,1,1,98,1251,1153
14570,0,0,27,0,-27
14571,0,0,3,0,-3
14572,1,0,106,0,-106
14573,1,1,1225,1539,314
14574,1,1,728,1209,481
14575,1,0,58,0,-58
14576,1,0,120,0,-120
14577,0,0,2,0,-2
14578,1,0,27,0,-27
14579,0,0,33,0,-33
14580,1,1,1047,2806,1759
14581,1,0,124,0,-124
14582,0,0,79,0,-79
14583,1,1,115,1392,1277
14584,1,1,643,1851,1208
14585,1,1,1064,1495,431
14586,0,0,52,0,-52
14587,1,1,137,1360,1223
14588,1,0,248,0,-248
14589,0,0,61,0,-61
14590,0,0,76,0,-76
14591,1,0,83,0,-83
14592,1,0,114,0,-114
14593,0,0,115,0,-115
14594,1,0,35,0,-35
14595,0,0,30,0,-30
14596,1,1,187,1543,1356
14597,1,0,1,0,-1
14598,1,0,33,0,-33
14599,0,0,168,0,-168
14600,0,0,13,0,-13
14601,0,0,15,0,-15
14602,1,1,1141,3008,1867
14603,0,0,68,0,-68
14604,1,0,103,0,-103
14605,1,1,1141,1546,405
14606,1,0,6,0,-6
14607,1,1,69,2991,2922
14608,1,1,1310,1387,77
14609,1,1,115,1642,1527
14610,0,0,96,0,-96
14611,0,0,5,0,-5
14612,1,1,93,1318,1225
14613,0,0,49,0,-49
14614,0,0,38,0,-38
14615,0,0,14,0,-14
14616,1,1,991,1216,225
14617,1,0,17,0,-17
14618,1,1,96,1555,1459
14619,0,0,74,0,-74
14620,1,0,10,0,-10
14621,0,0,31,0,-31
14622,0,0,4,0,-4
14623,1,0,111,0,-111
14624,1,0,11,0,-11
14625,0,0,43,0,-43
14626,1,1,675,1589,914
14627,1,1,264,1447,1183
14628,0,0,21,0,-21
14629,1,0,58,0,-58
14630,0,0,25,0,-25
14631,1,0,70,0,-70
14632,1,0,14,0,-14
14633,0,0,17,0,-17
14634,1,0,35,0,-35
14635,1,0,40,0,-40
14636,0,0,123,0,-123
14637,0,0,8,0,-8
14638,0,0,14,0,-14
14639,0,0,56,0,-56
14640,1,1,120,1299,1179
14641,0,0,28,0,-28
14642,0,0,7,0,-7
14643,1,0,16,0,-16
14644,0,0,32,0,-32
14645,1,1,1333,1654,321
14646,0,0,24,0,-24
14647,0,0,48,0,-48
14648,1,1,57,1201,1144
14649,1,1,1433,1274,-159
14650,1,1,207,1244,1037
14651,0,0,45,0,-45
14652,1,1,636,2156,1520
14653,0,0,27,0,-27
14654,0,0,17,0,-17
14655,1,1,116,1720,1604
14656,0,0,29,0,-29
14657,1,0,76,0,-76
14658,1,1,655,3816,3161
14659,1,0,10,0,-10
14660,1,0,1,0,-1
14661,1,0,85,0,-85
14662,0,0,1,0,-1
14663,1,1,97,1252,1155
14664,1,0,13,0,-13
14665,0,0,55,0,-55
14666,0,0,101,0,-101
14667,1,0,51,0,-51
14668,1,0,9,0,-9
14669,1,0,14,0,-14
14670,0,0,5,0,-5
14671,1,1,118,1394,1276
14672,1,0,48,0,-48
14673,0,0,6,0,-6
14674,0,0,20,0,-20
14675,0,0,0,0,0
14676,1,1,146,1562,1416
14677,1,1,82,1460,1378
14678,0,0,64,0,-64
14679,1,0,50,0,-50
14680,0,0,13,0,-13
14681,1,0,80,0,-80
14682,0,0,26,0,-26
14683,0,0,17,0,-17
14684,1,1,167,1352,1185
14685,0,0,0,0,0
14686,1,1,466,1523,1057
14687,1,1,487,1360,873
14688,1,0,2,0,-2
14689,1,0,25,0,-25
14690,1,0,64,0,-64
14691,1,0,124,0,-124
14692,1,1,909,1541,632
14693,0,0,161,0,-161
14694,1,1,213,1761,1548
14695,1,0,135,0,-135
14696,0,0,68,0,-68
14697,0,0,35,0,-35
14698,1,0,32,0,-32
14699,0,0,0,0,0
14700,1,1,395,2372,1977
14701,1,0,19,0,-19
14702,1,0,114,0,-114
14703,1,1,514,1620,1106
14704,0,0,83,0,-83
14705,1,0,32,0,-32
14706,0,0,6,0,-6
14707,0,0,5,0,-5
14708,1,1,11,1525,1514
14709,1,1,737,1457,720
14710,1,0,3,0,-3
14711,1,1,462,1215,753
14712,1,0,102,0,-102
14713,0,0,13,0,-13
14714,1,0,114,0,-114
14715,0,0,61,0,-61
14716,1,0,14,0,-14
14717,0,0,51,0,-51
14718,1,1,267,1603,1336
14719,1,1,670,1323,653
14720,0,0,32,0,-32
14721,1,1,3374,1519,-1855
14722,1,0,39,0,-39
14723,1,1,127,1409,1282
14724,1,1,800,1785,985
14725,0,0,76,0,-76
14726,0,0,63,0,-63
14727,1,0,91,0,-91
14728,0,0,14,0,-14
14729,0,0,59,0,-59
14730,1,1,447,1522,1075
14731,1,1,1118,1369,251
14732,1,1,530,1232,702
14733,1,1,269,1218,949
14734,1,0,0,0,0
14735,1,0,14,0,-14
14736,0,0,36,0,-36
14737,1,1,314,1894,1580
14738,1,0,38,0,-38
14739,0,0,4,0,-4
14740,0,0,111,0,-111
14741,0,0,75,0,-75
14742,0,0,103,0,-103
14743,0,0,9,0,-9
14744,1,1,463,1706,1243
14745,1,0,109,0,-109
14746,1,1,780,1625,845
14747,1,1,1248,1313,65
14748,1,0,67,0,-67
14749,0,0,7,0,-7
14750,0,0,7,0,-7
14751,0,0,45,0,-45
14752,0,0,39,0,-39
14753,1,1,1542,1402,-140
14754,1,1,394,1313,919
14755,1,0,89,0,-89
14756,0,0,38,0,-38
14757,1,0,52,0,-52
14758,1,1,459,2492,2033
14759,0,0,6,0,-6
14760,0,0,11,0,-11
14761,0,0,0,0,0
14762,1,1,1717,1280,-437
14763,1,0,2,0,-2
14764,0,0,34,0,-34
14765,0,0,53,0,-53
14766,0,0,28,0,-28
14767,1,0,26,0,-26
14768,1,0,27,0,-27
14769,1,1,534,1209,675
14770,0,0,67,0,-67
14771,1,1,919,1248,329
14772,1,1,381,1623,1242
14773,1,1,974,2313,1339
14774,1,1,1326,1288,-38
14775,1,1,826,1488,662
14776,0,0,5,0,-5
14777,1,0,2,0,-2
14778,1,1,1135,1311,176
14779,1,1,743,1944,1201
14780,1,0,67,0,-67
14781,0,0,3,0,-3
14782,0,0,8,0,-8
14783,0,0,29,0,-29
14784,0,0,4,0,-4
14785,0,0,0,0,0
14786,1,0,9,0,-9
14787,0,0,25,0,-25
14788,1,1,250,1215,965
14789,1,0,13,0,-13
14790,0,0,17,0,-17
14791,1,1,841,1378,537
14792,1,1,1550,1487,-63
14793,1,0,17,0,-17
14794,0,0,58,0,-58
14795,1,1,171,1363,1192
14796,0,0,53,0,-53
14797,0,0,44,0,-44
14798,1,0,9,0,-9
14799,1,1,940,1283,343
14800,0,0,6,0,-6
14801,1,0,43,0,-43
14802,1,1,634,1732,1098
14803,1,1,618,1730,1112
14804,1,0,9,0,-9
14805,1,1,823,1343,520
14806,0,0,38,0,-38
14807,0,0,32,0,-32
14808,1,0,37,0,-37
14809,1,1,496,1367,871
14810,0,0,85,0,-85
14811,1,0,22,0,-22
14812,0,0,92,0,-92
14813,0,0,6,0,-6
14814,1,0,58,0,-58
14815,1,0,5,0,-5
14816,0,0,54,0,-54
14817,0,0,85,0,-85
14818,1,1,390,1600,1210
14819,0,0,81,0,-81
14820,1,1,145,1390,1245
14821,1,0,142,0,-142
14822,1,1,1499,1261,-238
14823,0,0,86,0,-86
14824,0,0,66,0,-66
14825,1,0,42,0,-42
14826,0,0,31,0,-31
14827,1,0,28,0,-28
14828,0,0,120,0,-120
14829,1,1,678,1225,547
14830,0,0,4,0,-4
14831,1,1,175,2605,2430
14832,1,0,19,0,-19
14833,0,0,137,0,-137
14834,1,0,24,0,-24
14835,0,0,22,0,-22
14836,1,0,24,0,-24
14837,0,0,38,0,-38
14838,1,1,248,1253,1005
14839,1,1,455,1761,1306
14840,1,1,398,1230,832
14841,1,1,49,1592,1543
14842,1,1,494,1306,812
14843,0,0,100,0,-100
14844,1,1,75,1358,1283
14845,0,0,68,0,-68
14846,0,0,48,0,-48
14847,0,0,55,0,-55
14848,1,1,715,1592,877
14849,0,0,10,0,-10
14850,1,1,29,1332,1303
14851,1,0,33,0,-33
14852,0,0,54,0,-54
14853,0,0,249,0,-249
14854,1,1,437,1497,1060
14855,1,0,2,0,-2
14856,0,0,4,0,-4
14857,0,0,20,0,-20
14858,1,1,43,1259,1216
14859,0,0,72,0,-72
14860,1,1,468,1497,1029
14861,1,0,4,0,-4
14862,1,1,1308,1282,-26
14863,1,1,931,1535,604
14864,1,1,666,1211,545
14865,0,0,12,0,-12
14866,1,1,355,1955,1600
14867,0,0,188,0,-188
14868,0,0,4,0,-4
14869,1,0,47,0,-47
14870,0,0,9,0,-9
14871,0,0,194,0,-194
14872,0,0,14,0,-14
14873,0,0,3,0,-3
14874,0,0,125,0,-125
14875,1,1,313,4412,4099
14876,1,0,19,0,-19
14877,1,1,231,1226,995
14878,1,1,499,1213,714
14879,0,0,3,0,-3
14880,1,1,236,1337,1101
14881,1,0,3,0,-3
14882,0,0,56,0,-56
14883,0,0,12,0,-12
14884,1,0,18,0,-18
14885,1,0,13,0,-13
14886,0,0,12,0,-12
14887,1,0,23,0,-23
14888,1,1,256,1288,1032
14889,1,0,6,0,-6
14890,0,0,103,0,-103
14891,1,0,57,0,-57
14892,1,0,130,0,-130
14893,0,0,41,0,-41
14894,1,1,779,1351,572
14895,1,1,223,1608,1385
14896,0,0,90,0,-90
14897,0,0,56,0,-56
14898,0,0,55,0,-55
14899,1,0,144,0,-144
14900,1,1,2476,2439,-37
14901,0,0,49,0,-49
14902,0,0,0,0,0
14903,1,0,4,0,-4
14904,1,1,1346,1335,-11
14905,0,0,59,0,-59
14906,0,0,16,0,-16
14907,1,1,149,1462,1313
14908,0,0,15,0,-15
14909,0,0,14,0,-14
14910,1,1,484,2300,1816
14911,1,1,645,1331,686
14912,0,0,30,0,-30
14913,1,0,3,0,-3
14914,1,0,38,0,-38
14915,0,0,54,0,-54
14916,1,0,17,0,-17
14917,0,0,63,0,-63
14918,0,0,124,0,-124
14919,1,0,47,0,-47
14920,1,1,584,2005,1421
14921,1,0,14,0,-14
14922,0,0,19,0,-19
14923,1,1,281,2070,1789
14924,1,0,24,0,-24
14925,0,0,12,0,-12
14926,1,1,647,1233,586
14927,0,0,2,0,-2
14928,1,0,118,0,-118
14929,1,1,2109,2355,246
14930,1,1,942,1447,505
14931,1,0,132,0,-132
14932,1,0,28,0,-28
14933,1,0,57,0,-57
14934,0,0,19,0,-19
14935,1,1,743,1474,731
14936,0,0,0,0,0
14937,1,1,295,1549,1254
14938,0,0,52,0,-52
14939,0,0,52,0,-52
14940,1,1,723,1211,488
14941,1,1,1109,1457,348
14942,1,0,27,0,-27
14943,0,0,50,0,-50
14944,1,0,2,0,-2
14945,1,0,13,0,-13
14946,0,0,2,0,-2
14947,1,1,732,2494,1762
14948,1,0,73,0,-73
14949,1,0,145,0,-145
14950,0,0,16,0,-16
14951,1,0,47,0,-47
14952,0,0,7,0,-7
14953,1,0,4,0,-4
14954,1,0,53,0,-53
14955,0,0,14,0,-14
14956,0,0,28,0,-28
14957,1,1,678,1212,534
14958,0,0,47,0,-47
14959,1,0,17,0,-17
14960,0,0,205,0,-205
14961,0,0,18,0,-18
14962,0,0,246,0,-246
14963,1,0,5,0,-5
14964,1,0,28,0,-28
14965,1,1,275,1341,1066
14966,0,0,75,0,-75
14967,0,0,10,0,-10
14968,0,0,25,0,-25
14969,0,0,132,0,-132
14970,1,0,56,0,-56
14971,0,0,11,0,-11
14972,1,1,436,1423,987
14973,1,1,78,1499,1421
14974,0,0,30,0,-30
14975,1,1,109,1495,1386
14976,1,1,177,1211,1034
14977,0,0,47,0,-47
14978,1,1,180,1377,1197
14979,0,0,62,0,-62
14980,0,0,163,0,-163
14981,0,0,37,0,-37
14982,0,0,71,0,-71
14983,0,0,31,0,-31
14984,0,0,50,0,-50
14985,0,0,30,0,-30
14986,1,0,11,0,-11
14987,1,1,1029,1420,391
14988,0,0,10,0,-10
14989,1,1,511,1673,1162
14990,1,1,133,1242,1109
14991,1,0,19,0,-19
14992,1,1,1086,1356,270
14993,0,0,215,0,-215
14994,0,0,19,0,-19
14995,1,0,33,0,-33
14996,0,0,48,0,-48
14997,1,1,1521,1241,-280
14998,0,0,11,0,-11
14999,0,0,34,0,-34
15000,0,0,16,0,-16
15001,1,1,1716,1463,-253
15002,0,0,95,0,-95
15003,1,1,71,2459,2388
15004,1,0,14,0,-14
15005,0,0,82,0,-82
15006,1,1,190,2329,2139
15007,1,0,99,0,-99
15008,1,1,423,1307,884
15009,0,0,61,0,-61
15010,1,0,50,0,-50
15011,1,0,65,0,-65
15012,0,0,53,0,-53
15013,0,0,6,0,-6
15014,0,0,7,0,-7
15015,0,0,3,0,-3
15016,0,0,119,0,-119
15017,0,0,24,0,-24
15018,0,0,47,0,-47
15019,0,0,22,0,-22
15020,0,0,5,0,-5
15021,1,0,123,0,-123
15022,1,1,666,1484,818
15023,0,0,81,0,-81
15024,0,0,59,0,-59
15025,1,0,34,0,-34
15026,0,0,148,0,-148
15027,1,1,188,1239,1051
15028,1,0,14,0,-14
15029,0,0,29,0,-29
15030,1,1,438,1348,910
15031,0,0,172,0,-172
15032,0,0,148,0,-148
15033,1,0,31,0,-31
15034,1,0,73,0,-73
15035,1,1,46,1249,1203
15036,1,0,30,0,-30
15037,1,0,28,0,-28
15038,1,0,11,0,-11
15039,1,0,18,0,-18
15040,0,0,25,0,-25
15041,1,1,2575,1691,-884
15042,1,0,72,0,-72
15043,0,0,115,0,-115
15044,0,0,3,0,-3
15045,1,0,82,0,-82
15046,0,0,30,0,-30
15047,0,0,19,0,-19
15048,1,0,6,0,-6
15049,0,0,117,0,-117
15050,1,0,48,0,-48
15051,1,0,94,0,-94
15052,1,0,48,0,-48
15053,1,0,114,0,-114
15054,0,0,77,0,-77
15055,0,0,23,0,-23
15056,1,0,89,0,-89
15057,0,0,19,0,-19
15058,1,0,54,0,-54
15059,0,0,46,0,-46
15060,1,1,374,1247,873
15061,0,0,56,0,-56
15062,1,1,1303,1411,108
15063,1,0,59,0,-59
15064,0,0,19,0,-19
15065,1,0,9,0,-9
15066,1,1,678,1647,969
15067,0,0,16,0,-16
15068,0,0,10,0,-10
15069,1,0,8,0,-8
15070,1,1,574,1608,1034
15071,1,0,10,0,-10
15072,0,0,15,0,-15
15073,1,0,25,0,-25
15074,1,1,242,1269,1027
15075,1,0,3,0,-3
15076,0,0,24,0,-24
15077,1,1,523,1353,830
15078,1,1,1046,1235,189
15079,1,0,28,0,-28
15080,0,0,4,0,-4
15081,0,0,42,0,-42
15082,0,0,37,0,-37
15083,1,1,190,1311,1121
15084,0,0,48,0,-48
15085,0,0,16,0,-16
15086,1,1,72,1503,1431
15087,0,0,8,0,-8
15088,0,0,58,0,-58
15089,1,0,29,0,-29
15090,1,1,261,1316,1055
15091,1,1,439,1329,890
15092,1,1,167,1230,1063
15093,1,1,774,1499,725
15094,0,0,15,0,-15
15095,0,0,42,0,-42
15096,1,0,2,0,-2
15097,0,0,60,0,-60
15098,0,0,59,0,-59
15099,0,0,109,0,-109
15100,1,1,275,1247,972
15101,1,1,99,1718,1619
15102,1,0,44,0,-44
15103,1,1,440,2038,1598
15104,1,1,66,1347,1281
15105,1,0,14,0,-14
15106,1,1,1253,1975,722
15107,1,0,32,0,-32
15108,1,0,8,0,-8
15109,0,0,0,0,0
15110,0,0,22,0,-22
15111,1,1,132,1243,1111
15112,1,0,58,0,-58
15113,1,0,164,0,-164
15114,0,0,86,0,-86
15115,1,1,212,1445,1233
15116,1,0,74,0,-74
15117,1,1,1191,2689,1498
15118,1,0,59,0,-59
15119,0,0,50,0,-50
15120,0,0,15,0,-15
15121,1,1,108,1232,1124
15122,1,0,4,0,-4
15123,0,0,43,0,-43
15124,0,0,10,0,-10
15125,1,0,3,0,-3
15126,0,0,37,0,-37
15127,1,1,381,1377,996
15128,1,1,423,1624,1201
15129,1,1,1109,2264,1155
15130,0,0,83,0,-83
15131,1,1,352,1204,852
15132,1,1,259,1575,1316
15133,1,1,30,1322,1292
15134,0,0,32,0,-32
15135,1,1,319,1527,1208
15136,0,0,110,0,-110
15137,0,0,136,0,-136
15138,1,1,192,1289,1097
15139,1,1,324,1596,1272
15140,0,0,2,0,-2
15141,1,1,215,1210,995
15142,1,1,1739,1270,-469
15143,0,0,15,0,-15
15144,1,1,26,1510,1484
15145,1,0,130,0,-130
15146,0,0,12,0,-12
15147,1,1,3002,1289,-1713
15148,1,1,744,1294,550
15149,0,0,0,0,0
15150,0,0,40,0,-40
15151,1,0,7,0,-7
15152,1,1,1146,1823,677
15153,0,0,12,0,-12
15154,1,1,614,1379,765
15155,0,0,5,0,-5
15156,1,1,559,1227,668
15157,0,0,22,0,-22
15158,1,0,98,0,-98
15159,1,0,237,0,-237
15160,1,1,191,1234,1043
15161,1,1,420,2829,2409
15162,0,0,12,0,-12
15163,0,0,23,0,-23
15164,1,0,23,0,-23
15165,0,0,25,0,-25
15166,1,1,369,2840,2471
15167,1,1,238,1311,1073
15168,0,0,11,0,-11
15169,1,1,74,1726,1652
15170,1,0,54,0,-54
15171,0,0,1,0,-1
15172,1,1,655,1229,574
15173,0,0,16,0,-16
15174,1,1,840,2527,1687
15175,1,0,12,0,-12
15176,1,0,23,0,-23
15177,1,1,316,1947,1631
15178,1,1,653,1218,565
15179,1,1,345,1237,892
15180,1,1,105,1212,1107
15181,1,1,1305,1609,304
15182,0,0,84,0,-84
15183,0,0,88,0,-88
15184,0,0,39,0,-39
15185,1,0,14,0,-14
15186,0,0,1,0,-1
15187,1,0,37,0,-37
15188,1,0,101,0,-101
15189,1,1,379,1448,1069
15190,1,0,170,0,-170
15191,1,0,4,0,-4
15192,0,0,84,0,-84
15193,1,0,0,0,0
15194,1,1,839,1604,765
15195,1,0,62,0,-62
15196,0,0,0,0,0
15197,0,0,36,0,-36
15198,1,1,562,1386,824
15199,0,0,76,0,-76
15200,1,1,1277,1512,235
15201,1,1,725,1626,901
15202,1,0,6,0,-6
15203,1,0,5,0,-5
15204,1,0,1,0,-1
15205,1,0,40,0,-40
15206,1,1,202,1828,1626
15207,0,0,58,0,-58
15208,0,0,25,0,-25
15209,1,1,362,1213,851
15210,1,0,0,0,0
15211,1,0,114,0,-114
15212,1,0,3,0,-3
15213,0,0,107,0,-107
15214,1,1,527,1757,1230
15215,0,0,51,0,-51
15216,1,0,112,0,-112
15217,1,1,855,1486,631
15218,1,1,350,1271,921
15219,0,0,48,0,-48
15220,1,1,971,1509,538
15221,0,0,108,0,-108
15222,1,0,80,0,-80
15223,0,0,17,0,-17
15224,0,0,98,0,-98
15225,1,0,4,0,-4
15226,1,1,80,1446,1366
15227,0,0,69,0,-69
15228,0,0,3,0,-3
15229,1,1,227,1281,1054
15230,1,1,67,1315,1248
15231,1,0,107,0,-107
15232,1,0,21,0,-21
15233,0,0,42,0,-42
15234,1,1,69,1353,1284
15235,1,0,23,0,-23
15236,1,0,30,0,-30
15237,0,0,14,0,-14
15238,1,0,57,0,-57
15239,1,0,36,0,-36
15240,1,0,107,0,-107
15241,0,0,86,0,-86
15242,1,0,42,0,-42
15243,1,0,53,0,-53
15244,1,1,282,1480,1198
15245,1,1,1168,1776,608
15246,0,0,31,0,-31
15247,1,0,125,0,-125
15248,1,1,346,1428,1082
15249,1,0,14,0,-14
15250,1,1,95,1358,1263
15251,0,0,32,0,-32
15252,0,0,299,0,-299
15253,1,1,250,1486,1236
15254,0,0,33,0,-33
15255,0,0,35,0,-35
15256,1,1,676,1336,660
15257,0,0,51,0,-51
15258,1,1,446,2563,2117
15259,1,0,68,0,-68
15260,0,0,70,0,-70
15261,1,1,1394,1252,-142
15262,1,0,99,0,-99
15263,1,0,16,0,-16
15264,0,0,62,0,-62
15265,1,0,11,0,-11
15266,1,1,155,1860,1705
15267,1,0,116,0,-116
15268,1,0,140,0,-140
15269,1,1,1024,2843,1819
15270,0,0,22,0,-22
15271,1,1,45,1246,1201
15272,0,0,38,0,-38
15273,0,0,62,0,-62
15274,1,1,1405,1324,-81
15275,0,0,17,0,-17
15276,0,0,37,0,-37
15277,1,1,279,1593,1314
15278,1,1,348,1383,1035
15279,0,0,15,0,-15
15280,1,0,39,0,-39
15281,0,0,15,0,-15
15282,1,0,52,0,-52
15283,1,0,56,0,-56
15284,0,0,28,0,-28
15285,1,1,766,1301,535
15286,0,0,9,0,-9
15287,1,1,220,1215,995
15288,1,1,176,1385,1209
15289,0,0,16,0,-16
15290,1,0,157,0,-157
15291,1,1,228,1571,1343
15292,1,0,86,0,-86
15293,0,0,31,0,-31
15294,1,0,86,0,-86
15295,0,0,45,0,-45
15296,0,0,79,0,-79
15297,1,1,173,1437,1264
15298,1,1,116,1219,1103
15299,0,0,98,0,-98
15300,0,0,67,0,-67
15301,1,0,103,0,-103
15302,1,0,29,0,-29
15303,1,0,87,0,-87
15304,1,0,83,0,-83
15305,1,0,60,0,-60
15306,0,0,44,0,-44
15307,1,1,365,1304,939
15308,0,0,21,0,-21
15309,1,1,126,1916,1790
15310,1,1,645,1283,638
15311,1,0,11,0,-11
15312,1,0,49,0,-49
15313,0,0,0,0,0
15314,1,1,113,2275,2162
15315,1,1,137,2035,1898
15316,1,0,3,0,-3
15317,1,1,218,3522,3304
15318,1,0,23,0,-23
15319,1,1,283,1554,1271
15320,0,0,13,0,-13
15321,0,0,43,0,-43
15322,0,0,14,0,-14
15323,1,1,350,1205,855
15324,0,0,8,0,-8
15325,0,0,67,0,-67
15326,0,0,24,0,-24
15327,0,0,7,0,-7
15328,0,0,77,0,-77
15329,0,0,13,0,-13
15330,1,0,59,0,-59
15331,1,0,75,0,-75
15332,0,0,64,0,-64
15333,0,0,54,0,-54
15334,0,0,10,0,-10
15335,1,0,131,0,-131
15336,1,1,26,1289,1263
15337,0,0,8,0,-8
15338,1,0,23,0,-23
15339,0,0,19,0,-19
15340,1,1,515,1276,761
15341,1,0,9,0,-9
15342,1,1,25,1348,1323
15343,1,0,67,0,-67
15344,1,0,23,0,-23
15345,1,1,504,1338,834
15346,1,0,90,0,-90
15347,1,0,45,0,-45
15348,1,1,1117,1378,261
15349,1,0,36,0,-36
15350,1,0,92,0,-92
15351,1,0,19,0,-19
15352,1,0,13,0,-13
15353,0,0,65,0,-65
15354,0,0,170,0,-170
15355,1,1,934,1292,358
15356,1,0,37,0,-37
15357,0,0,2,0,-2
15358,1,1,329,1418,1089
15359,1,0,11,0,-11
15360,1,1,195,1334,1139
15361,0,0,4,0,-4
15362,0,0,291,0,-291
15363,0,0,8,0,-8
15364,1,0,125,0,-125
15365,1,1,179,1230,1051
15366,1,1,1260,1318,58
15367,1,0,11,0,-11
15368,0,0,1,0,-1
15369,1,0,30,0,-30
15370,1,1,523,1392,869
15371,1,1,138,1350,1212
15372,1,0,23,0,-23
15373,0,0,8,0,-8
15374,1,0,17,0,-17
15375,1,1,199,1614,1415
15376,0,0,1,0,-1
15377,1,0,39,0,-39
15378,1,0,0,0,0
15379,1,0,95,0,-95
15380,1,0,25,0,-25
15381,1,0,3,0,-3
15382,0,0,19,0,-19
15383,1,0,36,0,-36
15384,0,0,9,0,-9
15385,1,0,99,0,-99
15386,0,0,70,0,-70
15387,0,0,1,0,-1
15388,1,0,4,0,-4
15389,0,0,124,0,-124
15390,0,0,12,0,-12
15391,1,0,11,0,-11
15392,0,0,8,0,-8
15393,1,0,39,0,-39
15394,1,1,725,1223,498
15395,1,0,21,0,-21
15396,1,0,70,0,-70
15397,1,1,306,1265,959
15398,0,0,25,0,-25
15399,0,0,55,0,-55
15400,1,0,152,0,-152
15401,0,0,119,0,-119
15402,1,0,23,0,-23
15403,1,1,352,1502,1150
15404,1,1,790,1436,646
15405,0,0,22,0,-22
15406,0,0,30,0,-30
15407,0,0,35,0,-35
15408,1,1,981,2806,1825
15409,1,0,99,0,-99
15410,1,1,334,1758,1424
15411,1,1,369,1466,1097
15412,1,0,25,0,-25
15413,1,1,1696,1228,-468
15414,0,0,107,0,-107
15415,1,0,35,0,-35
15416,1,1,305,1679,1374
15417,1,0,7,0,-7
15418,0,0,14,0,-14
15419,1,1,1333,1229,-104
15420,0,0,6,0,-6
15421,1,0,7,0,-7
15422,0,0,15,0,-15
15423,0,0,13,0,-13
15424,1,1,512,1638,1126
15425,0,0,3,0,-3
15426,1,0,113,0,-113
15427,1,1,299,1342,1043
15428,1,0,9,0,-9
15429,1,1,166,1821,1655
15430,1,0,43,0,-43
15431,1,0,21,0,-21
15432,1,1,683,1611,928
15433,1,0,168,0,-168
15434,1,1,338,1448,1110
15435,0,0,100,0,-100
15436,1,1,173,1294,1121
15437,1,1,1585,1205,-380
15438,1,0,5,0,-5
15439,1,1,195,2507,2312
15440,0,0,79,0,-79
15441,1,1,613,1260,647
15442,0,0,29,0,-29
15443,1,1,965,1381,416
15444,1,0,32,0,-32
15445,1,0,39,0,-39
15446,0,0,131,0,-131
15447,1,1,805,1222,417
15448,1,0,61,0,-61
15449,0,0,61,0,-61
15450,1,1,683,1298,615
15451,1,1,718,1445,727
15452,1,1,979,1774,795
15453,1,0,149,0,-149
15454,0,0,18,0,-18
15455,1,0,59,0,-59
15456,0,0,110,0,-110
15457,1,1,644,2015,1371
15458,0,0,42,0,-42
15459,0,0,18,0,-18
15460,1,0,3,0,-3
15461,0,0,45,0,-45
15462,1,1,214,1282,1068
15463,0,0,70,0,-70
15464,1,0,136,0,-136
15465,1,0,119,0,-119
15466,0,0,20,0,-20
15467,1,0,64,0,-64
15468,0,0,22,0,-22
15469,1,1,234,1286,1052
15470,0,0,19,0,-19
15471,1,0,22,0,-22
15472,0,0,99,0,-99
15473,1,0,32,0,-32
15474,0,0,19,0,-19
15475,1,0,151,0,-151
15476,1,1,1322,1392,70
15477,0,0,16,0,-16
15478,0,0,19,0,-19
15479,0,0,33,0,-33
15480,0,0,37,0,-37
15481,1,0,16,0,-16
15482,0,0,24,0,-24
15483,0,0,16,0,-16
15484,1,0,283,0,-283
15485,0,0,6,0,-6
15486,1,1,408,1418,1010
15487,1,1,178,4113,3935
15488,1,1,213,1300,1087
15489,1,1,161,1209,1048
15490,0,0,230,0,-230
15491,1,0,54,0,-54
15492,0,0,49,0,-49
15493,1,0,101,0,-101
15494,0,0,8,0,-8
15495,0,0,3,0,-3
15496,1,1,1012,1255,243
15497,0,0,43,0,-43
15498,1,0,18,0,-18
15499,1,0,108,0,-108
15500,1,0,5,0,-5
15501,1,0,74,0,-74
15502,0,0,56,0,-56
15503,0,0,32,0,-32
15504,0,0,6,0,-6
15505,1,0,43,0,-43
15506,0,0,163,0,-163
15507,0,0,65,0,-65
15508,1,0,17,0,-17
15509,1,1,254,2351,2097
15510,1,0,17,0,-17
15511,0,0,32,0,-32
15512,0,0,124,0,-124
15513,0,0,39,0,-39
15514,1,1,239,3752,3513
15515,0,0,24,0,-24
15516,1,0,37,0,-37
15517,1,1,191,1218,1027
15518,0,0,117,0,-117
15519,1,1,42,1273,1231
15520,1,1,655,1345,690
15521,1,0,15,0,-15
15522,0,0,128,0,-128
15523,1,1,322,1435,1113
15524,0,0,31,0,-31
15525,1,1,458,1244,786
15526,0,0,4,0,-4
15527,0,0,16,0,-16
15528,1,1,287,2663,2376
15529,1,1,523,1542,1019
15530,0,0,108,0,-108
15531,1,0,6,0,-6
15532,1,0,26,0,-26
15533,1,0,27,0,-27
15534,1,1,1961,1771,-190
15535,1,0,25,0,-25
15536,0,0,12,0,-12
15537,1,1,659,1211,552
15538,0,0,272,0,-272
15539,1,0,317,0,-317
15540,1,0,34,0,-34
15541,0,0,6,0,-6
15542,1,1,74,1249,1175
15543,0,0,72,0,-72
15544,1,0,98,0,-98
15545,1,1,1264,1671,407
15546,0,0,14,0,-14
15547,1,0,44,0,-44
15548,1,1,22,1839,1817
15549,1,0,13,0,-13
15550,1,0,147,0,-147
15551,0,0,17,0,-17
15552,1,1,727,1316,589
15553,0,0,134,0,-134
15554,1,1,144,1245,1101
15555,1,1,1007,1585,578
15556,1,1,70,1482,1412
15557,0,0,49,0,-49
15558,1,0,14,0,-14
15559,0,0,17,0,-17
15560,1,0,39,0,-39
15561,0,0,12,0,-12
15562,1,0,39,0,-39
15563,0,0,110,0,-110
15564,1,1,1144,1287,143
15565,0,0,41,0,-41
15566,1,1,696,1367,671
15567,0,0,9,0,-9
15568,0,0,137,0,-137
15569,1,0,41,0,-41
15570,1,1,316,1749,1433
15571,0,0,105,0,-105
15572,1,0,125,0,-125
15573,1,1,117,1361,1244
15574,1,0,70,0,-70
15575,0,0,6,0,-6
15576,0,0,27,0,-27
15577,0,0,52,0,-52
15578,1,0,14,0,-14
15579,0,0,39,0,-39
15580,0,0,11,0,-11
15581,1,0,127,0,-127
15582,1,1,615,1596,981
15583,1,1,411,1352,941
15584,1,0,131,0,-131
15585,0,0,110,0,-110
15586,0,0,14,0,-14
15587,1,1,105,1235,1130
15588,0,0,5,0,-5
15589,0,0,10,0,-10
15590,1,1,336,1271,935
15591,1,1,1586,1364,-222
15592,0,0,46,0,-46
15593,1,1,685,1461,776
15594,0,0,42,0,-42
15595,1,1,1379,1521,142
15596,1,0,92,0,-92
15597,0,0,135,0,-135
15598,0,0,61,0,-61
15599,1,0,6,0,-6
15600,1,1,314,1673,1359
15601,0,0,19,0,-19
15602,0,0,57,0,-57
15603,1,0,82,0,-82
15604,1,0,35,0,-35
15605,0,0,49,0,-49
15606,0,0,19,0,-19
15607,1,0,39,0,-39
15608,1,0,96,0,-96
15609,0,0,78,0,-78
15610,1,0,143,0,-143
15611,1,0,102,0,-102
15612,1,1,123,1267,1144
15613,1,1,1610,2719,1109
15614,0,0,28,0,-28
15615,0,0,55,0,-55
15616,1,0,96,0,-96
15617,1,1,511,1764,1253
15618,0,0,33,0,-33
15619,1,1,486,1473,987
15620,1,1,303,1458,1155
15621,1,1,379,1608,1229
15622,1,1,214,1213,999
15623,0,0,70,0,-70
15624,1,0,23,0,-23
15625,0,0,7,0,-7
15626,1,0,130,0,-130
15627,0,0,43,0,-43
15628,1,1,728,1664,936
15629,1,0,52,0,-52
15630,0,0,40,0,-40
15631,0,0,67,0,-67
15632,1,0,13,0,-13
15633,1,1,223,2790,2567
15634,1,1,392,1222,830
15635,0,0,20,0,-20
15636,1,1,481,1792,1311
15637,1,1,281,1367,1086
15638,1,0,44,0,-44
15639,1,0,78,0,-78
15640,1,1,156,1399,1243
15641,1,0,65,0,-65
15642,1,0,57,0,-57
15643,0,0,13,0,-13
15644,1,1,38,1857,1819
15645,0,0,5,0,-5
15646,1,1,69,1424,1355
15647,1,1,775,1536,761
15648,1,1,554,1443,889
15649,1,1,141,1395,1254
15650,0,0,18,0,-18
15651,0,0,2,0,-2
15652,0,0,38,0,-38
15653,1,1,275,1263,988
15654,0,0,161,0,-161
15655,1,1,248,1316,1068
15656,1,1,353,1567,1214
15657,0,0,22,0,-22
15658,0,0,8,0,-8
15659,1,1,233,1591,1358
15660,1,1,276,1290,1014
15661,1,1,371,1205,834
15662,0,0,7,0,-7
15663,0,0,21,0,-21
15664,0,0,112,0,-112
15665,1,0,21,0,-21
15666,1,1,80,1393,1313
15667,1,1,48,1269,1221
15668,1,1,1063,1663,600
15669,1,1,966,3631,2665
15670,0,0,37,0,-37
15671,1,0,19,0,-19
15672,1,0,62,0,-62
15673,1,1,77,1519,1442
15674,1,1,766,1224,458
15675,1,1,203,1463,1260
15676,1,1,169,1501,1332
15677,1,1,415,1410,995
15678,1,0,87,0,-87
15679,1,0,3,0,-3
15680,0,0,42,0,-42
15681,0,0,5,0,-5
15682,1,0,307,0,-307
15683,1,0,106,0,-106
15684,1,1,102,1376,1274
15685,1,0,29,0,-29
15686,1,1,205,1464,1259
15687,1,1,149,1782,1633
15688,1,1,191,1671,1480
15689,0,0,30,0,-30
15690,0,0,49,0,-49
15691,1,1,34,1491,1457
15692,0,0,9,0,-9
15693,1,1,308,1532,1224
15694,0,0,70,0,-70
15695,1,1,434,1207,773
15696,1,1,863,1339,476
15697,1,0,2,0,-2
15698,1,1,233,1353,1120
15699,1,0,0,0,0
15700,0,0,15,0,-15
15701,1,0,58,0,-58
15702,1,0,48,0,-48
15703,0,0,17,0,-17
15704,1,1,1140,1275,135
15705,0,0,94,0,-94
15706,0,0,6,0,-6
15707,1,1,685,1253,568
15708,1,1,609,1445,836
15709,1,1,1326,2022,696
15710,1,0,108,0,-108
15711,1,1,1436,1321,-115
15712,0,0,70,0,-70
15713,1,1,371,2527,2156
15714,1,0,53,0,-53
15715,0,0,28,0,-28
15716,0,0,36,0,-36
15717,0,0,10,0,-10
15718,0,0,9,0,-9
15719,0,0,60,0,-60
15720,1,0,0,0,0
15721,1,0,84,0,-84
15722,1,0,7,0,-7
15723,0,0,26,0,-26
15724,1,0,31,0,-31
15725,0,0,32,0,-32
15726,1,0,64,0,-64
15727,0,0,6,0,-6
15728,1,0,23,0,-23
15729,1,0,113,0,-113
15730,0,0,45,0,-45
15731,0,0,32,0,-32
15732,0,0,33,0,-33
15733,1,0,16,0,-16
15734,1,0,24,0,-24
15735,1,0,27,0,-27
15736,1,1,500,1260,760
15737,0,0,17,0,-17
15738,0,0,70,0,-70
15739,0,0,15,0,-15
15740,1,0,8,0,-8
15741,1,0,14,0,-14
15742,1,0,4,0,-4
15743,1,0,20,0,-20
15744,0,0,33,0,-33
15745,1,1,1046,1440,394
15746,0,0,75,0,-75
15747,0,0,16,0,-16
15748,0,0,5,0,-5
15749,1,0,11,0,-11
15750,1,1,167,1244,1077
15751,1,1,471,1888,1417
15752,1,0,68,0,-68
15753,0,0,55,0,-55
15754,1,1,253,1703,1450
15755,1,0,8,0,-8
15756,1,1,480,1598,1118
15757,1,1,319,1235,916
15758,0,0,20,0,-20
15759,1,1,430,1402,972
15760,1,1,201,1308,1107
15761,1,1,217,1396,1179
15762,1,1,1266,1508,242
15763,0,0,23,0,-23
15764,0,0,0,0,0
15765,1,1,475,1291,816
15766,0,0,65,0,-65
15767,0,0,37,0,-37
15768,1,1,50,1822,1772
15769,0,0,41,0,-41
15770,1,1,212,1387,1175
15771,0,0,45,0,-45
15772,0,0,31,0,-31
15773,1,1,103,1326,1223
15774,1,1,258,2425,2167
15775,1,1,344,1516,1172
15776,1,1,206,1333,1127
15777,0,0,6,0,-6
15778,0,0,62,0,-62
15779,1,1,1504,1701,197
15780,1,0,4,0,-4
15781,1,1,734,1289,555
15782,1,1,895,2024,1129
15783,1,1,101,1385,1284
15784,0,0,65,0,-65
15785,0,0,102,0,-102
15786,1,0,17,0,-17
15787,1,1,59,1216,1157
15788,0,0,38,0,-38
15789,0,0,7,0,-7
15790,1,1,226,1288,1062
15791,0,0,41,0,-41
15792,1,1,636,2579,1943
15793,0,0,13,0,-13
15794,1,1,498,1233,735
15795,1,0,11,0,-11
15796,0,0,43,0,-43
15797,1,0,21,0,-21
15798,0,0,50,0,-50
15799,1,0,22,0,-22
15800,0,0,3,0,-3
15801,1,0,9,0,-9
15802,0,0,6,0,-6
15803,1,0,33,0,-33
15804,1,1,194,1412,1218
15805,0,0,68,0,-68
15806,1,0,12,0,-12
15807,1,1,86,1412,1326
15808,0,0,44,0,-44
15809,0,0,26,0,-26
15810,1,1,183,1909,1726
15811,1,1,796,1682,886
15812,1,0,43,0,-43
15813,1,0,13,0,-13
15814,1,0,2,0,-2
15815,1,0,10,0,-10
15816,1,1,726,1320,594
15817,0,0,20,0,-20
15818,0,0,118,0,-118
15819,1,0,4,0,-4
15820,0,0,38,0,-38
15821,0,0,5,0,-5
15822,1,0,40,0,-40
15823,0,0,4,0,-4
15824,1,0,1,0,-1
15825,1,0,7,0,-7
15826,0,0,0,0,0
15827,1,0,22,0,-22
15828,1,0,9,0,-9
15829,0,0,96,0,-96
15830,1,1,324,1912,1588
15831,0,0,5,0,-5
15832,1,0,29,0,-29
15833,1,0,7,0,-7
15834,1,1,328,2085,1757
15835,0,0,2,0,-2
15836,1,1,987,1242,255
15837,1,0,47,0,-47
15838,1,1,353,1270,917
15839,1,0,261,0,-261
15840,1,1,236,1316,1080
15841,1,0,36,0,-36
15842,1,1,607,3723,3116
15843,1,0,79,0,-79
15844,1,1,1389,1223,-166
15845,0,0,15,0,-15
15846,1,0,39,0,-39
15847,0,0,24,0,-24
15848,0,0,69,0,-69
15849,1,0,35,0,-35
15850,1,1,618,1349,731
15851,0,0,38,0,-38
15852,1,0,17,0,-17
15853,1,0,62,0,-62
15854,0,0,1,0,-1
15855,1,0,47,0,-47
15856,1,0,60,0,-60
15857,1,0,41,0,-41
15858,1,0,50,0,-50
15859,1,0,43,0,-43
15860,0,0,8,0,-8
15861,1,1,160,1212,1052
15862,1,1,296,1828,1532
15863,0,0,16,0,-16
15864,1,1,161,1407,1246
15865,1,0,44,0,-44
15866,0,0,196,0,-196
15867,1,1,1129,1704,575
15868,0,0,29,0,-29
15869,1,0,58,0,-58
15870,1,0,24,0,-24
15871,1,0,40,0,-40
15872,1,0,63,0,-63
15873,1,0,21,0,-21
15874,0,0,11,0,-11
15875,1,1,462,1267,805
15876,1,1,101,1649,1548
15877,0,0,114,0,-114
15878,0,0,139,0,-139
15879,1,1,360,1207,847
15880,0,0,64,0,-64
15881,0,0,96,0,-96
15882,1,0,24,0,-24
15883,1,0,8,0,-8
15884,1,0,70,0,-70
15885,0,0,204,0,-204
15886,0,0,108,0,-108
15887,1,0,34,0,-34
15888,0,0,9,0,-9
15889,1,0,5,0,-5
15890,0,0,3,0,-3
15891,1,0,81,0,-81
15892,0,0,0,0,0
15893,1,0,54,0,-54
15894,1,1,2176,1397,-779
15895,1,0,28,0,-28
15896,1,1,416,1371,955
15897,0,0,125,0,-125
15898,0,0,34,0,-34
15899,1,1,148,1357,1209
15900,1,0,25,0,-25
15901,1,0,53,0,-53
15902,0,0,20,0,-20
15903,1,0,33,0,-33
15904,1,0,70,0,-70
15905,1,1,68,1213,1145
15906,0,0,13,0,-13
15907,1,1,329,1636,1307
15908,1,1,977,1750,773
15909,1,0,21,0,-21
15910,0,0,50,0,-50
15911,0,0,38,0,-38
15912,1,0,40,0,-40
15913,1,1,43,1619,1576
15914,1,0,58,0,-58
15915,0,0,71,0,-71
15916,1,1,603,1497,894
15917,1,0,67,0,-67
15918,1,0,36,0,-36
15919,1,1,46,1337,1291
15920,1,0,58,0,-58
15921,1,0,95,0,-95
15922,1,1,371,2510,2139
15923,0,0,21,0,-21
15924,0,0,23,0,-23
15925,1,1,1530,1482,-48
15926,1,1,1389,1713,324
15927,0,0,46,0,-46
15928,0,0,56,0,-56
15929,0,0,152,0,-152
15930,0,0,76,0,-76
15931,1,1,807,2166,1359
15932,1,0,53,0,-53
15933,0,0,14,0,-14
15934,0,0,26,0,-26
15935,0,0,64,0,-64
15936,0,0,6,0,-6
15937,1,1,2248,1243,-1005
15938,1,0,29,0,-29
15939,1,1,231,1223,992
15940,1,0,13,0,-13
15941,0,0,253,0,-253
15942,0,0,32,0,-32
15943,0,0,38,0,-38
15944,1,1,393,1515,1122
15945,0,0,18,0,-18
15946,1,1,261,1551,1290
15947,0,0,32,0,-32
15948,0,0,18,0,-18
15949,1,1,1160,1346,186
15950,1,1,1891,1223,-668
15951,1,0,116,0,-116
15952,0,0,34,0,-34
15953,1,0,10,0,-10
15954,1,0,55,0,-55
15955,1,1,1143,1251,108
15956,1,0,68,0,-68
15957,0,0,61,0,-61
15958,0,0,12,0,-12
15959,1,0,78,0,-78
15960,1,0,28,0,-28
15961,0,0,63,0,-63
15962,1,0,111,0,-111
15963,0,0,47,0,-47
15964,1,1,110,2301,2191
15965,1,1,822,1278,456
15966,1,0,49,0,-49
15967,1,0,18,0,-18
15968,1,1,561,1340,779
15969,0,0,55,0,-55
15970,1,1,569,4157,3588
15971,1,0,38,0,-38
15972,1,0,36,0,-36
15973,0,0,31,0,-31
15974,1,1,139,1496,1357
15975,0,0,0,0,0
15976,1,1,278,1372,1094
15977,1,1,538,2217,1679
15978,1,1,816,1276,460
15979,1,1,18,2887,2869
15980,0,0,116,0,-116
15981,0,0,5,0,-5
15982,0,0,23,0,-23
15983,1,0,90,0,-90
15984,1,0,44,0,-44
15985,1,1,490,1233,743
15986,0,0,10,0,-10
15987,1,1,148,1259,1111
15988,1,0,43,0,-43
15989,1,1,190,1425,1235
15990,1,0,6,0,-6
15991,1,0,11,0,-11
15992,0,0,109,0,-109
15993,0,0,44,0,-44
15994,0,0,195,0,-195
15995,0,0,44,0,-44
15996,0,0,29,0,-29
15997,0,0,0,0,0
15998,0,0,55,0,-55
15999,1,0,13,0,-13
16000,0,0,67,0,-67
16001,1,0,34,0,-34
16002,0,0,7,0,-7
16003,0,0,15,0,-15
16004,1,1,232,4114,3882
16005,0,0,45,0,-45
16006,1,1,304,1472,1168
16007,1,1,339,1536,1197
16008,0,0,15,0,-15
16009,1,0,137,0,-137
16010,1,0,90,0,-90
16011,1,0,7,0,-7
16012,1,1,1000,1341,341
16013,1,0,176,0,-176
16014,1,1,761,1492,731
16015,1,1,636,1311,675
16016,0,0,25,0,-25
16017,1,0,31,0,-31
16018,0,0,88,0,-88
16019,1,1,496,1775,1279
16020,1,1,455,2402,1947
16021,0,0,13,0,-13
16022,1,1,520,2475,1955
16023,0,0,20,0,-20
16024,1,0,11,0,-11
16025,1,1,164,1351,1187
16026,1,1,692,1399,707
16027,0,0,49,0,-49
16028,1,1,393,2595,2202
16029,1,0,11,0,-11
16030,1,1,383,1282,899
16031,1,1,161,1402,1241
16032,1,0,36,0,-36
16033,1,0,212,0,-212
16034,0,0,31,0,-31
16035,1,0,13,0,-13
16036,1,1,90,2059,1969
16037,0,0,27,0,-27
16038,1,0,44,0,-44
16039,1,1,557,1271,714
16040,1,0,11,0,-11
16041,1,0,91,0,-91
16042,1,1,218,1318,1100
16043,1,1,399,1288,889
16044,1,0,4,0,-4
16045,0,0,41,0,-41
16046,1,1,628,2239,1611
16047,0,0,114,0,-114
16048,1,0,134,0,-134
16049,0,0,17,0,-17
16050,1,0,52,0,-52
16051,1,1,257,1614,1357
16052,1,0,196,0,-196
16053,1,0,59,0,-59
16054,1,0,20,0,-20
16055,0,0,79,0,-79
16056,0,0,1,0,-1
16057,1,1,25,1349,1324
16058,0,0,12,0,-12
16059,0,0,71,0,-71
16060,0,0,76,0,-76
16061,1,0,18,0,-18
16062,1,0,2,0,-2
16063,1,0,0,0,0
16064,1,1,518,1217,699
16065,1,0,30,0,-30
16066,1,0,29,0,-29
16067,1,0,102,0,-102
16068,0,0,77,0,-77
16069,0,0,31,0,-31
16070,1,1,85,1317,1232
16071,0,0,60,0,-60
16072,1,0,21,0,-21
16073,1,1,1011,1369,358
16074,1,0,16,0,-16
16075,0,0,55,0,-55
16076,0,0,32,0,-32
16077,1,1,351,1633,1282
16078,1,1,266,1339,1073
16079,0,0,260,0,-260
16080,0,0,16,0,-16
16081,1,0,6,0,-6
16082,0,0,39,0,-39
16083,1,0,16,0,-16
16084,0,0,12,0,-12
16085,1,0,23,0,-23
16086,0,0,39,0,-39
16087,1,0,44,0,-44
16088,1,1,134,2175,2041
16089,1,0,145,0,-145
16090,0,0,90,0,-90
16091,0,0,5,0,-5
16092,0,0,86,0,-86
16093,1,1,44,1521,1477
16094,1,1,336,1455,1119
16095,0,0,52,0,-52
16096,0,0,162,0,-162
16097,1,1,1258,1229,-29
16098,0,0,72,0,-72
16099,1,1,525,1255,730
16100,0,0,1,0,-1
16101,1,0,12,0,-12
16102,0,0,69,0,-69
16103,0,0,77,0,-77
16104,0,0,27,0,-27
16105,1,1,236,1249,1013
16106,1,1,702,1342,640
16107,0,0,67,0,-67
16108,1,1,958,2517,1559
16109,1,1,96,1661,1565
16110,1,0,142,0,-142
16111,1,0,75,0,-75
16112,1,0,47,0,-47
16113,0,0,12,0,-12
16114,1,0,58,0,-58
16115,0,0,52,0,-52
16116,1,0,72,0,-72
16117,1,1,1251,1244,-7
16118,0,0,53,0,-53
16119,1,1,875,1649,774
16120,0,0,81,0,-81
16121,1,1,239,1215,976
16122,0,0,19,0,-19
16123,1,1,1678,1457,-221
16124,1,0,51,0,-51
16125,1,1,396,1780,1384
16126,0,0,118,0,-118
16127,1,1,288,1719,1431
16128,0,0,62,0,-62
16129,1,1,382,1515,1133
16130,1,0,39,0,-39
16131,0,0,103,0,-103
16132,0,0,181,0,-181
16133,1,0,36,0,-36
16134,1,1,512,1366,854
16135,0,0,43,0,-43
16136,1,0,11,0,-11
16137,0,0,22,0,-22
16138,0,0,52,0,-52
16139,0,0,13,0,-13
16140,0,0,11,0,-11
16141,1,0,58,0,-58
16142,1,0,21,0,-21
16143,0,0,3,0,-3
16144,1,0,73,0,-73
16145,1,0,73,0,-73
16146,0,0,5,0,-5
16147,1,1,1103,1328,225
16148,1,0,82,0,-82
16149,1,1,456,1302,846
16150,0,0,11,0,-11
16151,0,0,43,0,-43
16152,0,0,78,0,-78
16153,1,1,1159,1627,468
16154,1,0,45,0,-45
16155,0,0,7,0,-7
16156,1,0,91,0,-91
16157,1,0,89,0,-89
16158,1,0,16,0,-16
16159,1,0,58,0,-58
16160,0,0,97,0,-97
16161,1,1,479,1575,1096
16162,1,0,80,0,-80
16163,1,0,1,0,-1
16164,1,0,42,0,-42
16165,1,1,123,1352,1229
16166,1,1,232,1775,1543
16167,1,1,263,1694,1431
16168,0,0,80,0,-80
16169,1,0,2,0,-2
16170,1,1,1915,1201,-714
16171,0,0,83,0,-83
16172,0,0,22,0,-22
16173,1,0,0,0,0
16174,1,1,1682,2224,542
16175,1,1,969,2030,1061
16176,0,0,13,0,-13
16177,0,0,47,0,-47
16178,1,0,8,0,-8
16179,1,0,7,0,-7
16180,0,0,43,0,-43
16181,1,0,21,0,-21
16182,1,1,1892,1358,-534
16183,1,1,108,1481,1373
16184,1,0,18,0,-18
16185,1,1,357,1560,1203
16186,1,0,69,0,-69
16187,0,0,75,0,-75
16188,1,0,178,0,-178
16189,0,0,7,0,-7
16190,0,0,40,0,-40
16191,0,0,28,0,-28
16192,0,0,35,0,-35
16193,1,1,181,1319,1138
16194,1,1,198,1346,1148
16195,0,0,8,0,-8
16196,1,0,31,0,-31
16197,1,0,68,0,-68
16198,1,1,343,1390,1047
16199,0,0,41,0,-41
16200,0,0,140,0,-140
16201,1,1,49,1844,1795
16202,0,0,3,0,-3
16203,0,0,31,0,-31
16204,1,0,1,0,-1
16205,1,0,38,0,-38
16206,0,0,7,0,-7
16207,1,0,6,0,-6
16208,0,0,4,0,-4
16209,0,0,127,0,-127
16210,1,1,399,1244,845
16211,1,1,329,1263,934
16212,1,1,245,1434,1189
16213,1,0,62,0,-62
16214,1,0,25,0,-25
16215,1,0,3,0,-3
16216,1,0,23,0,-23
16217,0,0,20,0,-20
16218,0,0,74,0,-74
16219,1,0,25,0,-25
16220,0,0,34,0,-34
16221,1,1,748,1284,536
16222,1,0,148,0,-148
16223,1,0,81,0,-81
16224,1,0,32,0,-32
16225,1,0,29,0,-29
16226,0,0,4,0,-4
16227,0,0,32,0,-32
16228,1,1,615,1262,647
16229,1,1,265,1286,1021
16230,1,1,138,1474,1336
16231,1,1,1614,1247,-367
16232,1,0,84,0,-84
16233,1,1,1415,1340,-75
16234,1,1,192,1257,1065
16235,0,0,13,0,-13
16236,1,1,372,1653,1281
16237,0,0,30,0,-30
16238,1,1,110,1274,1164
16239,1,0,4,0,-4
16240,0,0,13,0,-13
16241,0,0,38,0,-38
16242,1,0,49,0,-49
16243,1,0,87,0,-87
16244,1,0,19,0,-19
16245,1,0,19,0,-19
16246,1,1,158,1436,1278
16247,0,0,57,0,-57
16248,0,0,118,0,-118
16249,1,0,49,0,-49
16250,1,1,594,1320,726
16251,1,0,38,0,-38
16252,0,0,62,0,-62
16253,1,0,8,0,-8
16254,0,0,48,0,-48
16255,1,0,45,0,-45
16256,1,0,32,0,-32
16257,1,0,1,0,-1
16258,0,0,15,0,-15
16259,1,1,82,1422,1340
16260,1,1,359,1400,1041
16261,1,1,358,1500,1142
16262,0,0,18,0,-18
16263,0,0,60,0,-60
16264,1,0,43,0,-43
16265,0,0,23,0,-23
16266,0,0,10,0,-10
16267,1,0,81,0,-81
16268,1,1,490,1484,994
16269,1,1,136,1338,1202
16270,0,0,87,0,-87
16271,0,0,12,0,-12
16272,1,0,124,0,-124
16273,1,1,296,1711,1415
16274,1,0,34,0,-34
16275,1,0,3,0,-3
16276,0,0,34,0,-34
16277,0,0,29,0,-29
16278,1,0,64,0,-64
16279,1,1,592,3515,2923
16280,0,0,4,0,-4
16281,1,0,6,0,-6
16282,1,1,251,1205,954
16283,1,1,541,1203,662
16284,0,0,35,0,-35
16285,1,1,289,1692,1403
16286,0,0,124,0,-124
16287,1,1,323,1225,902
16288,1,1,316,1901,1585
16289,1,1,153,1290,1137
16290,1,1,817,1565,748
16291,1,1,434,1288,854
16292,0,0,15,0,-15
16293,1,1,1414,1205,-209
16294,1,1,123,1330,1207
16295,1,1,115,1685,1570
16296,0,0,28,0,-28
16297,1,1,102,2080,1978
16298,1,1,1043,1434,391
16299,1,0,43,0,-43
16300,1,1,395,1302,907
16301,0,0,37,0,-37
16302,1,0,93,0,-93
16303,1,1,89,2026,1937
16304,1,0,77,0,-77
16305,1,1,139,5850,5711
16306,1,0,42,0,-42
16307,0,0,20,0,-20
16308,1,0,51,0,-51
16309,1,1,690,1203,513
16310,1,1,1043,1207,164
16311,1,1,33,1262,1229
16312,1,1,769,1784,1015
16313,0,0,41,0,-41
16314,0,0,14,0,-14
16315,0,0,123,0,-123
16316,1,0,153,0,-153
16317,1,0,37,0,-37
16318,1,1,408,3309,2901
16319,1,1,214,2600,2386
16320,1,0,103,0,-103
16321,0,0,36,0,-36
16322,1,0,20,0,-20
16323,1,1,581,2124,1543
16324,1,1,299,1224,925
16325,1,0,121,0,-121
16326,0,0,12,0,-12
16327,1,1,499,2193,1694
16328,0,0,95,0,-95
16329,1,1,697,1256,559
16330,0,0,152,0,-152
16331,1,0,80,0,-80
16332,1,0,8,0,-8
16333,0,0,13,0,-13
16334,1,1,508,1328,820
16335,0,0,7,0,-7
16336,0,0,94,0,-94
16337,0,0,0,0,0
16338,1,1,534,1486,952
16339,1,0,33,0,-33
16340,1,0,46,0,-46
16341,1,1,773,2508,1735
16342,1,0,66,0,-66
16343,1,1,320,2096,1776
16344,1,0,2,0,-2
16345,0,0,25,0,-25
16346,1,0,20,0,-20
16347,1,0,147,0,-147
16348,0,0,17,0,-17
16349,1,0,138,0,-138
16350,1,1,576,3394,2818
16351,1,0,42,0,-42
16352,1,0,75,0,-75
16353,1,0,11,0,-11
16354,1,0,6,0,-6
16355,1,1,200,1356,1156
16356,1,1,641,1227,586
16357,1,1,765,1993,1228
16358,0,0,29,0,-29
16359,0,0,37,0,-37
16360,1,1,244,1515,1271
16361,1,0,6,0,-6
16362,1,0,80,0,-80
16363,1,0,60,0,-60
16364,1,1,56,1328,1272
16365,0,0,11,0,-11
16366,1,0,44,0,-44
16367,0,0,22,0,-22
16368,0,0,2,0,-2
16369,1,0,42,0,-42
16370,1,1,194,1430,1236
16371,1,1,1024,1269,245
16372,0,0,8,0,-8
16373,1,0,60,0,-60
16374,1,1,170,1590,1420
16375,1,0,20,0,-20
16376,0,0,30,0,-30
16377,0,0,41,0,-41
16378,1,1,956,1223,267
16379,0,0,4,0,-4
16380,1,1,72,1203,1131
16381,1,0,16,0,-16
16382,0,0,5,0,-5
16383,1,0,23,0,-23
16384,1,1,206,1319,1113
16385,1,1,768,2760,1992
16386,0,0,86,0,-86
16387,1,0,32,0,-32
16388,0,0,49,0,-49
16389,0,0,7,0,-7
16390,0,0,41,0,-41
16391,1,0,14,0,-14
16392,1,0,16,0,-16
16393,1,1,204,1327,1123
16394,1,1,1620,1564,-56
16395,1,1,126,1654,1528
16396,1,1,71,1251,1180
16397,1,0,51,0,-51
16398,1,1,1386,1568,182
16399,1,0,2,0,-2
16400,0,0,0,0,0
16401,1,1,199,1919,1720
16402,1,0,87,0,-87
16403,1,1,344,1683,1339
16404,1,0,26,0,-26
16405,1,0,111,0,-111
16406,0,0,41,0,-41
16407,1,1,95,1308,1213
16408,1,0,140,0,-140
16409,1,1,763,2103,1340
16410,0,0,26,0,-26
16411,1,0,10,0,-10
16412,1,0,40,0,-40
16413,1,1,294,3208,2914
16414,1,0,116,0,-116
16415,1,0,43,0,-43
16416,1,1,57,1273,1216
16417,1,1,778,1942,1164
16418,0,0,44,0,-44
16419,0,0,203,0,-203
16420,1,0,138,0,-138
16421,1,1,992,1267,275
16422,0,0,21,0,-21
16423,0,0,41,0,-41
16424,0,0,66,0,-66
16425,1,0,72,0,-72
16426,1,1,75,1305,1230
16427,1,0,36,0,-36
16428,1,0,35,0,-35
16429,1,1,1494,1743,249
16430,0,0,110,0,-110
16431,1,1,61,1438,1377
16432,1,0,2,0,-2
16433,1,1,460,1949,1489
16434,1,1,249,3275,3026
16435,1,0,306,0,-306
16436,0,0,36,0,-36
16437,0,0,7,0,-7
16438,1,1,68,1545,1477
16439,1,1,76,1243,1167
16440,1,0,16,0,-16
16441,0,0,5,0,-5
16442,1,1,389,1302,913
16443,0,0,120,0,-120
16444,1,1,1263,1531,268
16445,0,0,24,0,-24
16446,1,1,50,1973,1923
16447,0,0,7,0,-7
16448,0,0,0,0,0
16449,1,0,74,0,-74
16450,0,0,34,0,-34
16451,0,0,51,0,-51
16452,1,0,34,0,-34
16453,1,1,289,1202,913
16454,1,1,646,1236,590
16455,1,1,291,1499,1208
16456,1,1,508,1325,817
16457,0,0,30,0,-30
16458,0,0,30,0,-30
16459,0,0,35,0,-35
16460,0,0,44,0,-44
16461,1,0,8,0,-8
16462,0,0,3,0,-3
16463,0,0,181,0,-181
16464,0,0,22,0,-22
16465,0,0,9,0,-9
16466,1,1,120,1607,1487
16467,1,1,97,2296,2199
16468,1,0,19,0,-19
16469,1,0,36,0,-36
16470,0,0,140,0,-140
16471,1,1,144,1958,1814
16472,1,0,34,0,-34
16473,0,0,2,0,-2
16474,0,0,63,0,-63
16475,0,0,6,0,-6
16476,1,1,617,1319,702
16477,1,1,499,2920,2421
16478,1,1,151,1709,1558
16479,0,0,14,0,-14
16480,1,0,12,0,-12
16481,0,0,19,0,-19
16482,1,1,1146,1539,393
16483,1,1,1342,1907,565
16484,1,0,247,0,-247
16485,1,1,216,1516,1300
16486,1,0,138,0,-138
16487,0,0,86,0,-86
16488,1,1,182,1755,1573
16489,0,0,41,0,-41
16490,1,1,249,1489,1240
16491,1,0,26,0,-26
16492,1,0,67,0,-67
16493,0,0,6,0,-6
16494,1,1,108,1340,1232
16495,1,1,1410,1716,306
16496,0,0,6,0,-6
16497,1,0,72,0,-72
16498,0,0,8,0,-8
16499,1,1,52,1385,1333
16500,1,1,486,1282,796
16501,1,1,1716,2253,537
16502,1,0,72,0,-72
16503,1,1,145,1353,1208
16504,1,1,1594,3079,1485
16505,0,0,0,0,0
16506,1,0,32,0,-32
16507,1,1,1416,1226,-190
16508,0,0,13,0,-13
16509,1,0,114,0,-114
16510,0,0,17,0,-17
16511,1,1,531,1358,827
16512,1,0,91,0,-91
16513,0,0,28,0,-28
16514,1,1,1437,1642,205
16515,0,0,112,0,-112
16516,1,0,12,0,-12
16517,0,0,73,0,-73
16518,0,0,12,0,-12
16519,1,1,929,1282,353
16520,0,0,10,0,-10
16521,1,0,26,0,-26
16522,1,1,163,1430,1267
16523,1,0,16,0,-16
16524,1,1,130,1238,1108
16525,1,0,23,0,-23
16526,1,1,691,1378,687
16527,0,0,80,0,-80
16528,0,0,10,0,-10
16529,1,1,294,1253,959
16530,0,0,14,0,-14
16531,0,0,40,0,-40
16532,1,1,612,1222,610
16533,1,1,256,1293,1037
16534,1,0,7,0,-7
16535,0,0,65,0,-65
16536,1,1,501,1278,777
16537,1,0,9,0,-9
16538,1,0,22,0,-22
16539,0,0,6,0,-6
16540,1,1,663,1597,934
16541,0,0,13,0,-13
16542,1,1,732,4199,3467
16543,1,1,1489,1428,-61
16544,0,0,8,0,-8
16545,1,0,7,0,-7
16546,1,0,61,0,-61
16547,1,0,21,0,-21
16548,0,0,17,0,-17
16549,1,1,312,1644,1332
16550,1,0,133,0,-133
16551,0,0,14,0,-14
16552,0,0,71,0,-71
16553,1,0,33,0,-33
16554,0,0,6,0,-6
16555,0,0,17,0,-17
16556,1,1,213,1274,1061
16557,0,0,25,0,-25
16558,1,1,1046,1227,181
16559,0,0,22,0,-22
16560,0,0,87,0,-87
16561,1,0,42,0,-42
16562,1,0,7,0,-7
16563,1,0,128,0,-128
16564,1,1,293,1259,966
16565,1,0,38,0,-38
16566,1,0,88,0,-88
16567,1,0,5,0,-5
16568,0,0,176,0,-176
16569,1,0,8,0,-8
16570,0,0,13,0,-13
16571,0,0,80,0,-80
16572,0,0,12,0,-12
16573,0,0,88,0,-88
16574,0,0,208,0,-208
16575,0,0,20,0,-20
16576,1,0,58,0,-58
16577,1,1,1603,1467,-136
16578,0,0,20,0,-20
16579,1,0,3,0,-3
16580,1,1,238,1397,1159
16581,1,1,296,2866,2570
16582,1,0,41,0,-41
16583,0,0,132,0,-132
16584,1,1,1028,2389,1361
16585,0,0,10,0,-10
16586,0,0,151,0,-151
16587,1,0,13,0,-13
16588,0,0,42,0,-42
16589,0,0,111,0,-111
16590,1,1,97,1887,1790
16591,1,1,54,1442,1388
16592,1,0,6,0,-6
16593,0,0,31,0,-31
16594,1,1,371,1419,1048
16595,0,0,168,0,-168
16596,1,0,121,0,-121
16597,1,1,96,1636,1540
16598,0,0,172,0,-172
16599,0,0,105,0,-105
16600,1,1,793,1295,502
16601,0,0,180,0,-180
16602,1,0,6,0,-6
16603,0,0,25,0,-25
16604,1,1,695,1282,587
16605,1,0,29,0,-29
16606,1,0,59,0,-59
16607,1,0,68,0,-68
16608,1,1,496,1366,870
16609,0,0,165,0,-165
16610,1,0,92,0,-92
16611,1,0,30,0,-30
16612,1,1,1222,1819,597
16613,1,1,394,1666,1272
16614,0,0,67,0,-67
16615,0,0,1,0,-1
16616,1,1,199,1227,1028
16617,1,0,19,0,-19
16618,0,0,8,0,-8
16619,1,1,240,1487,1247
16620,1,0,122,0,-122
16621,0,0,101,0,-101
16622,0,0,72,0,-72
16623,0,0,13,0,-13
16624,1,0,91,0,-91
16625,1,0,127,0,-127
16626,1,0,45,0,-45
16627,1,1,534,1561,1027
16628,0,0,173,0,-173
16629,0,0,3,0,-3
16630,1,1,141,1547,1406
16631,1,0,90,0,-90
16632,1,1,483,2170,1687
16633,1,1,816,1241,425
16634,1,1,1544,1479,-65
16635,1,1,156,1722,1566
16636,1,0,39,0,-39
16637,0,0,15,0,-15
16638,0,0,75,0,-75
16639,1,1,403,1217,814
16640,1,0,39,0,-39
16641,0,0,34,0,-34
16642,1,1,1123,1611,488
16643,1,0,51,0,-51
16644,0,0,31,0,-31
16645,0,0,187,0,-187
16646,0,0,0,0,0
16647,1,1,310,1752,1442
16648,1,1,145,1525,1380
16649,0,0,11,0,-11
16650,1,1,984,1987,1003
16651,0,0,103,0,-103
16652,1,1,415,1394,979
16653,1,0,3,0,-3
16654,1,0,118,0,-118
16655,1,1,125,1494,1369
16656,0,0,27,0,-27
16657,1,1,135,1486,1351
16658,1,0,33,0,-33
16659,1,0,4,0,-4
16660,1,1,994,1870,876
16661,1,1,496,1267,771
16662,1,1,88,1274,1186
16663,1,0,13,0,-13
16664,1,1,906,1339,433
16665,1,0,48,0,-48
16666,0,0,26,0,-26
16667,1,1,164,1355,1191
16668,0,0,39,0,-39
16669,1,0,46,0,-46
16670,0,0,19,0,-19
16671,0,0,5,0,-5
16672,1,1,602,1470,868
16673,0,0,4,0,-4
16674,1,0,52,0,-52
16675,1,1,39,1385,1346
16676,1,0,41,0,-41
16677,0,0,18,0,-18
16678,1,0,51,0,-51
16679,1,1,634,2003,1369
16680,1,1,803,1397,594
16681,1,0,142,0,-142
16682,0,0,33,0,-33
16683,0,0,144,0,-144
16684,0,0,2,0,-2
16685,1,0,44,0,-44
16686,0,0,49,0,-49
16687,1,0,55,0,-55
16688,1,0,213,0,-213
16689,1,1,269,1519,1250
16690,1,0,26,0,-26
16691,0,0,2,0,-2
16692,1,0,5,0,-5
16693,0,0,21,0,-21
16694,0,0,64,0,-64
16695,0,0,15,0,-15
16696,1,1,16,1583,1567
16697,1,1,87,1304,1217
16698,1,1,577,1207,630
16699,0,0,53,0,-53
16700,1,1,1316,1217,-99
16701,1,0,143,0,-143
16702,1,1,27,1661,1634
16703,0,0,9,0,-9
16704,0,0,29,0,-29
16705,0,0,133,0,-133
16706,1,1,145,1264,1119
16707,1,1,1299,1354,55
16708,1,1,634,1405,771
16709,1,0,56,0,-56
16710,1,0,80,0,-80
16711,0,0,124,0,-124
16712,0,0,34,0,-34
16713,0,0,45,0,-45
16714,1,0,37,0,-37
16715,1,1,94,1428,1334
16716,0,0,33,0,-33
16717,0,0,87,0,-87
16718,0,0,47,0,-47
16719,1,0,82,0,-82
16720,1,0,32,0,-32
16721,0,0,76,0,-76
16722,1,1,83,1670,1587
16723,0,0,16,0,-16
16724,1,0,21,0,-21
16725,1,0,32,0,-32
16726,1,0,47,0,-47
16727,0,0,37,0,-37
16728,0,0,10,0,-10
16729,1,0,111,0,-111
16730,0,0,32,0,-32
16731,1,1,954,1207,253
16732,1,1,758,1314,556
16733,1,1,590,1275,685
16734,0,0,130,0,-130
16735,1,0,24,0,-24
16736,0,0,3,0,-3
16737,1,1,58,1312,1254
16738,0,0,16,0,-16
16739,1,1,933,1402,469
16740,1,0,78,0,-78
16741,0,0,5,0,-5
16742,0,0,154,0,-154
16743,1,0,13,0,-13
16744,0,0,32,0,-32
16745,1,1,149,1200,1051
16746,1,0,37,0,-37
16747,1,1,470,1974,1504
16748,0,0,96,0,-96
16749,0,0,6,0,-6
16750,1,0,42,0,-42
16751,0,0,15,0,-15
16752,1,0,8,0,-8
16753,1,0,59,0,-59
16754,1,1,1454,1562,108
16755,1,0,73,0,-73
16756,1,0,94,0,-94
16757,1,0,28,0,-28
16758,1,0,29,0,-29
16759,1,1,263,1280,1017
16760,1,0,65,0,-65
16761,1,0,28,0,-28
16762,0,0,27,0,-27
16763,0,0,33,0,-33
16764,0,0,61,0,-61
16765,1,1,177,1383,1206
16766,1,0,28,0,-28
16767,0,0,17,0,-17
16768,1,0,3,0,-3
16769,1,0,65,0,-65
16770,0,0,31,0,-31
16771,0,0,118,0,-118
16772,1,1,273,1367,1094
16773,0,0,33,0,-33
16774,1,1,1034,1209,175
16775,1,1,144,1229,1085
16776,0,0,34,0,-34
16777,0,0,68,0,-68
16778,1,1,367,1324,957
16779,1,1,56,1340,1284
16780,1,1,390,2481,2091
16781,0,0,51,0,-51
16782,0,0,69,0,-69
16783,0,0,0,0,0
16784,1,0,14,0,-14
16785,1,1,389,1279,890
16786,1,0,31,0,-31
16787,1,1,211,1353,1142
16788,1,1,1253,1270,17
16789,1,1,206,1464,1258
16790,0,0,17,0,-17
16791,1,1,702,1373,671
16792,0,0,51,0,-51
16793,0,0,163,0,-163
16794,1,0,19,0,-19
16795,0,0,41,0,-41
16796,1,0,32,0,-32
16797,0,0,59,0,-59
16798,1,1,293,1513,1220
16799,0,0,65,0,-65
16800,1,1,423,1911,1488
16801,0,0,0,0,0
16802,0,0,51,0,-51
16803,1,1,1019,1363,344
16804,1,1,758,1228,470
16805,0,0,34,0,-34
16806,1,1,397,1509,1112
16807,1,0,9,0,-9
16808,0,0,58,0,-58
16809,1,1,617,2455,1838
16810,0,0,7,0,-7
16811,0,0,86,0,-86
16812,1,0,16,0,-16
16813,1,1,725,1219,494
16814,1,0,67,0,-67
16815,1,1,156,1356,1200
16816,1,1,744,1219,475
16817,1,1,459,1536,1077
16818,0,0,32,0,-32
16819,1,0,44,0,-44
16820,0,0,27,0,-27
16821,0,0,1,0,-1
16822,1,0,99,0,-99
16823,1,1,498,1253,755
16824,1,0,26,0,-26
16825,0,0,0,0,0
16826,0,0,22,0,-22
16827,1,1,622,1342,720
16828,1,1,101,1217,1116
16829,1,1,941,1773,832
16830,1,0,27,0,-27
16831,1,0,19,0,-19
16832,1,0,113,0,-113
16833,0,0,39,0,-39
16834,1,0,36,0,-36
16835,0,0,8,0,-8
16836,1,0,13,0,-13
16837,1,0,18,0,-18
16838,1,1,1010,1285,275
16839,1,1,88,1539,1451
16840,0,0,33,0,-33
16841,1,1,189,1305,1116
16842,1,0,31,0,-31
16843,1,0,87,0,-87
16844,1,0,20,0,-20
16845,0,0,48,0,-48
16846,0,0,23,0,-23
16847,1,0,41,0,-41
16848,1,1,337,1365,1028
16849,1,0,7,0,-7
16850,1,1,1012,1438,426
16851,1,1,1555,1297,-258
16852,1,0,82,0,-82
16853,1,0,4,0,-4
16854,0,0,95,0,-95
16855,1,1,316,1228,912
16856,0,0,85,0,-85
16857,0,0,16,0,-16
16858,0,0,45,0,-45
16859,1,1,903,1245,342
16860,0,0,106,0,-106
16861,1,1,320,1399,1079
16862,1,1,858,1256,398
16863,0,0,32,0,-32
16864,1,1,187,1280,1093
16865,0,0,29,0,-29
16866,1,1,210,1536,1326
16867,1,1,369,1613,1244
16868,1,1,27,2622,2595
16869,0,0,85,0,-85
16870,0,0,5,0,-5
16871,1,0,189,0,-189
16872,1,0,106,0,-106
16873,1,1,73,1583,1510
16874,0,0,107,0,-107
16875,0,0,32,0,-32
16876,1,1,70,1526,1456
16877,1,1,456,1507,1051
16878,1,1,42,1351,1309
16879,1,1,160,1536,1376
16880,1,0,32,0,-32
16881,1,0,138,0,-138
16882,0,0,16,0,-16
16883,1,0,5,0,-5
16884,0,0,36,0,-36
16885,0,0,113,0,-113
16886,1,0,10,0,-10
16887,0,0,40,0,-40
16888,0,0,47,0,-47
16889,1,0,20,0,-20
16890,1,0,89,0,-89
16891,1,1,487,1369,882
16892,1,0,31,0,-31
16893,1,1,578,1230,652
16894,1,1,348,1932,1584
16895,0,0,5,0,-5
16896,1,0,3,0,-3
16897,0,0,43,0,-43
16898,1,0,44,0,-44
16899,1,1,197,1362,1165
16900,1,1,69,1844,1775
16901,1,1,198,1233,1035
16902,1,0,13,0,-13
16903,1,0,56,0,-56
16904,0,0,14,0,-14
16905,1,1,28,1343,1315
16906,0,0,39,0,-39
16907,1,0,77,0,-77
16908,1,1,325,1385,1060
16909,0,0,83,0,-83
16910,0,0,106,0,-106
16911,1,0,7,0,-7
16912,1,1,519,1388,869
16913,1,1,177,1398,1221
16914,1,0,5,0,-5
16915,1,1,332,1285,953
16916,1,0,63,0,-63
16917,1,0,0,0,0
16918,1,1,737,2033,1296
16919,0,0,32,0,-32
16920,1,0,37,0,-37
16921,1,0,8,0,-8
16922,0,0,87,0,-87
16923,1,0,42,0,-42
16924,1,1,863,1382,519
16925,1,1,426,2282,1856
16926,1,1,518,1767,1249
16927,1,1,1168,1236,68
16928,0,0,13,0,-13
16929,0,0,9,0,-9
16930,1,0,6,0,-6
16931,1,1,211,1361,1150
16932,0,0,50,0,-50
16933,1,0,31,0,-31
16934,0,0,18,0,-18
16935,0,0,56,0,-56
16936,0,0,85,0,-85
16937,0,0,18,0,-18
16938,0,0,8,0,-8
16939,1,1,118,1541,1423
16940,1,1,1395,1307,-88
16941,0,0,72,0,-72
16942,1,1,647,1282,635
16943,0,0,6,0,-6
16944,1,1,154,1201,1047
16945,1,0,41,0,-41
16946,0,0,51,0,-51
16947,0,0,31,0,-31
16948,1,1,853,1304,451
16949,1,0,168,0,-168
16950,1,0,27,0,-27
16951,0,0,189,0,-189
16952,1,0,4,0,-4
16953,0,0,31,0,-31
16954,1,0,24,0,-24
16955,0,0,8,0,-8
16956,1,0,7,0,-7
16957,1,0,49,0,-49
16958,0,0,89,0,-89
16959,0,0,34,0,-34
16960,1,0,2,0,-2
16961,0,0,148,0,-148
16962,1,0,41,0,-41
16963,1,1,192,1415,1223
16964,0,0,16,0,-16
16965,1,1,764,1369,605
16966,1,1,419,1371,952
16967,1,1,126,1636,1510
16968,0,0,140,0,-140
16969,1,1,685,1558,873
16970,0,0,16,0,-16
16971,0,0,70,0,-70
16972,0,0,10,0,-10
16973,1,1,640,1255,615
16974,1,1,532,1270,738
16975,0,0,58,0,-58
16976,1,1,1016,3248,2232
16977,1,1,224,1359,1135
16978,1,0,37,0,-37
16979,0,0,17,0,-17
16980,0,0,39,0,-39
16981,1,0,75,0,-75
16982,1,0,10,0,-10
16983,1,0,21,0,-21
16984,1,1,92,2010,1918
16985,0,0,24,0,-24
16986,0,0,9,0,-9
16987,1,1,294,1289,995
16988,0,0,67,0,-67
16989,0,0,10,0,-10
16990,1,0,35,0,-35
16991,1,1,1425,1552,127
16992,0,0,1,0,-1
16993,0,0,49,0,-49
16994,1,0,115,0,-115
16995,1,1,116,1478,1362
16996,0,0,1,0,-1
16997,0,0,32,0,-32
16998,0,0,3,0,-3
16999,0,0,120,0,-120
17000,0,0,25,0,-25
17001,0,0,34,0,-34
17002,1,1,620,1607,987
17003,1,0,1,0,-1
17004,0,0,28,0,-28
17005,0,0,34,0,-34
17006,0,0,111,0,-111
17007,0,0,36,0,-36
17008,0,0,19,0,-19
17009,1,1,1669,1265,-404
17010,1,1,365,6147,5782
17011,1,1,214,1890,1676
17012,1,0,84,0,-84
17013,1,1,508,2010,1502
17014,0,0,53,0,-53
17015,0,0,39,0,-39
17016,0,0,4,0,-4
17017,0,0,28,0,-28
17018,0,0,43,0,-43
17019,1,1,509,1338,829
17020,0,0,30,0,-30
17021,0,0,78,0,-78
17022,1,1,1419,1280,-139
17023,0,0,4,0,-4
17024,1,1,782,2224,1442
17025,1,1,176,1574,1398
17026,0,0,126,0,-126
17027,1,0,17,0,-17
17028,0,0,81,0,-81
17029,1,0,6,0,-6
17030,1,1,229,2044,1815
17031,0,0,25,0,-25
17032,1,0,57,0,-57
17033,0,0,115,0,-115
17034,1,1,137,1290,1153
17035,0,0,2,0,-2
17036,0,0,26,0,-26
17037,1,1,1302,1569,267
17038,0,0,20,0,-20
17039,1,0,12,0,-12
17040,1,1,274,1298,1024
17041,1,1,249,2073,1824
17042,1,1,247,1225,978
17043,1,1,120,1222,1102
17044,1,0,0,0,0
17045,0,0,21,0,-21
17046,0,0,29,0,-29
17047,1,0,3,0,-3
17048,1,0,8,0,-8
17049,1,1,274,2109,1835
17050,1,0,77,0,-77
17051,0,0,142,0,-142
17052,0,0,4,0,-4
17053,1,1,294,1600,1306
17054,1,1,403,1548,1145
17055,1,0,19,0,-19
17056,0,0,47,0,-47
17057,0,0,16,0,-16
17058,1,1,1293,1443,150
17059,1,0,104,0,-104
17060,1,1,109,1312,1203
17061,1,1,150,1478,1328
17062,0,0,0,0,0
17063,1,0,54,0,-54
17064,1,0,50,0,-50
17065,0,0,56,0,-56
17066,1,0,14,0,-14
17067,1,0,53,0,-53
17068,1,1,638,1933,1295
17069,1,1,549,2912,2363
17070,0,0,146,0,-146
17071,1,1,55,1584,1529
17072,1,0,19,0,-19
17073,1,1,676,1268,592
17074,1,1,313,2192,1879
17075,0,0,44,0,-44
17076,0,0,46,0,-46
17077,1,0,69,0,-69
17078,0,0,18,0,-18
17079,1,1,579,1292,713
17080,1,1,264,1381,1117
17081,0,0,59,0,-59
17082,0,0,96,0,-96
17083,0,0,77,0,-77
17084,0,0,32,0,-32
17085,1,0,40,0,-40
17086,0,0,131,0,-131
17087,1,0,16,0,-16
17088,1,0,121,0,-121
17089,1,0,21,0,-21
17090,1,1,2186,2546,360
17091,0,0,9,0,-9
17092,1,0,58,0,-58
17093,0,0,122,0,-122
17094,0,0,6,0,-6
17095,1,1,75,1258,1183
17096,1,0,62,0,-62
17097,1,1,217,1288,1071
17098,1,0,148,0,-148
17099,1,1,428,1273,845
17100,1,1,470,1287,817
17101,0,0,122,0,-122
17102,1,0,220,0,-220
17103,1,1,342,1245,903
17104,1,0,91,0,-91
17105,0,0,38,0,-38
17106,1,1,353,1222,869
17107,0,0,105,0,-105
17108,1,1,514,1259,745
17109,1,0,36,0,-36
17110,0,0,11,0,-11
17111,1,1,234,1633,1399
17112,1,0,21,0,-21
17113,0,0,46,0,-46
17114,0,0,2,0,-2
17115,1,0,9,0,-9
17116,1,1,320,1433,1113
17117,1,0,25,0,-25
17118,0,0,33,0,-33
17119,1,0,97,0,-97
17120,1,0,32,0,-32
17121,1,1,215,1254,1039
17122,1,0,28,0,-28
17123,1,1,257,1316,1059
17124,1,0,14,0,-14
17125,1,0,34,0,-34
17126,0,0,47,0,-47
17127,0,0,27,0,-27
17128,0,0,6,0,-6
17129,1,0,3,0,-3
17130,1,1,464,1572,1108
17131,1,1,297,1884,1587
17132,0,0,23,0,-23
17133,0,0,41,0,-41
17134,1,1,101,1491,1390
17135,1,0,48,0,-48
17136,0,0,26,0,-26
17137,0,0,27,0,-27
17138,0,0,15,0,-15
17139,0,0,27,0,-27
17140,1,0,13,0,-13
17141,1,1,932,2201,1269
17142,1,1,71,2078,2007
17143,0,0,51,0,-51
17144,0,0,34,0,-34
17145,0,0,41,0,-41
17146,1,0,2,0,-2
17147,1,0,93,0,-93
17148,1,1,1150,1688,538
17149,1,1,144,1206,1062
17150,0,0,41,0,-41
17151,1,1,89,1245,1156
17152,1,1,190,1485,1295
17153,1,1,297,1222,925
17154,1,1,1091,1272,181
17155,1,0,57,0,-57
17156,1,1,1005,1963,958
17157,0,0,8,0,-8
17158,1,1,1626,1253,-373
17159,1,0,222,0,-222
17160,0,0,15,0,-15
17161,1,0,3,0,-3
17162,1,0,75,0,-75
17163,1,0,8,0,-8
17164,0,0,48,0,-48
17165,0,0,1,0,-1
17166,1,0,127,0,-127
17167,1,1,116,1225,1109
17168,0,0,25,0,-25
17169,1,1,521,1245,724
17170,0,0,81,0,-81
17171,1,0,39,0,-39
17172,1,0,113,0,-113
17173,0,0,18,0,-18
17174,1,1,1080,1462,382
17175,1,1,49,1273,1224
17176,0,0,82,0,-82
17177,1,1,175,1356,1181
17178,1,1,1116,2150,1034
17179,1,0,24,0,-24
17180,0,0,36,0,-36
17181,1,0,45,0,-45
17182,1,0,129,0,-129
17183,0,0,11,0,-11
17184,0,0,13,0,-13
17185,1,1,519,1557,1038
17186,0,0,9,0,-9
17187,0,0,61,0,-61
17188,1,1,1422,2636,1214
17189,1,0,43,0,-43
17190,1,1,42,1463,1421
17191,1,0,4,0,-4
17192,1,1,217,1953,1736
17193,1,1,1044,1980,936
17194,1,1,302,1208,906
17195,0,0,47,0,-47
17196,0,0,56,0,-56
17197,1,0,61,0,-61
17198,1,0,131,0,-131
17199,0,0,43,0,-43
17200,1,0,16,0,-16
17201,1,0,181,0,-181
17202,1,0,10,0,-10
17203,1,0,4,0,-4
17204,0,0,1,0,-1
17205,0,0,19,0,-19
17206,1,0,48,0,-48
17207,0,0,131,0,-131
17208,0,0,103,0,-103
17209,0,0,65,0,-65
17210,1,0,91,0,-91
17211,1,1,867,1406,539
17212,1,1,639,1324,685
17213,1,0,31,0,-31
17214,1,0,49,0,-49
17215,0,0,162,0,-162
17216,1,0,29,0,-29
17217,0,0,2,0,-2
17218,0,0,27,0,-27
17219,0,0,63,0,-63
17220,1,0,4,0,-4
17221,1,1,491,1557,1066
17222,1,0,4,0,-4
17223,1,1,423,1206,783
17224,1,1,109,1759,1650
17225,1,0,17,0,-17
17226,1,1,211,2369,2158
17227,0,0,62,0,-62
17228,1,1,469,1301,832
17229,0,0,165,0,-165
17230,0,0,187,0,-187
17231,1,0,39,0,-39
17232,0,0,84,0,-84
17233,0,0,20,0,-20
17234,1,1,198,1358,1160
17235,1,1,77,2276,2199
17236,0,0,19,0,-19
17237,0,0,7,0,-7
17238,1,1,349,1230,881
17239,0,0,239,0,-239
17240,1,0,125,0,-125
17241,0,0,25,0,-25
17242,0,0,23,0,-23
17243,1,1,1313,1244,-69
17244,0,0,9,0,-9
17245,1,1,1633,1207,-426
17246,1,1,140,1708,1568
17247,1,0,1,0,-1
17248,1,1,345,2118,1773
17249,1,0,263,0,-263
17250,0,0,30,0,-30
17251,1,0,19,0,-19
17252,0,0,21,0,-21
17253,0,0,118,0,-118
17254,1,0,93,0,-93
17255,1,1,807,1281,474
17256,0,0,3,0,-3
17257,1,0,75,0,-75
17258,1,0,27,0,-27
17259,1,0,6,0,-6
17260,0,0,50,0,-50
17261,0,0,152,0,-152
17262,1,0,211,0,-211
17263,0,0,58,0,-58
17264,1,0,18,0,-18
17265,0,0,71,0,-71
17266,1,0,46,0,-46
17267,0,0,108,0,-108
17268,1,0,83,0,-83
17269,1,1,208,1776,1568
17270,0,0,65,0,-65
17271,1,0,48,0,-48
17272,1,0,8,0,-8
17273,1,0,35,0,-35
17274,1,0,0,0,0
17275,0,0,61,0,-61
17276,1,1,432,1437,1005
17277,0,0,43,0,-43
17278,0,0,48,0,-48
17279,1,0,13,0,-13
17280,0,0,33,0,-33
17281,1,1,629,1258,629
17282,0,0,35,0,-35
17283,1,0,8,0,-8
17284,0,0,47,0,-47
17285,0,0,18,0,-18
17286,0,0,197,0,-197
17287,1,1,226,1392,1166
17288,1,1,587,1985,1398
17289,0,0,4,0,-4
17290,1,1,318,2552,2234
17291,1,1,1080,1527,447
17292,1,1,19,1596,1577
17293,0,0,26,0,-26
17294,1,1,1139,1224,85
17295,1,0,63,0,-63
17296,1,0,26,0,-26
17297,1,1,543,1293,750
17298,1,0,60,0,-60
17299,0,0,33,0,-33
17300,0,0,46,0,-46
17301,0,0,54,0,-54
17302,0,0,29,0,-29
17303,1,0,28,0,-28
17304,1,1,266,1276,1010
17305,0,0,162,0,-162
17306,1,0,43,0,-43
17307,1,0,2,0,-2
17308,0,0,23,0,-23
17309,1,1,698,2078,1380
17310,1,0,11,0,-11
17311,1,1,696,1541,845
17312,0,0,13,0,-13
17313,1,1,412,1300,888
17314,0,0,108,0,-108
17315,0,0,16,0,-16
17316,1,1,171,1270,1099
17317,0,0,5,0,-5
17318,1,0,8,0,-8
17319,1,0,1,0,-1
17320,1,0,28,0,-28
17321,1,0,19,0,-19
17322,1,1,248,1441,1193
17323,1,0,116,0,-116
17324,1,0,5,0,-5
17325,0,0,17,0,-17
17326,1,1,669,1410,741
17327,1,0,0,0,0
17328,0,0,14,0,-14
17329,0,0,3,0,-3
17330,0,0,14,0,-14
17331,1,0,45,0,-45
17332,1,1,541,1956,1415
17333,0,0,99,0,-99
17334,1,0,40,0,-40
17335,0,0,13,0,-13
17336,1,1,1389,1267,-122
17337,0,0,29,0,-29
17338,1,1,197,1406,1209
17339,0,0,36,0,-36
17340,1,0,51,0,-51
17341,1,0,17,0,-17
17342,0,0,10,0,-10
17343,0,0,2,0,-2
17344,1,1,260,1764,1504
17345,1,0,17,0,-17
17346,0,0,56,0,-56
17347,0,0,124,0,-124
17348,1,1,391,1534,1143
17349,1,0,13,0,-13
17350,0,0,28,0,-28
17351,0,0,44,0,-44
17352,1,1,101,1298,1197
17353,0,0,60,0,-60
17354,0,0,35,0,-35
17355,1,0,74,0,-74
17356,0,0,29,0,-29
17357,0,0,74,0,-74
17358,0,0,51,0,-51
17359,0,0,59,0,-59
17360,0,0,49,0,-49
17361,1,1,308,1697,1389
17362,0,0,0,0,0
17363,0,0,4,0,-4
17364,1,1,902,2732,1830
17365,0,0,41,0,-41
17366,0,0,47,0,-47
17367,1,1,515,1342,827
17368,1,1,254,1995,1741
17369,0,0,31,0,-31
17370,0,0,38,0,-38
17371,0,0,54,0,-54
17372,1,1,739,1452,713
17373,1,1,422,1219,797
17374,1,0,137,0,-137
17375,1,0,47,0,-47
17376,1,1,818,2346,1528
17377,1,0,46,0,-46
17378,1,1,1587,1261,-326
17379,0,0,6,0,-6
17380,1,0,16,0,-16
17381,0,0,33,0,-33
17382,1,0,19,0,-19
17383,1,0,68,0,-68
17384,0,0,1,0,-1
17385,0,0,88,0,-88
17386,1,0,61,0,-61
17387,0,0,47,0,-47
17388,0,0,99,0,-99
17389,0,0,51,0,-51
17390,1,1,70,1224,1154
17391,1,1,957,1422,465
17392,0,0,152,0,-152
17393,1,0,120,0,-120
17394,1,0,34,0,-34
17395,1,1,101,1232,1131
17396,0,0,129,0,-129
17397,1,1,65,1909,1844
17398,0,0,172,0,-172
17399,1,0,20,0,-20
17400,1,1,266,1306,1040
17401,1,1,230,1272,1042
17402,0,0,16,0,-16
17403,1,1,890,2133,1243
17404,1,0,66,0,-66
17405,1,0,19,0,-19
17406,1,1,761,1220,459
17407,0,0,106,0,-106
17408,1,0,90,0,-90
17409,0,0,110,0,-110
17410,1,0,19,0,-19
17411,1,0,4,0,-4
17412,0,0,5,0,-5
17413,1,0,30,0,-30
17414,0,0,1,0,-1
17415,1,1,59,1442,1383
17416,1,0,94,0,-94
17417,1,1,356,1704,1348
17418,0,0,39,0,-39
17419,1,1,1635,1202,-433
17420,0,0,12,0,-12
17421,0,0,103,0,-103
17422,1,1,210,1333,1123
17423,1,0,14,0,-14
17424,1,1,780,1448,668
17425,1,1,1720,1474,-246
17426,0,0,110,0,-110
17427,1,1,1655,1254,-401
17428,1,1,730,1326,596
17429,1,1,125,1760,1635
17430,0,0,16,0,-16
17431,0,0,74,0,-74
17432,1,0,67,0,-67
17433,1,0,15,0,-15
17434,1,1,451,1272,821
17435,1,1,655,2087,1432
17436,1,1,62,1396,1334
17437,0,0,131,0,-131
17438,0,0,179,0,-179
17439,1,0,2,0,-2
17440,0,0,22,0,-22
17441,1,0,41,0,-41
17442,1,1,127,1455,1328
17443,1,0,58,0,-58
17444,1,1,44,1320,1276
17445,1,1,243,1531,1288
17446,0,0,48,0,-48
17447,0,0,43,0,-43
17448,1,0,134,0,-134
17449,1,0,70,0,-70
17450,1,0,5,0,-5
17451,1,1,347,1217,870
17452,1,1,666,1792,1126
17453,1,0,40,0,-40
17454,1,0,59,0,-59
17455,1,1,472,1289,817
17456,1,1,981,1363,382
17457,1,0,2,0,-2
17458,1,0,1,0,-1
17459,0,0,182,0,-182
17460,1,1,870,1500,630
17461,1,0,0,0,0
17462,0,0,33,0,-33
17463,0,0,2,0,-2
17464,0,0,4,0,-4
17465,1,0,6,0,-6
17466,1,0,11,0,-11
17467,1,0,80,0,-80
17468,0,0,10,0,-10
17469,1,1,589,2666,2077
17470,0,0,257,0,-257
17471,0,0,48,0,-48
17472,0,0,76,0,-76
17473,1,1,194,1663,1469
17474,0,0,165,0,-165
17475,0,0,22,0,-22
17476,1,1,119,1382,1263
17477,0,0,124,0,-124
17478,1,1,87,1961,1874
17479,0,0,36,0,-36
17480,0,0,16,0,-16
17481,0,0,23,0,-23
17482,1,1,147,1334,1187
17483,1,1,143,3338,3195
17484,0,0,92,0,-92
17485,0,0,0,0,0
17486,1,1,142,2184,2042
17487,1,0,3,0,-3
17488,1,0,23,0,-23
17489,1,0,7,0,-7
17490,0,0,59,0,-59
17491,1,0,65,0,-65
17492,1,1,1068,1521,453
17493,1,1,779,1205,426
17494,1,1,2263,2536,273
17495,1,1,346,1257,911
17496,1,0,52,0,-52
17497,1,1,193,1277,1084
17498,0,0,32,0,-32
17499,1,1,294,1278,984
17500,0,0,22,0,-22
17501,1,1,569,1589,1020
17502,0,0,86,0,-86
17503,1,1,506,2112,1606
17504,1,1,91,6572,6481
17505,0,0,15,0,-15
17506,1,1,104,1501,1397
17507,1,1,159,1422,1263
17508,0,0,18,0,-18
17509,0,0,27,0,-27
17510,0,0,20,0,-20
17511,1,1,37,2493,2456
17512,1,1,605,2084,1479
17513,0,0,285,0,-285
17514,0,0,50,0,-50
17515,0,0,53,0,-53
17516,1,0,47,0,-47
17517,0,0,116,0,-116
17518,1,0,57,0,-57
17519,1,1,112,1397,1285
17520,1,0,100,0,-100
17521,1,1,342,1329,987
17522,0,0,30,0,-30
17523,1,1,360,1613,1253
17524,0,0,70,0,-70
17525,1,0,45,0,-45
17526,0,0,103,0,-103
17527,0,0,59,0,-59
17528,0,0,21,0,-21
17529,1,1,2425,1419,-1006
17530,1,1,584,1350,766
17531,1,0,23,0,-23
17532,1,0,3,0,-3
17533,1,1,302,1293,991
17534,0,0,5,0,-5
17535,0,0,13,0,-13
17536,0,0,11,0,-11
17537,1,1,361,1334,973
17538,1,1,344,2330,1986
17539,0,0,4,0,-4
17540,1,1,408,1435,1027
17541,0,0,17,0,-17
17542,1,1,1495,1454,-41
17543,1,0,5,0,-5
17544,1,1,634,1596,962
17545,0,0,82,0,-82
17546,0,0,2,0,-2
17547,1,0,23,0,-23
17548,1,0,90,0,-90
17549,0,0,20,0,-20
17550,0,0,60,0,-60
17551,1,1,1002,1447,445
17552,1,0,53,0,-53
17553,0,0,4,0,-4
17554,1,1,502,1246,744
17555,1,0,87,0,-87
17556,1,0,11,0,-11
17557,1,1,138,1241,1103
17558,1,1,116,1609,1493
17559,0,0,51,0,-51
17560,1,0,207,0,-207
17561,1,1,536,1862,1326
17562,1,1,113,1586,1473
17563,0,0,27,0,-27
17564,0,0,30,0,-30
17565,1,0,33,0,-33
17566,1,1,489,1520,1031
17567,1,1,102,2175,2073
17568,1,0,9,0,-9
17569,1,1,788,1535,747
17570,0,0,126,0,-126
17571,1,0,37,0,-37
17572,0,0,43,0,-43
17573,1,0,43,0,-43
17574,1,0,2,0,-2
17575,0,0,40,0,-40
17576,1,0,211,0,-211
17577,0,0,50,0,-50
17578,1,1,267,1500,1233
17579,1,1,505,1330,825
17580,0,0,79,0,-79
17581,1,1,393,1678,1285
17582,1,0,15,0,-15
17583,0,0,0,0,0
17584,0,0,4,0,-4
17585,1,0,28,0,-28
17586,1,1,1414,1246,-168
17587,1,0,23,0,-23
17588,1,0,6,0,-6
17589,1,0,18,0,-18
17590,0,0,7,0,-7
17591,0,0,115,0,-115
17592,0,0,41,0,-41
17593,1,0,167,0,-167
17594,1,0,88,0,-88
17595,0,0,50,0,-50
17596,1,0,84,0,-84
17597,1,0,14,0,-14
17598,1,1,203,1498,1295
17599,1,1,282,2472,2190
17600,1,0,33,0,-33
17601,1,0,39,0,-39
17602,1,1,680,1279,599
17603,1,0,39,0,-39
17604,1,1,244,1690,1446
17605,1,1,377,1782,1405
17606,1,0,84,0,-84
17607,1,1,172,2196,2024
17608,0,0,11,0,-11
17609,0,0,10,0,-10
17610,0,0,41,0,-41
17611,0,0,255,0,-255
17612,0,0,85,0,-85
17613,0,0,60,0,-60
17614,1,1,502,1439,937
17615,1,0,47,0,-47
17616,1,1,823,1793,970
17617,1,0,117,0,-117
17618,0,0,74,0,-74
17619,1,1,640,1529,889
17620,0,0,5,0,-5
17621,0,0,70,0,-70
17622,1,0,11,0,-11
17623,1,0,164,0,-164
17624,1,0,2,0,-2
17625,1,1,403,1394,991
17626,1,0,57,0,-57
17627,1,1,1000,1760,760
17628,1,1,104,1240,1136
17629,1,1,497,1937,1440
17630,1,1,567,1239,672
17631,0,0,38,0,-38
17632,1,0,125,0,-125
17633,1,0,46,0,-46
17634,1,1,355,1576,1221
17635,1,1,1244,1250,6
17636,0,0,105,0,-105
17637,1,1,598,1321,723
17638,1,0,63,0,-63
17639,1,0,62,0,-62
17640,0,0,14,0,-14
17641,0,0,92,0,-92
17642,0,0,123,0,-123
17643,1,1,60,2307,2247
17644,0,0,23,0,-23
17645,1,1,223,1375,1152
17646,1,0,86,0,-86
17647,1,1,234,1581,1347
17648,0,0,43,0,-43
17649,1,1,545,1276,731
17650,1,1,1194,1263,69
17651,0,0,144,0,-144
17652,1,0,40,0,-40
17653,1,0,77,0,-77
17654,0,0,109,0,-109
17655,1,1,1295,1260,-35
17656,0,0,33,0,-33
17657,1,1,202,1300,1098
17658,0,0,39,0,-39
17659,1,0,22,0,-22
17660,1,1,565,1417,852
17661,1,0,117,0,-117
17662,0,0,47,0,-47
17663,1,0,17,0,-17
17664,0,0,203,0,-203
17665,1,0,22,0,-22
17666,0,0,90,0,-90
17667,1,0,17,0,-17
17668,1,1,990,1399,409
17669,0,0,1,0,-1
17670,1,0,14,0,-14
17671,0,0,58,0,-58
17672,1,0,2,0,-2
17673,1,0,48,0,-48
17674,0,0,29,0,-29
17675,1,1,588,1480,892
17676,1,1,70,1307,1237
17677,1,1,449,1348,899
17678,1,1,564,1438,874
17679,0,0,185,0,-185
17680,1,1,218,1493,1275
17681,0,0,51,0,-51
17682,0,0,1,0,-1
17683,0,0,40,0,-40
17684,1,0,18,0,-18
17685,0,0,88,0,-88
17686,1,1,1085,1273,188
17687,0,0,3,0,-3
17688,1,0,18,0,-18
17689,1,0,14,0,-14
17690,0,0,5,0,-5
17691,1,1,481,1262,781
17692,0,0,6,0,-6
17693,1,1,814,1567,753
17694,0,0,7,0,-7
17695,0,0,24,0,-24
17696,1,0,49,0,-49
17697,0,0,23,0,-23
17698,0,0,54,0,-54
17699,0,0,45,0,-45
17700,1,1,370,1572,1202
17701,1,0,27,0,-27
17702,1,1,1138,1290,152
17703,0,0,39,0,-39
17704,1,0,51,0,-51
17705,0,0,84,0,-84
17706,0,0,37,0,-37
17707,0,0,45,0,-45
17708,1,1,900,1287,387
17709,1,1,170,1235,1065
17710,1,0,159,0,-159
17711,0,0,57,0,-57
17712,1,0,16,0,-16
17713,0,0,11,0,-11
17714,1,1,340,1484,1144
17715,1,1,313,1337,1024
17716,1,1,17,1282,1265
17717,1,0,17,0,-17
17718,1,1,400,1284,884
17719,1,0,0,0,0
17720,1,0,32,0,-32
17721,1,1,815,1295,480
17722,0,0,20,0,-20
17723,0,0,93,0,-93
17724,0,0,43,0,-43
17725,1,0,21,0,-21
17726,0,0,31,0,-31
17727,1,0,99,0,-99
17728,0,0,26,0,-26
17729,1,0,21,0,-21
17730,0,0,15,0,-15
17731,0,0,5,0,-5
17732,1,0,17,0,-17
17733,1,1,275,1245,970
17734,1,1,903,1650,747
17735,1,1,161,1685,1524
17736,1,0,41,0,-41
17737,1,1,872,1825,953
17738,1,1,150,2131,1981
17739,1,0,30,0,-30
17740,1,1,938,1551,613
17741,0,0,3,0,-3
17742,1,0,40,0,-40
17743,1,1,575,1617,1042
17744,1,0,207,0,-207
17745,0,0,64,0,-64
17746,1,1,425,1244,819
17747,0,0,106,0,-106
17748,1,1,456,1864,1408
17749,1,0,40,0,-40
17750,1,1,204,1327,1123
17751,0,0,13,0,-13
17752,1,1,849,1552,703
17753,1,0,176,0,-176
17754,1,1,1142,1258,116
17755,1,0,112,0,-112
17756,1,0,80,0,-80
17757,1,1,707,1946,1239
17758,1,1,116,1226,1110
17759,0,0,98,0,-98
17760,1,1,277,1396,1119
17761,1,0,17,0,-17
17762,0,0,12,0,-12
17763,1,0,18,0,-18
17764,1,1,146,1382,1236
17765,0,0,52,0,-52
17766,1,1,283,1280,997
17767,0,0,117,0,-117
17768,1,1,264,1229,965
17769,1,0,85,0,-85
17770,0,0,40,0,-40
17771,1,1,196,1268,1072
17772,0,0,27,0,-27
17773,0,0,91,0,-91
17774,1,0,13,0,-13
17775,1,0,43,0,-43
17776,0,0,35,0,-35
17777,0,0,8,0,-8
17778,1,1,619,2037,1418
17779,1,1,378,1354,976
17780,1,1,139,1328,1189
17781,0,0,56,0,-56
17782,0,0,28,0,-28
17783,1,1,821,1736,915
17784,1,1,322,1473,1151
17785,0,0,5,0,-5
17786,0,0,0,0,0
17787,1,0,95,0,-95
17788,1,0,2,0,-2
17789,0,0,73,0,-73
17790,1,0,23,0,-23
17791,1,1,450,1470,1020
17792,0,0,9,0,-9
17793,0,0,23,0,-23
17794,1,0,26,0,-26
17795,0,0,21,0,-21
17796,0,0,34,0,-34
17797,1,1,110,1330,1220
17798,0,0,95,0,-95
17799,1,0,49,0,-49
17800,0,0,54,0,-54
17801,1,0,62,0,-62
17802,0,0,38,0,-38
17803,1,1,685,1400,715
17804,1,0,16,0,-16
17805,1,0,158,0,-158
17806,1,0,32,0,-32
17807,1,1,161,2151,1990
17808,1,0,48,0,-48
17809,1,0,16,0,-16
17810,1,1,73,1238,1165
17811,0,0,246,0,-246
17812,1,1,331,1665,1334
17813,0,0,30,0,-30
17814,1,0,4,0,-4
17815,0,0,25,0,-25
17816,0,0,2,0,-2
17817,0,0,33,0,-33
17818,1,1,1267,1335,68
17819,0,0,45,0,-45
17820,0,0,5,0,-5
17821,1,0,47,0,-47
17822,1,1,232,1469,1237
17823,1,1,127,1344,1217
17824,1,1,2255,1283,-972
17825,0,0,13,0,-13
17826,0,0,25,0,-25
17827,1,0,44,0,-44
17828,1,1,1052,1234,182
17829,1,0,34,0,-34
17830,1,0,19,0,-19
17831,1,0,21,0,-21
17832,1,0,56,0,-56
17833,1,1,1635,1200,-435
17834,0,0,37,0,-37
17835,1,0,22,0,-22
17836,1,0,156,0,-156
17837,1,0,115,0,-115
17838,0,0,33,0,-33
17839,0,0,12,0,-12
17840,0,0,43,0,-43
17841,1,1,329,1567,1238
17842,1,0,74,0,-74
17843,0,0,136,0,-136
17844,1,0,72,0,-72
17845,0,0,8,0,-8
17846,1,0,10,0,-10
17847,0,0,39,0,-39
17848,0,0,3,0,-3
17849,1,0,128,0,-128
17850,1,1,6,1255,1249
17851,1,0,97,0,-97
17852,1,0,218,0,-218
17853,1,1,596,1258,662
17854,1,1,721,1333,612
17855,1,1,540,1208,668
17856,0,0,13,0,-13
17857,1,0,78,0,-78
17858,1,1,179,1551,1372
17859,0,0,23,0,-23
17860,0,0,72,0,-72
17861,1,0,55,0,-55
17862,1,1,575,1470,895
17863,1,0,3,0,-3
17864,0,0,63,0,-63
17865,0,0,54,0,-54
17866,0,0,12,0,-12
17867,1,1,910,2108,1198
17868,0,0,73,0,-73
17869,0,0,186,0,-186
17870,1,1,503,1540,1037
17871,0,0,5,0,-5
17872,0,0,59,0,-59
17873,1,0,162,0,-162
17874,1,0,80,0,-80
17875,1,0,25,0,-25
17876,1,0,76,0,-76
17877,1,1,87,2113,2026
17878,1,0,98,0,-98
17879,1,1,422,1948,1526
17880,0,0,57,0,-57
17881,0,0,58,0,-58
17882,0,0,109,0,-109
17883,1,0,4,0,-4
17884,0,0,31,0,-31
17885,1,1,260,1209,949
17886,0,0,7,0,-7
17887,0,0,16,0,-16
17888,0,0,167,0,-167
17889,1,1,148,1405,1257
17890,0,0,28,0,-28
17891,1,1,626,1238,612
17892,1,1,29,2140,2111
17893,1,1,267,2687,2420
17894,0,0,19,0,-19
17895,1,1,905,1218,313
17896,1,0,59,0,-59
17897,1,1,398,1351,953
17898,0,0,25,0,-25
17899,0,0,46,0,-46
17900,0,0,100,0,-100
17901,1,0,6,0,-6
17902,1,1,391,1207,816
17903,1,0,68,0,-68
17904,1,1,559,1429,870
17905,0,0,19,0,-19
17906,0,0,7,0,-7
17907,0,0,56,0,-56
17908,1,0,15,0,-15
17909,0,0,57,0,-57
17910,0,0,73,0,-73
17911,0,0,73,0,-73
17912,1,0,7,0,-7
17913,1,0,27,0,-27
17914,0,0,9,0,-9
17915,0,0,43,0,-43
17916,0,0,81,0,-81
17917,1,0,17,0,-17
17918,1,1,184,1228,1044
17919,0,0,99,0,-99
17920,1,1,661,1613,952
17921,0,0,84,0,-84
17922,1,1,448,1446,998
17923,1,0,29,0,-29
17924,1,1,754,2308,1554
17925,0,0,76,0,-76
17926,1,1,453,1269,816
17927,1,0,36,0,-36
17928,0,0,115,0,-115
17929,0,0,119,0,-119
17930,0,0,34,0,-34
17931,1,0,39,0,-39
17932,1,0,92,0,-92
17933,0,0,15,0,-15
17934,1,1,1346,1901,555
17935,0,0,68,0,-68
17936,1,1,176,1233,1057
17937,1,0,59,0,-59
17938,1,1,471,1686,1215
17939,0,0,210,0,-210
17940,0,0,241,0,-241
17941,0,0,63,0,-63
17942,1,0,60,0,-60
17943,0,0,28,0,-28
17944,1,1,548,1405,857
17945,0,0,163,0,-163
17946,1,0,43,0,-43
17947,1,0,47,0,-47
17948,0,0,38,0,-38
17949,1,1,37,1796,1759
17950,0,0,23,0,-23
17951,1,0,188,0,-188
17952,0,0,0,0,0
17953,1,0,28,0,-28
17954,1,0,34,0,-34
17955,1,1,653,1202,549
17956,1,0,13,0,-13
17957,0,0,367,0,-367
17958,1,1,354,1391,1037
17959,1,0,24,0,-24
17960,0,0,41,0,-41
17961,1,0,26,0,-26
17962,0,0,145,0,-145
17963,1,1,530,1320,790
17964,0,0,36,0,-36
17965,0,0,2,0,-2
17966,0,0,14,0,-14
17967,1,0,50,0,-50
17968,1,1,32,1237,1205
17969,1,1,336,1200,864
17970,1,1,528,1230,702
17971,1,0,112,0,-112
17972,1,0,5,0,-5
17973,1,1,149,1288,1139
17974,0,0,24,0,-24
17975,1,0,164,0,-164
17976,0,0,16,0,-16
17977,0,0,18,0,-18
17978,1,1,146,1643,1497
17979,1,1,866,1300,434
17980,0,0,14,0,-14
17981,0,0,22,0,-22
17982,1,1,623,1294,671
17983,1,1,213,1468,1255
17984,1,1,667,1570,903
17985,0,0,58,0,-58
17986,0,0,54,0,-54
17987,1,0,15,0,-15
17988,0,0,62,0,-62
17989,0,0,11,0,-11
17990,0,0,12,0,-12
17991,1,1,458,1374,916
17992,1,1,200,2093,1893
17993,1,0,24,0,-24
17994,1,0,13,0,-13
17995,1,1,610,1207,597
17996,0,0,15,0,-15
17997,0,0,80,0,-80
17998,1,0,14,0,-14
17999,0,0,22,0,-22
18000,0,0,108,0,-108
18001,0,0,34,0,-34
18002,1,0,7,0,-7
18003,0,0,9,0,-9
18004,1,1,214,1281,1067
18005,1,1,1125,1369,244
18006,0,0,16,0,-16
18007,1,1,235,1401,1166
18008,0,0,51,0,-51
18009,0,0,27,0,-27
18010,1,1,874,1374,500
18011,1,1,373,1898,1525
18012,0,0,58,0,-58
18013,1,1,74,1205,1131
18014,1,1,258,1358,1100
18015,0,0,12,0,-12
18016,1,1,1274,1632,358
18017,1,0,1,0,-1
18018,1,0,7,0,-7
18019,1,1,124,1214,1090
18020,0,0,11,0,-11
18021,1,0,77,0,-77
18022,1,0,22,0,-22
18023,0,0,42,0,-42
18024,1,0,24,0,-24
18025,0,0,15,0,-15
18026,1,1,252,1275,1023
18027,1,1,156,1644,1488
18028,0,0,10,0,-10
18029,0,0,6,0,-6
18030,1,0,27,0,-27
18031,0,0,68,0,-68
18032,1,0,15,0,-15
18033,0,0,19,0,-19
18034,1,1,4197,1517,-2680
18035,1,0,102,0,-102
18036,1,1,519,1721,1202
18037,1,1,326,1555,1229
18038,1,0,4,0,-4
18039,0,0,27,0,-27
18040,1,0,20,0,-20
18041,0,0,39,0,-39
18042,0,0,3,0,-3
18043,0,0,39,0,-39
18044,0,0,85,0,-85
18045,1,1,26,1422,1396
18046,1,1,184,1297,1113
18047,1,0,95,0,-95
18048,1,1,425,1354,929
18049,1,0,36,0,-36
18050,1,1,256,3150,2894
18051,1,1,98,1463,1365
18052,1,0,8,0,-8
18053,1,1,510,1372,862
18054,0,0,81,0,-81
18055,0,0,6,0,-6
18056,0,0,14,0,-14
18057,0,0,148,0,-148
18058,0,0,51,0,-51
18059,0,0,8,0,-8
18060,1,0,38,0,-38
18061,0,0,41,0,-41
18062,1,1,216,1381,1165
18063,1,0,7,0,-7
18064,0,0,10,0,-10
18065,0,0,23,0,-23
18066,1,1,136,1847,1711
18067,0,0,35,0,-35
18068,0,0,8,0,-8
18069,1,1,785,1222,437
18070,1,0,36,0,-36
18071,1,0,46,0,-46
18072,1,0,21,0,-21
18073,1,0,2,0,-2
18074,1,0,25,0,-25
18075,1,1,992,1348,356
18076,0,0,12,0,-12
18077,0,0,0,0,0
18078,1,1,97,3716,3619
18079,1,0,58,0,-58
18080,1,1,261,1248,987
18081,0,0,30,0,-30
18082,0,0,49,0,-49
18083,0,0,113,0,-113
18084,1,1,117,1548,1431
18085,1,1,447,1508,1061
18086,0,0,34,0,-34
18087,0,0,3,0,-3
18088,1,0,47,0,-47
18089,1,1,64,1859,1795
18090,1,1,329,1414,1085
18091,1,0,111,0,-111
18092,0,0,161,0,-161
18093,1,0,44,0,-44
18094,1,1,886,2223,1337
18095,0,0,47,0,-47
18096,1,1,250,1339,1089
18097,1,0,91,0,-91
18098,0,0,35,0,-35
18099,0,0,11,0,-11
18100,0,0,16,0,-16
18101,0,0,5,0,-5
18102,1,0,37,0,-37
18103,0,0,2,0,-2
18104,0,0,62,0,-62
18105,0,0,3,0,-3
18106,1,1,895,1836,941
18107,1,0,24,0,-24
18108,0,0,80,0,-80
18109,0,0,64,0,-64
18110,1,0,2,0,-2
18111,1,0,43,0,-43
18112,0,0,146,0,-146
18113,0,0,22,0,-22
18114,1,0,62,0,-62
18115,0,0,118,0,-118
18116,0,0,93,0,-93
18117,0,0,7,0,-7
18118,1,1,237,1265,1028
18119,1,1,125,1647,1522
18120,0,0,46,0,-46
18121,1,1,878,1316,438
18122,1,0,33,0,-33
18123,0,0,7,0,-7
18124,0,0,77,0,-77
18125,0,0,36,0,-36
18126,1,1,101,1876,1775
18127,1,1,1680,1200,-480
18128,0,0,11,0,-11
18129,0,0,16,0,-16
18130,1,0,77,0,-77
18131,1,0,105,0,-105
18132,1,1,925,1491,566
18133,1,0,73,0,-73
18134,1,0,121,0,-121
18135,1,1,78,1293,1215
18136,0,0,24,0,-24
18137,0,0,24,0,-24
18138,1,1,285,1358,1073
18139,0,0,87,0,-87
18140,1,0,12,0,-12
18141,0,0,17,0,-17
18142,1,0,51,0,-51
18143,1,0,110,0,-110
18144,0,0,15,0,-15
18145,1,1,125,1266,1141
18146,0,0,66,0,-66
18147,1,1,603,1263,660
18148,1,1,1390,2599,1209
18149,0,0,78,0,-78
18150,1,0,9,0,-9
18151,0,0,30,0,-30
18152,1,0,21,0,-21
18153,1,1,352,1284,932
18154,0,0,29,0,-29
18155,0,0,0,0,0
18156,1,1,481,1317,836
18157,1,0,18,0,-18
18158,1,0,9,0,-9
18159,0,0,55,0,-55
18160,1,0,26,0,-26
18161,1,0,2,0,-2
18162,0,0,48,0,-48
18163,1,1,132,2546,2414
18164,0,0,10,0,-10
18165,1,1,135,1259,1124
18166,0,0,47,0,-47
18167,1,0,85,0,-85
18168,1,1,165,1734,1569
18169,1,1,59,1456,1397
18170,1,0,16,0,-16
18171,1,1,460,1206,746
18172,1,0,118,0,-118
18173,0,0,19,0,-19
18174,0,0,7,0,-7
18175,1,0,25,0,-25
18176,0,0,168,0,-168
18177,0,0,2,0,-2
18178,1,0,63,0,-63
18179,1,1,228,2163,1935
18180,1,1,288,1504,1216
18181,1,1,445,1313,868
18182,0,0,2,0,-2
18183,1,1,887,1403,516
18184,1,0,50,0,-50
18185,1,1,268,1266,998
18186,1,0,14,0,-14
18187,1,1,630,1218,588
18188,0,0,16,0,-16
18189,0,0,85,0,-85
18190,0,0,125,0,-125
18191,1,0,5,0,-5
18192,0,0,84,0,-84
18193,0,0,4,0,-4
18194,1,1,264,1919,1655
18195,1,0,13,0,-13
18196,1,1,625,1475,850
18197,0,0,17,0,-17
18198,1,0,117,0,-117
18199,0,0,21,0,-21
18200,0,0,105,0,-105
18201,0,0,2,0,-2
18202,1,0,13,0,-13
18203,0,0,49,0,-49
18204,0,0,5,0,-5
18205,1,1,185,1200,1015
18206,1,1,940,1604,664
18207,1,1,864,1359,495
18208,0,0,1,0,-1
18209,1,1,149,1279,1130
18210,0,0,23,0,-23
18211,0,0,26,0,-26
18212,0,0,29,0,-29
18213,1,0,1,0,-1
18214,0,0,134,0,-134
18215,0,0,41,0,-41
18216,1,1,1197,1256,59
18217,0,0,172,0,-172
18218,0,0,114,0,-114
18219,1,1,1017,2527,1510
18220,1,1,36,1624,1588
18221,1,0,82,0,-82
18222,1,1,323,2094,1771
18223,1,0,21,0,-21
18224,0,0,19,0,-19
18225,1,0,26,0,-26
18226,1,0,237,0,-237
18227,1,0,14,0,-14
18228,0,0,1,0,-1
18229,0,0,125,0,-125
18230,0,0,15,0,-15
18231,1,1,410,1221,811
18232,1,0,20,0,-20
18233,0,0,8,0,-8
18234,0,0,17,0,-17
18235,0,0,43,0,-43
18236,1,1,1498,1317,-181
18237,1,0,20,0,-20
18238,1,1,536,2004,1468
18239,0,0,94,0,-94
18240,0,0,24,0,-24
18241,0,0,5,0,-5
18242,0,0,8,0,-8
18243,1,1,1326,1561,235
18244,0,0,14,0,-14
18245,1,1,153,1794,1641
18246,1,1,92,1516,1424
18247,1,1,248,1748,1500
18248,0,0,44,0,-44
18249,1,1,269,1379,1110
18250,0,0,11,0,-11
18251,1,1,49,2746,2697
18252,0,0,23,0,-23
18253,0,0,28,0,-28
18254,1,0,93,0,-93
18255,0,0,15,0,-15
18256,1,1,781,1635,854
18257,0,0,1,0,-1
18258,0,0,1,0,-1
18259,1,0,5,0,-5
18260,1,1,313,1388,1075
18261,1,0,76,0,-76
18262,0,0,48,0,-48
18263,1,1,677,1670,993
18264,0,0,54,0,-54
18265,0,0,31,0,-31
18266,0,0,194,0,-194
18267,1,0,34,0,-34
18268,1,0,51,0,-51
18269,1,0,23,0,-23
18270,0,0,108,0,-108
18271,1,0,16,0,-16
18272,1,1,212,1361,1149
18273,0,0,61,0,-61
18274,1,1,441,1512,1071
18275,1,1,455,1237,782
18276,0,0,16,0,-16
18277,1,1,226,1457,1231
18278,1,0,268,0,-268
18279,1,0,5,0,-5
18280,0,0,52,0,-52
18281,0,0,20,0,-20
18282,0,0,17,0,-17
18283,0,0,64,0,-64
18284,0,0,40,0,-40
18285,0,0,4,0,-4
18286,1,0,202,0,-202
18287,0,0,1,0,-1
18288,1,1,248,1274,1026
18289,1,1,356,1540,1184
18290,0,0,3,0,-3
18291,0,0,10,0,-10
18292,1,0,44,0,-44
18293,1,1,475,2306,1831
18294,1,0,15,0,-15
18295,1,0,55,0,-55
18296,1,0,108,0,-108
18297,0,0,9,0,-9
18298,0,0,37,0,-37
18299,0,0,14,0,-14
18300,0,0,13,0,-13
18301,1,1,453,2087,1634
18302,0,0,41,0,-41
18303,1,1,446,3389,2943
18304,0,0,54,0,-54
18305,1,0,2,0,-2
18306,1,0,25,0,-25
18307,0,0,84,0,-84
18308,1,0,79,0,-79
18309,0,0,27,0,-27
18310,1,0,12,0,-12
18311,1,0,8,0,-8
18312,1,1,1089,2019,930
18313,1,0,17,0,-17
18314,1,0,6,0,-6
18315,0,0,29,0,-29
18316,1,1,129,1238,1109
18317,1,1,624,1765,1141
18318,0,0,12,0,-12
18319,0,0,104,0,-104
18320,1,1,852,1522,670
18321,1,0,13,0,-13
18322,0,0,57,0,-57
18323,1,1,300,1703,1403
18324,1,0,55,0,-55
18325,1,1,611,1256,645
18326,1,0,4,0,-4
18327,0,0,14,0,-14
18328,1,0,52,0,-52
18329,0,0,67,0,-67
18330,1,1,620,2124,1504
18331,1,1,308,1201,893
18332,0,0,92,0,-92
18333,1,1,775,1211,436
18334,1,1,933,2029,1096
18335,1,0,28,0,-28
18336,1,1,74,1271,1197
18337,1,1,59,1285,1226
18338,0,0,31,0,-31
18339,0,0,42,0,-42
18340,1,0,7,0,-7
18341,1,0,16,0,-16
18342,0,0,47,0,-47
18343,0,0,57,0,-57
18344,1,0,29,0,-29
18345,1,1,254,1319,1065
18346,0,0,71,0,-71
18347,1,1,49,1915,1866
18348,1,0,15,0,-15
18349,1,1,480,1368,888
18350,1,1,151,1480,1329
18351,1,0,3,0,-3
18352,1,1,329,1394,1065
18353,1,1,292,2055,1763
18354,1,0,17,0,-17
18355,1,1,459,1235,776
18356,0,0,4,0,-4
18357,0,0,98,0,-98
18358,1,0,116,0,-116
18359,1,0,63,0,-63
18360,1,1,58,1422,1364
18361,1,1,194,1685,1491
18362,1,0,2,0,-2
18363,1,1,2189,1239,-950
18364,0,0,81,0,-81
18365,0,0,0,0,0
18366,1,0,11,0,-11
18367,0,0,343,0,-343
18368,1,0,2,0,-2
18369,0,0,7,0,-7
18370,0,0,27,0,-27
18371,0,0,51,0,-51
18372,0,0,24,0,-24
18373,1,0,97,0,-97
18374,1,0,131,0,-131
18375,1,0,65,0,-65
18376,0,0,49,0,-49
18377,1,1,1057,1291,234
18378,0,0,158,0,-158
18379,1,0,28,0,-28
18380,0,0,93,0,-93
18381,0,0,96,0,-96
18382,0,0,11,0,-11
18383,1,1,1635,1287,-348
18384,0,0,15,0,-15
18385,0,0,37,0,-37
18386,0,0,16,0,-16
18387,0,0,39,0,-39
18388,1,1,201,1798,1597
18389,1,1,1097,1268,171
18390,0,0,21,0,-21
18391,1,1,1223,2100,877
18392,1,0,18,0,-18
18393,1,0,12,0,-12
18394,1,0,55,0,-55
18395,1,0,86,0,-86
18396,1,0,25,0,-25
18397,0,0,58,0,-58
18398,1,0,31,0,-31
18399,1,1,99,1477,1378
18400,0,0,4,0,-4
18401,1,0,24,0,-24
18402,0,0,31,0,-31
18403,1,0,6,0,-6
18404,0,0,82,0,-82
18405,1,0,20,0,-20
18406,1,0,193,0,-193
18407,1,0,2,0,-2
18408,1,1,2610,1535,-1075
18409,1,0,58,0,-58
18410,1,1,326,1430,1104
18411,0,0,59,0,-59
18412,1,1,756,1214,458
18413,1,1,12,1622,1610
18414,1,1,224,2135,1911
18415,1,0,31,0,-31
18416,1,1,388,1386,998
18417,1,0,57,0,-57
18418,1,1,457,1247,790
18419,0,0,79,0,-79
18420,1,0,77,0,-77
18421,0,0,11,0,-11
18422,0,0,203,0,-203
18423,1,0,24,0,-24
18424,1,1,250,1674,1424
18425,1,0,232,0,-232
18426,1,0,68,0,-68
18427,1,0,59,0,-59
18428,1,0,22,0,-22
18429,0,0,159,0,-159
18430,0,0,94,0,-94
18431,0,0,34,0,-34
18432,1,0,39,0,-39
18433,0,0,31,0,-31
18434,0,0,2,0,-2
18435,1,1,735,1777,1042
18436,1,0,77,0,-77
18437,1,1,761,1761,1000
18438,1,1,717,1270,553
18439,1,0,23,0,-23
18440,0,0,40,0,-40
18441,0,0,55,0,-55
18442,0,0,13,0,-13
18443,0,0,100,0,-100
18444,1,1,1086,1591,505
18445,0,0,15,0,-15
18446,1,0,127,0,-127
18447,1,0,20,0,-20
18448,1,0,181,0,-181
18449,0,0,5,0,-5
18450,0,0,1,0,-1
18451,0,0,19,0,-19
18452,1,1,32,2018,1986
18453,0,0,6,0,-6
18454,1,0,11,0,-11
18455,1,0,183,0,-183
18456,1,0,168,0,-168
18457,1,0,38,0,-38
18458,1,0,68,0,-68
18459,1,0,14,0,-14
18460,1,1,1953,2131,178
18461,1,0,18,0,-18
18462,0,0,8,0,-8
18463,1,1,406,1490,1084
18464,1,1,986,1587,601
18465,1,1,172,1450,1278
18466,1,1,582,1347,765
18467,1,0,17,0,-17
18468,1,1,930,1521,591
18469,0,0,71,0,-71
18470,1,0,45,0,-45
18471,1,0,4,0,-4
18472,0,0,120,0,-120
18473,0,0,11,0,-11
18474,1,1,69,2170,2101
18475,0,0,40,0,-40
18476,1,1,641,3352,2711
18477,1,0,2,0,-2
18478,0,0,117,0,-117
18479,1,0,90,0,-90
18480,0,0,20,0,-20
18481,0,0,68,0,-68
18482,0,0,59,0,-59
18483,0,0,24,0,-24
18484,0,0,28,0,-28
18485,0,0,118,0,-118
18486,0,0,88,0,-88
18487,1,1,87,1267,1180
18488,0,0,23,0,-23
18489,0,0,54,0,-54
18490,1,1,2250,1252,-998
18491,1,1,98,1680,1582
18492,1,1,517,1255,738
18493,1,1,1381,1263,-118
18494,1,1,388,1568,1180
18495,1,0,7,0,-7
18496,1,0,59,0,-59
18497,1,0,50,0,-50
18498,1,1,678,1430,752
18499,1,0,79,0,-79
18500,1,1,282,1498,1216
18501,1,0,12,0,-12
18502,1,0,18,0,-18
18503,0,0,14,0,-14
18504,1,0,18,0,-18
18505,1,0,4,0,-4
18506,0,0,67,0,-67
18507,1,0,7,0,-7
18508,1,0,14,0,-14
18509,1,1,897,1558,661
18510,0,0,37,0,-37
18511,0,0,108,0,-108
18512,1,0,121,0,-121
18513,1,1,942,1417,475
18514,1,0,135,0,-135
18515,1,1,127,2757,2630
18516,1,1,843,1667,824
18517,1,0,0,0,0
18518,0,0,101,0,-101
18519,1,1,271,1448,1177
18520,1,0,18,0,-18
18521,1,0,18,0,-18
18522,0,0,14,0,-14
18523,1,1,470,1987,1517
18524,1,0,19,0,-19
18525,1,0,265,0,-265
18526,0,0,64,0,-64
18527,1,0,61,0,-61
18528,1,0,25,0,-25
18529,1,0,86,0,-86
18530,1,0,85,0,-85
18531,1,1,538,1666,1128
18532,1,1,159,1204,1045
18533,0,0,6,0,-6
18534,0,0,17,0,-17
18535,0,0,48,0,-48
18536,1,0,20,0,-20
18537,0,0,44,0,-44
18538,0,0,5,0,-5
18539,0,0,62,0,-62
18540,1,1,205,1359,1154
18541,1,0,44,0,-44
18542,0,0,32,0,-32
18543,1,1,214,1251,1037
18544,1,1,41,2340,2299
18545,1,1,184,1451,1267
18546,1,0,187,0,-187
18547,1,1,417,1527,1110
18548,0,0,23,0,-23
18549,0,0,259,0,-259
18550,1,1,612,1282,670
18551,1,1,54,1224,1170
18552,1,0,36,0,-36
18553,0,0,82,0,-82
18554,1,1,308,1202,894
18555,1,1,420,1755,1335
18556,1,1,720,1987,1267
18557,1,1,934,1626,692
18558,1,0,304,0,-304
18559,0,0,9,0,-9
18560,1,1,395,1204,809
18561,0,0,125,0,-125
18562,1,0,55,0,-55
18563,0,0,171,0,-171
18564,1,0,66,0,-66
18565,1,0,34,0,-34
18566,1,0,1,0,-1
18567,0,0,16,0,-16
18568,1,0,31,0,-31
18569,1,1,50,1582,1532
18570,1,1,259,1478,1219
18571,1,1,149,1606,1457
18572,1,0,53,0,-53
18573,0,0,46,0,-46
18574,1,1,1013,1751,738
18575,0,0,12,0,-12
18576,0,0,21,0,-21
18577,0,0,0,0,0
18578,0,0,22,0,-22
18579,0,0,4,0,-4
18580,1,1,130,3826,3696
18581,1,0,0,0,0
18582,1,0,1,0,-1
18583,1,1,379,1467,1088
18584,1,0,45,0,-45
18585,0,0,48,0,-48
18586,1,0,53,0,-53
18587,1,1,939,1433,494
18588,1,1,169,1234,1065
18589,1,0,12,0,-12
18590,0,0,59,0,-59
18591,1,0,104,0,-104
18592,1,1,81,1207,1126
18593,1,1,487,1648,1161
18594,1,1,523,2288,1765
18595,1,0,64,0,-64
18596,0,0,157,0,-157
18597,1,1,1492,1482,-10
18598,1,1,547,1482,935
18599,1,1,705,1272,567
18600,1,1,846,1307,461
18601,1,0,0,0,0
18602,1,0,20,0,-20
18603,1,0,44,0,-44
18604,0,0,2,0,-2
18605,1,1,707,1401,694
18606,0,0,34,0,-34
18607,0,0,10,0,-10
18608,0,0,10,0,-10
18609,0,0,36,0,-36
18610,0,0,14,0,-14
18611,1,0,35,0,-35
18612,1,1,582,1333,751
18613,0,0,40,0,-40
18614,1,1,271,2729,2458
18615,0,0,83,0,-83
18616,1,0,32,0,-32
18617,1,0,17,0,-17
18618,0,0,60,0,-60
18619,1,0,94,0,-94
18620,1,0,26,0,-26
18621,0,0,54,0,-54
18622,0,0,15,0,-15
18623,0,0,72,0,-72
18624,1,0,42,0,-42
18625,0,0,7,0,-7
18626,1,0,36,0,-36
18627,1,1,1033,1316,283
18628,1,0,112,0,-112
18629,0,0,58,0,-58
18630,0,0,21,0,-21
18631,1,1,363,1406,1043
18632,1,0,16,0,-16
18633,1,1,851,1463,612
18634,0,0,48,0,-48
18635,1,1,274,1850,1576
18636,0,0,93,0,-93
18637,1,0,14,0,-14
18638,1,1,239,2425,2186
18639,1,0,29,0,-29
18640,1,0,6,0,-6
18641,0,0,205,0,-205
18642,1,1,220,1878,1658
18643,1,1,76,1854,1778
18644,1,1,1009,1398,389
18645,0,0,3,0,-3
18646,1,1,471,1373,902
18647,1,1,648,1535,887
18648,0,0,84,0,-84
18649,1,1,57,1604,1547
18650,1,0,37,0,-37
18651,0,0,145,0,-145
18652,0,0,22,0,-22
18653,1,1,1762,1531,-231
18654,1,1,460,1217,757
18655,0,0,10,0,-10
18656,0,0,15,0,-15
18657,1,0,63,0,-63
18658,1,1,1459,1277,-182
18659,1,1,67,1288,1221
18660,0,0,256,0,-256
18661,0,0,117,0,-117
18662,1,1,269,1330,1061
18663,1,1,292,1510,1218
18664,1,1,503,1694,1191
18665,1,1,45,1292,1247
18666,1,1,749,1234,485
18667,1,1,264,1311,1047
18668,0,0,15,0,-15
18669,0,0,28,0,-28
18670,0,0,98,0,-98
18671,0,0,91,0,-91
18672,1,1,2258,1305,-953
18673,1,0,6,0,-6
18674,1,0,76,0,-76
18675,1,1,584,1211,627
18676,1,1,76,1374,1298
18677,1,0,10,0,-10
18678,0,0,14,0,-14
18679,1,0,87,0,-87
18680,1,1,776,1374,598
18681,0,0,54,0,-54
18682,0,0,30,0,-30
18683,1,1,52,1247,1195
18684,1,0,63,0,-63
18685,1,0,5,0,-5
18686,1,0,30,0,-30
18687,0,0,76,0,-76
18688,1,0,37,0,-37
18689,1,1,1025,1474,449
18690,1,1,99,3424,3325
18691,1,0,152,0,-152
18692,0,0,62,0,-62
18693,0,0,91,0,-91
18694,0,0,3,0,-3
18695,1,1,109,1284,1175
18696,1,0,0,0,0
18697,0,0,49,0,-49
18698,0,0,126,0,-126
18699,0,0,97,0,-97
18700,1,0,52,0,-52
18701,1,0,57,0,-57
18702,1,1,274,1423,1149
18703,1,0,22,0,-22
18704,1,0,25,0,-25
18705,1,0,11,0,-11
18706,1,0,0,0,0
18707,1,1,1353,1977,624
18708,1,1,184,1467,1283
18709,1,1,946,1352,406
18710,0,0,16,0,-16
18711,1,1,1294,2173,879
18712,1,1,721,1267,546
18713,1,0,12,0,-12
18714,1,0,139,0,-139
18715,1,0,39,0,-39
18716,1,0,38,0,-38
18717,0,0,231,0,-231
18718,1,0,31,0,-31
18719,0,0,32,0,-32
18720,1,1,56,2251,2195
18721,1,0,73,0,-73
18722,1,0,23,0,-23
18723,0,0,156,0,-156
18724,1,0,23,0,-23
18725,1,1,105,2768,2663
18726,1,1,419,1345,926
18727,0,0,15,0,-15
18728,0,0,1,0,-1
18729,1,0,84,0,-84
18730,0,0,38,0,-38
18731,1,1,452,1440,988
18732,0,0,23,0,-23
18733,0,0,56,0,-56
18734,0,0,87,0,-87
18735,1,0,6,0,-6
18736,1,1,262,2015,1753
18737,0,0,20,0,-20
18738,1,0,82,0,-82
18739,1,0,78,0,-78
18740,0,0,184,0,-184
18741,1,1,1341,1546,205
18742,1,1,305,1532,1227
18743,0,0,11,0,-11
18744,0,0,31,0,-31
18745,1,0,17,0,-17
18746,1,1,185,1306,1121
18747,0,0,19,0,-19
18748,1,0,68,0,-68
18749,0,0,8,0,-8
18750,1,0,49,0,-49
18751,1,1,502,1524,1022
18752,1,1,1015,1322,307
18753,0,0,31,0,-31
18754,0,0,71,0,-71
18755,1,1,622,1261,639
18756,1,0,122,0,-122
18757,1,0,32,0,-32
18758,1,0,49,0,-49
18759,1,1,459,2286,1827
18760,1,1,353,1322,969
18761,0,0,104,0,-104
18762,1,1,2425,1363,-1062
18763,0,0,140,0,-140
18764,1,0,10,0,-10
18765,1,1,242,1521,1279
18766,1,0,50,0,-50
18767,1,1,531,2018,1487
18768,0,0,12,0,-12
18769,1,0,64,0,-64
18770,1,0,2,0,-2
18771,1,0,2,0,-2
18772,0,0,85,0,-85
18773,1,1,89,1822,1733
18774,1,1,301,1784,1483
18775,0,0,17,0,-17
18776,1,1,131,1228,1097
18777,1,0,40,0,-40
18778,0,0,25,0,-25
18779,0,0,1,0,-1
18780,1,0,41,0,-41
18781,1,1,521,1315,794
18782,1,0,25,0,-25
18783,0,0,142,0,-142
18784,0,0,37,0,-37
18785,1,1,526,1382,856
18786,1,0,43,0,-43
18787,0,0,8,0,-8
18788,0,0,17,0,-17
18789,0,0,33,0,-33
18790,1,1,432,1799,1367
18791,1,0,22,0,-22
18792,1,1,581,1246,665
18793,0,0,8,0,-8
18794,0,0,0,0,0
18795,0,0,15,0,-15
18796,1,0,10,0,-10
18797,0,0,154,0,-154
18798,1,1,644,1347,703
18799,1,0,43,0,-43
18800,1,1,404,1475,1071
18801,1,1,160,2546,2386
18802,0,0,43,0,-43
18803,1,1,2368,1340,-1028
18804,0,0,7,0,-7
18805,0,0,184,0,-184
18806,0,0,79,0,-79
18807,1,1,877,1314,437
18808,0,0,122,0,-122
18809,0,0,47,0,-47
18810,0,0,15,0,-15
18811,0,0,47,0,-47
18812,0,0,12,0,-12
18813,1,0,8,0,-8
18814,1,1,295,1748,1453
18815,1,0,33,0,-33
18816,1,1,1077,1708,631
18817,1,1,674,1902,1228
18818,1,1,169,1475,1306
18819,1,1,162,1918,1756
18820,0,0,162,0,-162
18821,0,0,48,0,-48
18822,1,0,45,0,-45
18823,0,0,13,0,-13
18824,0,0,7,0,-7
18825,1,0,45,0,-45
18826,1,1,357,1267,910
18827,0,0,35,0,-35
18828,1,0,68,0,-68
18829,0,0,2,0,-2
18830,1,1,297,2725,2428
18831,0,0,16,0,-16
18832,1,1,214,1222,1008
18833,0,0,44,0,-44
18834,1,1,165,1322,1157
18835,0,0,19,0,-19
18836,1,0,4,0,-4
18837,0,0,40,0,-40
18838,1,0,103,0,-103
18839,1,1,256,1849,1593
18840,1,0,8,0,-8
18841,1,1,815,2142,1327
18842,1,1,69,1227,1158
18843,0,0,34,0,-34
18844,0,0,14,0,-14
18845,0,0,56,0,-56
18846,0,0,11,0,-11
18847,0,0,43,0,-43
18848,1,0,2,0,-2
18849,0,0,26,0,-26
18850,0,0,27,0,-27
18851,0,0,71,0,-71
18852,0,0,120,0,-120
18853,1,1,599,2865,2266
18854,0,0,48,0,-48
18855,1,1,110,1390,1280
18856,1,1,426,1424,998
18857,1,1,474,2005,1531
18858,1,0,14,0,-14
18859,0,0,12,0,-12
18860,1,0,3,0,-3
18861,1,1,1173,1278,105
18862,1,0,1,0,-1
18863,0,0,44,0,-44
18864,1,0,188,0,-188
18865,1,1,1579,1638,59
18866,1,0,11,0,-11
18867,1,1,428,1236,808
18868,1,1,238,1233,995
18869,1,1,1094,1289,195
18870,0,0,69,0,-69
18871,1,1,237,1668,1431
18872,1,0,61,0,-61
18873,1,1,717,1358,641
18874,1,1,719,1423,704
18875,1,0,25,0,-25
18876,1,0,2,0,-2
18877,1,0,19,0,-19
18878,0,0,70,0,-70
18879,1,1,161,1323,1162
18880,0,0,14,0,-14
18881,0,0,134,0,-134
18882,1,0,86,0,-86
18883,1,1,287,1859,1572
18884,1,1,2256,4397,2141
18885,1,0,72,0,-72
18886,1,1,784,1597,813
18887,1,1,352,1431,1079
18888,1,1,345,1378,1033
18889,1,1,399,1360,961
18890,1,1,1696,1584,-112
18891,1,1,573,1952,1379
18892,1,0,34,0,-34
18893,1,1,447,1210,763
18894,1,1,72,2473,2401
18895,1,0,29,0,-29
18896,1,0,85,0,-85
18897,0,0,0,0,0
18898,1,1,122,1537,1415
18899,1,0,60,0,-60
18900,1,0,15,0,-15
18901,1,1,542,1224,682
18902,0,0,13,0,-13
18903,1,0,34,0,-34
18904,1,0,31,0,-31
18905,0,0,163,0,-163
18906,1,1,470,1227,757
18907,1,0,3,0,-3
18908,1,0,12,0,-12
18909,1,1,654,1869,1215
18910,1,0,6,0,-6
18911,1,1,714,1276,562
18912,1,1,207,1249,1042
18913,0,0,71,0,-71
18914,1,0,99,0,-99
18915,1,1,612,1278,666
18916,0,0,4,0,-4
18917,1,0,5,0,-5
18918,1,1,811,1276,465
18919,0,0,108,0,-108
18920,1,0,33,0,-33
18921,0,0,47,0,-47
18922,0,0,36,0,-36
18923,1,1,299,1511,1212
18924,0,0,1,0,-1
18925,1,0,24,0,-24
18926,1,1,90,9184,9094
18927,0,0,181,0,-181
18928,1,0,20,0,-20
18929,1,1,791,1641,850
18930,1,0,83,0,-83
18931,0,0,135,0,-135
18932,0,0,20,0,-20
18933,1,1,447,2179,1732
18934,0,0,94,0,-94
18935,0,0,27,0,-27
18936,0,0,51,0,-51
18937,1,1,280,1894,1614
18938,1,0,74,0,-74
18939,0,0,153,0,-153
18940,0,0,41,0,-41
18941,0,0,89,0,-89
18942,1,0,21,0,-21
18943,1,1,1478,1895,417
18944,1,0,257,0,-257
18945,1,1,246,1290,1044
18946,1,0,5,0,-5
18947,0,0,66,0,-66
18948,0,0,25,0,-25
18949,0,0,16,0,-16
18950,0,0,40,0,-40
18951,1,1,122,1914,1792
18952,0,0,138,0,-138
18953,1,0,5,0,-5
18954,0,0,35,0,-35
18955,0,0,19,0,-19
18956,1,1,106,1762,1656
18957,0,0,8,0,-8
18958,0,0,21,0,-21
18959,0,0,292,0,-292
18960,0,0,14,0,-14
18961,1,0,126,0,-126
18962,1,1,1059,1435,376
18963,1,0,68,0,-68
18964,0,0,6,0,-6
18965,0,0,8,0,-8
18966,0,0,41,0,-41
18967,0,0,94,0,-94
18968,1,1,396,1252,856
18969,1,0,36,0,-36
18970,1,1,1018,1215,197
18971,1,1,408,2112,1704
18972,1,1,743,4107,3364
18973,1,0,44,0,-44
18974,1,0,31,0,-31
18975,1,0,118,0,-118
18976,1,0,6,0,-6
18977,0,0,24,0,-24
18978,1,1,954,1690,736
18979,0,0,68,0,-68
18980,1,1,210,1384,1174
18981,0,0,30,0,-30
18982,1,1,1000,1395,395
18983,1,0,28,0,-28
18984,1,0,26,0,-26
18985,0,0,2,0,-2
18986,1,1,508,1201,693
18987,0,0,93,0,-93
18988,1,1,425,1332,907
18989,0,0,88,0,-88
18990,0,0,38,0,-38
18991,0,0,22,0,-22
18992,0,0,33,0,-33
18993,0,0,73,0,-73
18994,0,0,94,0,-94
18995,0,0,106,0,-106
18996,0,0,0,0,0
18997,0,0,36,0,-36
18998,0,0,17,0,-17
18999,1,0,81,0,-81
19000,0,0,22,0,-22
19001,1,0,4,0,-4
19002,1,1,1123,1563,440
19003,1,1,2336,1290,-1046
19004,1,0,4,0,-4
19005,1,0,10,0,-10
19006,1,1,58,1274,1216
19007,1,0,19,0,-19
19008,1,0,106,0,-106
19009,0,0,68,0,-68
19010,1,1,242,1918,1676
19011,0,0,7,0,-7
19012,1,0,74,0,-74
19013,1,1,84,2122,2038
19014,0,0,72,0,-72
19015,1,1,608,1444,836
19016,1,0,14,0,-14
19017,0,0,3,0,-3
19018,1,1,176,1631,1455
19019,1,1,352,1355,1003
19020,0,0,136,0,-136
19021,1,0,95,0,-95
19022,0,0,37,0,-37
19023,0,0,64,0,-64
19024,1,0,146,0,-146
19025,0,0,41,0,-41
19026,1,1,265,1799,1534
19027,0,0,8,0,-8
19028,1,1,410,1261,851
19029,0,0,16,0,-16
19030,1,0,55,0,-55
19031,1,1,1962,1229,-733
19032,0,0,50,0,-50
19033,1,0,4,0,-4
19034,0,0,30,0,-30
19035,1,0,60,0,-60
19036,0,0,23,0,-23
19037,0,0,155,0,-155
19038,1,1,91,1317,1226
19039,1,1,41,1554,1513
19040,1,0,72,0,-72
19041,0,0,23,0,-23
19042,1,1,436,1687,1251
19043,0,0,11,0,-11
19044,1,1,234,1418,1184
19045,1,0,20,0,-20
19046,1,1,872,2643,1771
19047,1,0,23,0,-23
19048,1,1,517,1234,717
19049,1,0,64,0,-64
19050,0,0,29,0,-29
19051,1,0,33,0,-33
19052,1,1,76,1926,1850
19053,0,0,80,0,-80
19054,1,1,445,1482,1037
19055,0,0,60,0,-60
19056,0,0,34,0,-34
19057,1,1,72,1261,1189
19058,0,0,55,0,-55
19059,1,1,78,1621,1543
19060,0,0,45,0,-45
19061,1,0,61,0,-61
19062,0,0,8,0,-8
19063,1,1,847,1336,489
19064,0,0,20,0,-20
19065,1,0,2,0,-2
19066,0,0,91,0,-91
19067,1,0,11,0,-11
19068,1,1,112,1202,1090
19069,1,0,74,0,-74
19070,1,0,18,0,-18
19071,0,0,46,0,-46
19072,1,1,70,1259,1189
19073,1,0,115,0,-115
19074,1,0,66,0,-66
19075,1,0,38,0,-38
19076,0,0,8,0,-8
19077,1,0,27,0,-27
19078,1,0,1,0,-1
19079,1,1,373,1272,899
19080,0,0,35,0,-35
19081,0,0,33,0,-33
19082,0,0,27,0,-27
19083,0,0,92,0,-92
19084,1,1,294,1225,931
19085,0,0,14,0,-14
19086,1,1,369,1541,1172
19087,0,0,8,0,-8
19088,1,0,101,0,-101
19089,0,0,22,0,-22
19090,1,0,62,0,-62
19091,0,0,140,0,-140
19092,0,0,78,0,-78
19093,1,1,454,1590,1136
19094,0,0,105,0,-105
19095,1,1,352,2035,1683
19096,1,1,260,1695,1435
19097,1,1,179,1252,1073
19098,1,0,152,0,-152
19099,0,0,13,0,-13
19100,1,1,158,1592,1434
19101,1,1,616,2051,1435
19102,1,0,93,0,-93
19103,1,0,12,0,-12
19104,1,0,42,0,-42
19105,0,0,76,0,-76
19106,1,0,5,0,-5
19107,0,0,130,0,-130
19108,1,0,37,0,-37
19109,1,0,51,0,-51
19110,0,0,17,0,-17
19111,0,0,92,0,-92
19112,1,0,94,0,-94
19113,1,1,272,1334,1062
19114,0,0,33,0,-33
19115,1,1,847,1226,379
19116,1,0,114,0,-114
19117,1,1,173,1539,1366
19118,0,0,106,0,-106
19119,0,0,104,0,-104
19120,1,0,7,0,-7
19121,0,0,11,0,-11
19122,0,0,15,0,-15
19123,1,1,1067,1243,176
19124,1,0,4,0,-4
19125,0,0,1,0,-1
19126,0,0,38,0,-38
19127,0,0,25,0,-25
19128,1,0,5,0,-5
19129,1,1,181,1617,1436
19130,1,0,94,0,-94
19131,0,0,18,0,-18
19132,0,0,164,0,-164
19133,1,1,198,1277,1079
19134,0,0,28,0,-28
19135,0,0,13,0,-13
19136,1,1,3021,1987,-1034
19137,1,1,68,1394,1326
19138,0,0,71,0,-71
19139,1,0,93,0,-93
19140,0,0,41,0,-41
19141,1,0,8,0,-8
19142,0,0,113,0,-113
19143,1,0,23,0,-23
19144,1,0,30,0,-30
19145,0,0,3,0,-3
19146,1,1,500,1627,1127
19147,1,1,787,1243,456
19148,0,0,9,0,-9
19149,1,0,1,0,-1
19150,1,0,27,0,-27
19151,1,0,8,0,-8
19152,0,0,15,0,-15
19153,0,0,28,0,-28
19154,0,0,6,0,-6
19155,1,0,53,0,-53
19156,1,1,282,1429,1147
19157,1,0,130,0,-130
19158,0,0,20,0,-20
19159,1,0,100,0,-100
19160,1,1,421,1479,1058
19161,0,0,132,0,-132
19162,1,1,306,1212,906
19163,1,0,101,0,-101
19164,0,0,15,0,-15
19165,1,0,2,0,-2
19166,1,1,1735,1490,-245
19167,0,0,121,0,-121
19168,1,0,29,0,-29
19169,1,1,271,1261,990
19170,0,0,21,0,-21
19171,0,0,41,0,-41
19172,1,0,60,0,-60
19173,1,1,149,1598,1449
19174,0,0,67,0,-67
19175,1,1,341,1267,926
19176,1,1,1803,1257,-546
19177,1,1,175,1466,1291
19178,1,1,427,1406,979
19179,1,0,55,0,-55
19180,0,0,127,0,-127
19181,1,1,351,1678,1327
19182,1,1,361,1253,892
19183,0,0,175,0,-175
19184,1,0,67,0,-67
19185,1,1,547,2424,1877
19186,0,0,31,0,-31
19187,0,0,82,0,-82
19188,0,0,78,0,-78
19189,0,0,10,0,-10
19190,0,0,236,0,-236
19191,0,0,18,0,-18
19192,1,1,1059,1314,255
19193,0,0,44,0,-44
19194,1,0,13,0,-13
19195,1,1,377,1536,1159
19196,0,0,22,0,-22
19197,1,0,45,0,-45
19198,1,0,50,0,-50
19199,1,1,339,1287,948
19200,1,1,103,1211,1108
19201,1,0,143,0,-143
19202,0,0,157,0,-157
19203,0,0,15,0,-15
19204,0,0,14,0,-14
19205,1,1,487,1228,741
19206,0,0,87,0,-87
19207,1,0,53,0,-53
19208,0,0,15,0,-15
19209,1,1,149,1377,1228
19210,1,0,55,0,-55
19211,0,0,3,0,-3
19212,0,0,15,0,-15
19213,1,0,65,0,-65
19214,1,0,46,0,-46
19215,1,0,32,0,-32
19216,1,0,96,0,-96
19217,1,0,24,0,-24
19218,0,0,100,0,-100
19219,1,1,2662,1274,-1388
19220,1,0,20,0,-20
19221,1,1,117,1229,1112
19222,1,1,605,1582,977
19223,1,1,266,1253,987
19224,0,0,40,0,-40
19225,0,0,23,0,-23
19226,0,0,31,0,-31
19227,1,0,92,0,-92
19228,0,0,84,0,-84
19229,1,1,1208,2805,1597
19230,1,1,266,1570,1304
19231,0,0,9,0,-9
19232,1,1,325,1276,951
19233,0,0,13,0,-13
19234,1,1,496,2041,1545
19235,0,0,93,0,-93
19236,0,0,17,0,-17
19237,0,0,38,0,-38
19238,0,0,5,0,-5
19239,1,1,177,1259,1082
19240,0,0,2,0,-2
19241,1,1,110,1477,1367
19242,1,1,507,1525,1018
19243,0,0,56,0,-56
19244,1,0,29,0,-29
19245,0,0,2,0,-2
19246,0,0,120,0,-120
19247,0,0,2,0,-2
19248,1,1,666,2051,1385
19249,0,0,69,0,-69
19250,0,0,12,0,-12
19251,1,1,86,1407,1321
19252,1,1,318,1288,970
19253,0,0,1,0,-1
19254,0,0,15,0,-15
19255,1,1,971,1266,295
19256,1,0,18,0,-18
19257,0,0,44,0,-44
19258,1,1,292,2068,1776
19259,1,0,10,0,-10
19260,0,0,33,0,-33
19261,1,1,827,1798,971
19262,0,0,101,0,-101
19263,1,1,305,1217,912
19264,1,1,962,1291,329
19265,1,0,70,0,-70
19266,0,0,7,0,-7
19267,1,0,24,0,-24
19268,1,0,54,0,-54
19269,1,0,42,0,-42
19270,0,0,1,0,-1
19271,1,1,700,1871,1171
19272,1,1,553,1597,1044
19273,0,0,56,0,-56
19274,1,0,17,0,-17
19275,1,0,89,0,-89
19276,1,1,381,1284,903
19277,1,0,13,0,-13
19278,0,0,10,0,-10
19279,0,0,61,0,-61
19280,0,0,21,0,-21
19281,1,0,41,0,-41
19282,0,0,275,0,-275
19283,0,0,8,0,-8
19284,1,1,90,4007,3917
19285,1,0,78,0,-78
19286,0,0,5,0,-5
19287,0,0,181,0,-181
19288,1,0,118,0,-118
19289,1,0,83,0,-83
19290,1,0,88,0,-88
19291,0,0,73,0,-73
19292,0,0,29,0,-29
19293,0,0,13,0,-13
19294,1,0,3,0,-3
19295,0,0,60,0,-60
19296,1,1,372,1473,1101
19297,1,1,1743,1244,-499
19298,1,1,232,1710,1478
19299,0,0,17,0,-17
19300,1,0,22,0,-22
19301,1,0,207,0,-207
19302,0,0,2,0,-2
19303,1,1,506,1222,716
19304,1,1,863,1248,385
19305,1,0,6,0,-6
19306,1,1,251,1306,1055
19307,0,0,27,0,-27
19308,1,1,194,1201,1007
19309,0,0,12,0,-12
19310,0,0,16,0,-16
19311,0,0,40,0,-40
19312,1,0,9,0,-9
19313,0,0,51,0,-51
19314,1,1,131,1215,1084
19315,0,0,13,0,-13
19316,0,0,109,0,-109
19317,1,1,1265,1595,330
19318,1,0,73,0,-73
19319,0,0,45,0,-45
19320,1,0,6,0,-6
19321,0,0,13,0,-13
19322,1,1,187,1240,1053
19323,1,1,69,1681,1612
19324,0,0,163,0,-163
19325,1,1,362,1287,925
19326,1,0,24,0,-24
19327,1,0,5,0,-5
19328,1,1,697,1281,584
19329,1,1,111,1221,1110
19330,1,1,327,1255,928
19331,0,0,26,0,-26
19332,0,0,253,0,-253
19333,1,1,1069,1690,621
19334,1,1,291,2342,2051
19335,1,1,278,2370,2092
19336,1,0,11,0,-11
19337,1,1,898,2710,1812
19338,0,0,9,0,-9
19339,1,1,196,1281,1085
19340,0,0,74,0,-74
19341,1,0,43,0,-43
19342,0,0,149,0,-149
19343,1,0,7,0,-7
19344,0,0,94,0,-94
19345,1,0,145,0,-145
19346,1,0,86,0,-86
19347,1,0,42,0,-42
19348,1,0,51,0,-51
19349,0,0,79,0,-79
19350,1,1,197,4100,3903
19351,1,1,569,1654,1085
19352,1,1,160,1702,1542
19353,0,0,77,0,-77
19354,1,1,351,1824,1473
19355,1,0,23,0,-23
19356,1,0,9,0,-9
19357,1,0,38,0,-38
19358,0,0,116,0,-116
19359,0,0,135,0,-135
19360,0,0,2,0,-2
19361,0,0,16,0,-16
19362,0,0,4,0,-4
19363,1,0,1,0,-1
19364,0,0,121,0,-121
19365,1,1,160,1207,1047
19366,1,1,482,2103,1621
19367,0,0,55,0,-55
19368,0,0,20,0,-20
19369,1,1,67,1468,1401
19370,1,0,110,0,-110
19371,1,1,88,1633,1545
19372,1,0,49,0,-49
19373,1,0,2,0,-2
19374,1,1,598,1549,951
19375,1,0,230,0,-230
19376,1,1,311,1339,1028
19377,0,0,6,0,-6
19378,1,1,411,2751,2340
19379,0,0,69,0,-69
19380,0,0,167,0,-167
19381,0,0,26,0,-26
19382,0,0,61,0,-61
19383,1,0,77,0,-77
19384,1,1,374,1354,980
19385,1,0,22,0,-22
19386,1,1,121,1294,1173
19387,1,1,109,1410,1301
19388,1,1,1739,1406,-333
19389,0,0,3,0,-3
19390,0,0,35,0,-35
19391,0,0,102,0,-102
19392,0,0,125,0,-125
19393,0,0,58,0,-58
19394,0,0,42,0,-42
19395,1,1,879,1648,769
19396,0,0,219,0,-219
19397,1,1,498,2127,1629
19398,1,1,277,1991,1714
19399,0,0,24,0,-24
19400,1,0,38,0,-38
19401,0,0,13,0,-13
19402,0,0,88,0,-88
19403,0,0,4,0,-4
19404,1,0,15,0,-15
19405,1,0,23,0,-23
19406,1,1,166,2873,2707
19407,0,0,2,0,-2
19408,0,0,8,0,-8
19409,0,0,66,0,-66
19410,0,0,59,0,-59
19411,1,1,884,1335,451
19412,1,1,285,1671,1386
19413,1,1,115,1258,1143
19414,1,0,79,0,-79
19415,1,1,263,1603,1340
19416,0,0,7,0,-7
19417,1,1,453,1244,791
19418,1,0,90,0,-90
19419,0,0,6,0,-6
19420,1,1,14,1469,1455
19421,0,0,7,0,-7
19422,0,0,25,0,-25
19423,1,1,1380,1390,10
19424,0,0,37,0,-37
19425,1,1,383,1243,860
19426,0,0,177,0,-177
19427,1,0,161,0,-161
19428,1,0,19,0,-19
19429,1,1,570,1345,775
19430,1,1,1567,2174,607
19431,1,0,12,0,-12
19432,0,0,39,0,-39
19433,1,0,42,0,-42
19434,0,0,25,0,-25
19435,0,0,36,0,-36
19436,0,0,47,0,-47
19437,1,1,615,1202,587
19438,0,0,53,0,-53
19439,0,0,45,0,-45
19440,0,0,7,0,-7
19441,0,0,13,0,-13
19442,1,0,173,0,-173
19443,1,1,439,1241,802
19444,1,0,29,0,-29
19445,1,1,1059,2141,1082
19446,1,1,96,1956,1860
19447,1,0,56,0,-56
19448,1,0,45,0,-45
19449,0,0,36,0,-36
19450,1,1,281,1229,948
19451,1,0,41,0,-41
19452,0,0,24,0,-24
19453,1,0,38,0,-38
19454,1,0,36,0,-36
19455,0,0,83,0,-83
19456,0,0,71,0,-71
19457,1,1,356,1435,1079
19458,0,0,13,0,-13
19459,1,1,510,2413,1903
19460,1,1,1123,1771,648
19461,1,1,273,2254,1981
19462,0,0,111,0,-111
19463,1,0,32,0,-32
19464,1,0,83,0,-83
19465,1,1,323,1282,959
19466,1,0,62,0,-62
19467,0,0,0,0,0
19468,1,1,32,1684,1652
19469,1,1,1363,2712,1349
19470,1,0,29,0,-29
19471,1,0,4,0,-4
19472,1,0,44,0,-44
19473,0,0,40,0,-40
19474,1,0,267,0,-267
19475,1,0,11,0,-11
19476,1,0,37,0,-37
19477,1,1,128,1272,1144
19478,1,1,1030,1223,193
19479,1,1,365,1470,1105
19480,0,0,46,0,-46
19481,0,0,134,0,-134
19482,1,0,7,0,-7
19483,0,0,75,0,-75
19484,1,1,907,1966,1059
19485,1,1,81,1203,1122
19486,1,1,219,1239,1020
19487,1,0,86,0,-86
19488,1,0,5,0,-5
19489,0,0,11,0,-11
19490,0,0,19,0,-19
19491,1,1,1601,1936,335
19492,1,0,71,0,-71
19493,1,0,112,0,-112
19494,1,0,11,0,-11
19495,1,0,146,0,-146
19496,1,0,86,0,-86
19497,1,0,24,0,-24
19498,0,0,77,0,-77
19499,1,0,5,0,-5
19500,1,0,26,0,-26
19501,1,1,1504,1487,-17
19502,1,1,116,1429,1313
19503,1,0,33,0,-33
19504,0,0,11,0,-11
19505,1,0,57,0,-57
19506,0,0,15,0,-15
19507,1,1,136,1417,1281
19508,0,0,52,0,-52
19509,0,0,2,0,-2
19510,1,1,554,1491,937
19511,0,0,53,0,-53
19512,0,0,2,0,-2
19513,1,1,61,4014,3953
19514,1,1,59,1827,1768
19515,1,0,89,0,-89
19516,1,1,829,1358,529
19517,0,0,21,0,-21
19518,0,0,21,0,-21
19519,0,0,61,0,-61
19520,1,1,139,1558,1419
19521,1,0,24,0,-24
19522,1,1,811,1357,546
19523,0,0,52,0,-52
19524,0,0,65,0,-65
19525,1,1,265,1641,1376
19526,1,1,977,2598,1621
19527,0,0,24,0,-24
19528,1,0,63,0,-63
19529,0,0,22,0,-22
19530,1,1,1648,1289,-359
19531,1,0,16,0,-16
19532,1,1,228,1464,1236
19533,0,0,8,0,-8
19534,0,0,1,0,-1
19535,0,0,38,0,-38
19536,0,0,210,0,-210
19537,0,0,44,0,-44
19538,1,1,559,1270,711
19539,0,0,0,0,0
19540,0,0,30,0,-30
19541,1,1,37,2499,2462
19542,0,0,19,0,-19
19543,1,1,467,1345,878
19544,1,0,15,0,-15
19545,1,0,7,0,-7
19546,1,0,50,0,-50
19547,0,0,6,0,-6
19548,0,0,5,0,-5
19549,0,0,148,0,-148
19550,0,0,50,0,-50
19551,0,0,14,0,-14
19552,0,0,17,0,-17
19553,1,1,184,1591,1407
19554,1,0,12,0,-12
19555,1,0,12,0,-12
19556,0,0,96,0,-96
19557,1,1,751,1946,1195
19558,1,1,447,1213,766
19559,1,1,438,1595,1157
19560,0,0,16,0,-16
19561,1,1,382,1654,1272
19562,1,1,2251,2023,-228
19563,0,0,99,0,-99
19564,1,1,587,1220,633
19565,1,1,176,1305,1129
19566,0,0,70,0,-70
19567,0,0,46,0,-46
19568,0,0,25,0,-25
19569,1,1,393,1597,1204
19570,0,0,50,0,-50
19571,1,0,111,0,-111
19572,1,1,165,1406,1241
19573,1,0,27,0,-27
19574,1,0,91,0,-91
19575,0,0,23,0,-23
19576,0,0,58,0,-58
19577,0,0,23,0,-23
19578,1,1,994,1429,435
19579,0,0,10,0,-10
19580,0,0,16,0,-16
19581,1,1,634,1287,653
19582,1,1,471,2351,1880
19583,0,0,80,0,-80
19584,1,1,2518,1602,-916
19585,1,0,24,0,-24
19586,0,0,5,0,-5
19587,1,0,14,0,-14
19588,1,1,133,1598,1465
19589,1,0,21,0,-21
19590,1,0,49,0,-49
19591,1,0,12,0,-12
19592,1,0,59,0,-59
19593,1,0,29,0,-29
19594,1,0,62,0,-62
19595,0,0,83,0,-83
19596,0,0,100,0,-100
19597,1,1,653,1221,568
19598,0,0,34,0,-34
19599,1,1,245,1289,1044
19600,1,0,30,0,-30
19601,0,0,217,0,-217
19602,0,0,4,0,-4
19603,1,0,59,0,-59
19604,1,1,1269,1359,90
19605,1,1,521,1407,886
19606,1,0,54,0,-54
19607,1,1,69,1291,1222
19608,1,1,191,1329,1138
19609,1,0,2,0,-2
19610,1,0,36,0,-36
19611,1,1,58,2220,2162
19612,1,1,2245,2276,31
19613,1,1,330,1345,1015
19614,1,0,42,0,-42
19615,1,1,1093,1236,143
19616,0,0,2,0,-2
19617,1,0,29,0,-29
19618,1,0,13,0,-13
19619,0,0,14,0,-14
19620,1,0,145,0,-145
19621,0,0,66,0,-66
19622,1,1,804,1767,963
19623,0,0,53,0,-53
19624,1,1,570,1661,1091
19625,1,0,118,0,-118
19626,1,0,3,0,-3
19627,1,0,62,0,-62
19628,1,0,122,0,-122
19629,1,0,92,0,-92
19630,1,1,397,1588,1191
19631,0,0,47,0,-47
19632,1,0,105,0,-105
19633,1,0,7,0,-7
19634,1,0,38,0,-38
19635,1,1,650,1299,649
19636,0,0,33,0,-33
19637,0,0,219,0,-219
19638,0,0,57,0,-57
19639,0,0,18,0,-18
19640,0,0,12,0,-12
19641,1,0,29,0,-29
19642,1,1,294,1671,1377
19643,0,0,56,0,-56
19644,1,0,37,0,-37
19645,1,0,11,0,-11
19646,1,1,377,1495,1118
19647,1,1,302,1250,948
19648,0,0,4,0,-4
19649,0,0,22,0,-22
19650,1,1,1060,1317,257
19651,1,0,81,0,-81
19652,1,0,15,0,-15
19653,1,0,76,0,-76
19654,1,0,114,0,-114
19655,0,0,76,0,-76
19656,1,1,177,2262,2085
19657,1,1,3600,1444,-2156
19658,0,0,35,0,-35
19659,0,0,33,0,-33
19660,0,0,43,0,-43
19661,1,1,435,1276,841
19662,1,0,2,0,-2
19663,0,0,60,0,-60
19664,1,0,1,0,-1
19665,1,0,106,0,-106
19666,1,0,25,0,-25
19667,1,0,15,0,-15
19668,1,0,19,0,-19
19669,1,1,18,1218,1200
19670,0,0,77,0,-77
19671,1,0,36,0,-36
19672,0,0,0,0,0
19673,1,0,1,0,-1
19674,1,1,603,1405,802
19675,1,1,332,1360,1028
19676,1,1,30,2932,2902
19677,0,0,44,0,-44
19678,1,0,93,0,-93
19679,1,0,18,0,-18
19680,1,0,38,0,-38
19681,1,1,328,3533,3205
19682,0,0,4,0,-4
19683,1,1,175,2781,2606
19684,1,0,4,0,-4
19685,0,0,22,0,-22
19686,0,0,231,0,-231
19687,0,0,111,0,-111
19688,1,0,113,0,-113
19689,1,1,125,1681,1556
19690,1,1,188,2806,2618
19691,1,0,21,0,-21
19692,1,1,451,1344,893
19693,1,1,334,1612,1278
19694,1,1,618,1374,756
19695,0,0,22,0,-22
19696,1,0,47,0,-47
19697,0,0,18,0,-18
19698,0,0,85,0,-85
19699,0,0,18,0,-18
19700,1,1,803,1350,547
19701,0,0,18,0,-18
19702,1,0,11,0,-11
19703,1,1,83,1231,1148
19704,0,0,63,0,-63
19705,1,0,21,0,-21
19706,1,0,4,0,-4
19707,0,0,30,0,-30
19708,1,1,836,1834,998
19709,1,1,1113,1310,197
19710,0,0,120,0,-120
19711,0,0,36,0,-36
19712,1,1,61,3048,2987
19713,1,0,27,0,-27
19714,1,1,671,1616,945
19715,1,1,199,1380,1181
19716,1,0,45,0,-45
19717,0,0,72,0,-72
19718,1,0,52,0,-52
19719,0,0,38,0,-38
19720,0,0,12,0,-12
19721,1,1,471,1581,1110
19722,0,0,36,0,-36
19723,1,1,833,1340,507
19724,1,0,74,0,-74
19725,1,0,24,0,-24
19726,0,0,50,0,-50
19727,0,0,31,0,-31
19728,0,0,74,0,-74
19729,1,1,160,1581,1421
19730,1,0,27,0,-27
19731,0,0,22,0,-22
19732,1,1,156,1909,1753
19733,1,1,1736,2869,1133
19734,1,1,1065,1357,292
19735,1,1,2389,1882,-507
19736,0,0,133,0,-133
19737,1,1,344,1290,946
19738,1,0,5,0,-5
19739,0,0,33,0,-33
19740,1,1,472,1205,733
19741,0,0,8,0,-8
19742,1,1,224,2299,2075
19743,0,0,27,0,-27
19744,1,1,875,1463,588
19745,0,0,60,0,-60
19746,0,0,43,0,-43
19747,1,1,1728,1239,-489
19748,0,0,11,0,-11
19749,0,0,42,0,-42
19750,1,1,309,1252,943
19751,1,1,1344,1245,-99
19752,1,0,10,0,-10
19753,1,0,95,0,-95
19754,1,0,32,0,-32
19755,1,1,158,1559,1401
19756,1,0,32,0,-32
19757,1,1,1483,1274,-209
19758,1,0,63,0,-63
19759,1,1,613,1365,752
19760,0,0,31,0,-31
19761,0,0,47,0,-47
19762,0,0,2,0,-2
19763,0,0,136,0,-136
19764,0,0,115,0,-115
19765,0,0,23,0,-23
19766,0,0,16,0,-16
19767,1,0,44,0,-44
19768,1,0,8,0,-8
19769,1,1,510,1373,863
19770,1,0,0,0,0
19771,1,1,85,1257,1172
19772,1,1,1353,1313,-40
19773,1,1,1038,1233,195
19774,1,1,1465,1380,-85
19775,1,0,40,0,-40
19776,1,1,1390,1357,-33
19777,1,1,292,2535,2243
19778,1,1,242,2351,2109
19779,1,0,99,0,-99
19780,0,0,12,0,-12
19781,0,0,18,0,-18
19782,0,0,70,0,-70
19783,1,1,208,1469,1261
19784,0,0,17,0,-17
19785,1,1,243,1279,1036
19786,1,0,29,0,-29
19787,0,0,26,0,-26
19788,1,0,62,0,-62
19789,0,0,24,0,-24
19790,1,0,28,0,-28
19791,0,0,134,0,-134
19792,1,1,474,1662,1188
19793,1,0,132,0,-132
19794,1,1,1633,1702,69
19795,0,0,53,0,-53
19796,1,1,52,1578,1526
19797,1,0,105,0,-105
19798,0,0,34,0,-34
19799,1,1,17,1676,1659
19800,1,1,139,1366,1227
19801,0,0,31,0,-31
19802,1,1,343,1233,890
19803,1,1,45,1331,1286
19804,1,1,1227,1663,436
19805,1,0,12,0,-12
19806,1,1,506,1624,1118
19807,0,0,176,0,-176
19808,1,0,4,0,-4
19809,0,0,45,0,-45
19810,0,0,4,0,-4
19811,0,0,39,0,-39
19812,0,0,23,0,-23
19813,1,0,126,0,-126
19814,1,0,71,0,-71
19815,0,0,11,0,-11
19816,1,0,15,0,-15
19817,1,1,287,1211,924
19818,0,0,52,0,-52
19819,0,0,3,0,-3
19820,1,0,6,0,-6
19821,0,0,44,0,-44
19822,0,0,34,0,-34
19823,0,0,83,0,-83
19824,1,1,79,1321,1242
19825,0,0,15,0,-15
19826,1,0,22,0,-22
19827,1,1,1453,1213,-240
19828,1,0,83,0,-83
19829,0,0,19,0,-19
19830,0,0,8,0,-8
19831,1,1,116,1228,1112
19832,0,0,37,0,-37
19833,1,1,2025,1336,-689
19834,0,0,33,0,-33
19835,1,1,421,1309,888
19836,1,1,252,1280,1028
19837,0,0,31,0,-31
19838,1,0,128,0,-128
19839,0,0,67,0,-67
19840,1,0,67,0,-67
19841,1,0,12,0,-12
19842,1,1,965,2053,1088
19843,0,0,52,0,-52
19844,1,1,1095,1412,317
19845,1,1,1757,1476,-281
19846,1,0,13,0,-13
19847,0,0,120,0,-120
19848,0,0,1,0,-1
19849,1,1,152,1253,1101
19850,0,0,16,0,-16
19851,1,0,28,0,-28
19852,1,1,121,1353,1232
19853,1,0,39,0,-39
19854,1,0,5,0,-5
19855,1,1,2217,1506,-711
19856,1,1,694,1825,1131
19857,1,1,298,1232,934
19858,0,0,180,0,-180
19859,0,0,114,0,-114
19860,1,0,20,0,-20
19861,0,0,14,0,-14
19862,1,1,114,1411,1297
19863,1,0,18,0,-18
19864,0,0,117,0,-117
19865,1,0,2,0,-2
19866,0,0,65,0,-65
19867,0,0,25,0,-25
19868,0,0,164,0,-164
19869,1,1,41,1249,1208
19870,0,0,3,0,-3
19871,1,0,17,0,-17
19872,1,1,445,1560,1115
19873,1,1,125,1591,1466
19874,1,0,33,0,-33
19875,1,0,15,0,-15
19876,1,0,67,0,-67
19877,1,0,41,0,-41
19878,1,1,737,1484,747
19879,1,1,42,1219,1177
19880,0,0,21,0,-21
19881,0,0,16,0,-16
19882,1,0,0,0,0
19883,1,1,1401,1325,-76
19884,0,0,129,0,-129
19885,0,0,15,0,-15
19886,0,0,44,0,-44
19887,0,0,24,0,-24
19888,0,0,10,0,-10
19889,0,0,83,0,-83
19890,1,0,150,0,-150
19891,1,1,233,1849,1616
19892,1,0,4,0,-4
19893,0,0,65,0,-65
19894,0,0,41,0,-41
19895,1,1,116,2511,2395
19896,1,0,4,0,-4
19897,1,1,892,2497,1605
19898,1,0,96,0,-96
19899,0,0,122,0,-122
19900,1,0,9,0,-9
19901,1,1,519,1377,858
19902,1,1,95,1798,1703
19903,0,0,60,0,-60
19904,1,0,6,0,-6
19905,1,1,400,1249,849
19906,1,0,52,0,-52
19907,1,1,879,1665,786
19908,1,0,3,0,-3
19909,1,0,18,0,-18
19910,1,0,123,0,-123
19911,0,0,100,0,-100
19912,1,0,34,0,-34
19913,0,0,33,0,-33
19914,0,0,110,0,-110
19915,0,0,39,0,-39
19916,1,0,48,0,-48
19917,0,0,207,0,-207
19918,1,0,83,0,-83
19919,1,0,11,0,-11
19920,1,0,1,0,-1
19921,0,0,56,0,-56
19922,0,0,48,0,-48
19923,0,0,10,0,-10
19924,1,0,54,0,-54
19925,1,1,403,1563,1160
19926,1,0,25,0,-25
19927,1,0,7,0,-7
19928,1,0,8,0,-8
19929,0,0,17,0,-17
19930,1,1,2776,1363,-1413
19931,1,1,480,1749,1269
19932,0,0,66,0,-66
19933,1,1,780,1444,664
19934,1,0,14,0,-14
19935,1,1,1048,1402,354
19936,1,1,418,1225,807
19937,1,0,13,0,-13
19938,1,0,40,0,-40
19939,1,1,496,1445,949
19940,0,0,195,0,-195
19941,1,0,26,0,-26
19942,0,0,15,0,-15
19943,1,0,51,0,-51
19944,0,0,73,0,-73
19945,1,0,39,0,-39
19946,1,0,89,0,-89
19947,0,0,65,0,-65
19948,1,1,558,1587,1029
19949,0,0,66,0,-66
19950,0,0,45,0,-45
19951,1,1,73,1749,1676
19952,1,1,326,1906,1580
19953,0,0,36,0,-36
19954,0,0,29,0,-29
19955,0,0,50,0,-50
19956,1,0,142,0,-142
19957,1,0,29,0,-29
19958,1,0,166,0,-166
19959,1,1,138,1209,1071
19960,0,0,96,0,-96
19961,1,1,711,1276,565
19962,1,0,5,0,-5
19963,0,0,52,0,-52
19964,1,0,19,0,-19
19965,1,1,341,1384,1043
19966,1,0,135,0,-135
19967,1,1,406,1372,966
19968,0,0,210,0,-210
19969,1,1,423,1356,933
19970,0,0,6,0,-6
19971,1,0,119,0,-119
19972,0,0,65,0,-65
19973,0,0,85,0,-85
19974,1,1,584,1764,1180
19975,0,0,59,0,-59
19976,1,0,60,0,-60
19977,1,1,626,2127,1501
19978,0,0,7,0,-7
19979,1,0,10,0,-10
19980,0,0,155,0,-155
19981,1,0,18,0,-18
19982,0,0,42,0,-42
19983,0,0,27,0,-27
19984,1,1,732,1550,818
19985,1,0,30,0,-30
19986,1,0,10,0,-10
19987,0,0,66,0,-66
19988,1,1,678,1508,830
19989,1,0,130,0,-130
19990,0,0,82,0,-82
19991,0,0,67,0,-67
19992,0,0,79,0,-79
19993,1,0,32,0,-32
19994,0,0,77,0,-77
19995,1,0,2,0,-2
19996,1,0,5,0,-5
19997,1,0,22,0,-22
19998,1,0,67,0,-67
19999,0,0,5,0,-5
20000,1,0,77,0,-77
20001,1,1,1339,1289,-50
20002,1,1,26,3003,2977
20003,1,1,2452,1670,-782
20004,1,1,171,1893,1722
20005,1,1,1073,1316,243
20006,1,0,18,0,-18
20007,1,1,796,2026,1230
20008,0,0,62,0,-62
20009,1,1,300,1376,1076
20010,0,0,44,0,-44
20011,0,0,74,0,-74
20012,0,0,91,0,-91
20013,1,1,201,1628,1427
20014,1,1,923,1221,298
20015,1,1,85,1468,1383
20016,0,0,18,0,-18
20017,1,1,185,1791,1606
20018,1,0,63,0,-63
20019,1,1,100,1347,1247
20020,1,0,2,0,-2
20021,1,1,1392,1334,-58
20022,1,0,9,0,-9
20023,1,1,449,1582,1133
20024,1,1,581,1286,705
20025,1,0,5,0,-5
20026,0,0,125,0,-125
20027,1,0,86,0,-86
20028,0,0,48,0,-48
20029,0,0,1,0,-1
20030,1,1,1270,1379,109
20031,1,0,0,0,0
20032,1,0,18,0,-18
20033,1,1,217,1337,1120
20034,1,1,2794,1616,-1178
20035,1,0,12,0,-12
20036,1,1,457,2040,1583
20037,1,1,640,1243,603
20038,0,0,104,0,-104
20039,1,1,691,1414,723
20040,0,0,0,0,0
20041,1,1,344,2129,1785
20042,0,0,59,0,-59
20043,0,0,37,0,-37
20044,1,1,775,1314,539
20045,0,0,25,0,-25
20046,1,0,31,0,-31
20047,1,0,24,0,-24
20048,1,1,898,1214,316
20049,1,1,1100,1688,588
20050,1,1,161,1815,1654
20051,0,0,27,0,-27
20052,1,1,88,1207,1119
20053,1,1,365,1223,858
20054,1,0,11,0,-11
20055,1,0,5,0,-5
20056,1,0,51,0,-51
20057,1,1,497,1337,840
20058,0,0,4,0,-4
20059,0,0,5,0,-5
20060,1,1,774,1290,516
20061,1,0,6,0,-6
20062,1,1,176,1338,1162
20063,1,1,944,1205,261
20064,0,0,0,0,0
20065,1,0,4,0,-4
20066,0,0,38,0,-38
20067,0,0,3,0,-3
20068,1,1,1231,1686,455
20069,1,0,37,0,-37
20070,1,1,1077,1423,346
20071,0,0,19,0,-19
20072,1,1,716,1355,639
20073,1,0,13,0,-13
20074,1,0,61,0,-61
20075,1,1,421,1668,1247
20076,0,0,49,0,-49
20077,1,1,240,1787,1547
20078,1,0,34,0,-34
20079,1,1,415,1966,1551
20080,1,0,23,0,-23
20081,1,0,66,0,-66
20082,1,1,541,1252,711
20083,0,0,26,0,-26
20084,1,0,53,0,-53
20085,0,0,34,0,-34
20086,0,0,7,0,-7
20087,1,0,145,0,-145
20088,1,0,4,0,-4
20089,1,1,1165,2650,1485
20090,1,0,66,0,-66
20091,1,0,100,0,-100
20092,0,0,39,0,-39
20093,1,0,1,0,-1
20094,1,1,296,1543,1247
20095,1,1,875,1384,509
20096,1,1,1358,2460,1102
20097,1,1,645,1273,628
20098,1,0,86,0,-86
20099,1,1,474,1333,859
20100,1,1,118,1269,1151
20101,0,0,17,0,-17
20102,1,1,271,2972,2701
20103,1,1,1065,1313,248
20104,0,0,67,0,-67
20105,0,0,36,0,-36
20106,1,0,54,0,-54
20107,0,0,14,0,-14
20108,1,1,119,1201,1082
20109,1,0,6,0,-6
20110,1,0,124,0,-124
20111,0,0,96,0,-96
20112,0,0,32,0,-32
20113,1,0,128,0,-128
20114,0,0,127,0,-127
20115,1,0,55,0,-55
20116,1,1,147,1309,1162
20117,0,0,11,0,-11
20118,1,1,298,2031,1733
20119,1,1,293,1412,1119
20120,0,0,30,0,-30
20121,1,0,33,0,-33
20122,0,0,29,0,-29
20123,1,1,1778,1235,-543
20124,0,0,169,0,-169
20125,1,0,5,0,-5
20126,0,0,18,0,-18
20127,1,1,355,1641,1286
20128,1,1,321,1449,1128
20129,1,0,9,0,-9
20130,1,1,269,1432,1163
20131,0,0,31,0,-31
20132,0,0,6,0,-6
20133,1,0,26,0,-26
20134,0,0,21,0,-21
20135,1,1,344,1398,1054
20136,1,0,47,0,-47
20137,1,1,219,1524,1305
20138,0,0,42,0,-42
20139,1,0,7,0,-7
20140,1,0,8,0,-8
20141,1,0,4,0,-4
20142,0,0,97,0,-97
20143,0,0,16,0,-16
20144,0,0,61,0,-61
20145,0,0,100,0,-100
20146,0,0,0,0,0
20147,1,1,750,1872,1122
20148,0,0,11,0,-11
20149,0,0,19,0,-19
20150,1,1,684,2035,1351
20151,1,1,492,2293,1801
20152,1,1,417,1365,948
20153,1,1,54,2233,2179
20154,1,0,46,0,-46
20155,1,1,861,1424,563
20156,0,0,86,0,-86
20157,0,0,41,0,-41
20158,0,0,69,0,-69
20159,0,0,47,0,-47
20160,1,0,57,0,-57
20161,1,1,71,1566,1495
20162,0,0,25,0,-25
20163,1,0,28,0,-28
20164,1,0,66,0,-66
20165,0,0,62,0,-62
20166,0,0,90,0,-90
20167,1,0,191,0,-191
20168,1,0,39,0,-39
20169,0,0,48,0,-48
20170,0,0,1,0,-1
20171,1,1,240,1296,1056
20172,1,0,6,0,-6
20173,0,0,5,0,-5
20174,0,0,108,0,-108
20175,0,0,12,0,-12
20176,1,0,85,0,-85
20177,1,1,626,1389,763
20178,0,0,150,0,-150
20179,1,1,658,1322,664
20180,1,0,49,0,-49
20181,1,0,49,0,-49
20182,0,0,26,0,-26
20183,0,0,68,0,-68
20184,0,0,107,0,-107
20185,1,1,1410,1290,-120
20186,1,0,154,0,-154
20187,0,0,12,0,-12
20188,1,0,73,0,-73
20189,1,1,218,1316,1098
20190,1,0,36,0,-36
20191,1,0,7,0,-7
20192,1,1,905,1401,496
20193,0,0,8,0,-8
20194,1,0,76,0,-76
20195,0,0,11,0,-11
20196,0,0,46,0,-46
20197,1,1,239,1564,1325
20198,1,0,114,0,-114
20199,1,1,388,1368,980
20200,0,0,17,0,-17
20201,0,0,73,0,-73
20202,1,0,0,0,0
20203,1,1,325,1301,976
20204,0,0,4,0,-4
20205,1,1,305,1285,980
20206,1,0,33,0,-33
20207,0,0,48,0,-48
20208,1,0,62,0,-62
20209,0,0,2,0,-2
20210,1,0,70,0,-70
20211,1,1,175,1253,1078
20212,0,0,41,0,-41
20213,1,1,333,2515,2182
20214,0,0,105,0,-105
20215,1,1,205,1870,1665
20216,0,0,31,0,-31
20217,0,0,43,0,-43
20218,0,0,34,0,-34
20219,0,0,43,0,-43
20220,0,0,176,0,-176
20221,1,0,4,0,-4
20222,1,0,4,0,-4
20223,1,0,22,0,-22
20224,1,1,167,2344,2177
20225,1,1,45,1348,1303
20226,0,0,36,0,-36
20227,0,0,195,0,-195
20228,1,1,723,1424,701
20229,1,1,1102,2628,1526
20230,1,0,34,0,-34
20231,1,0,184,0,-184
20232,0,0,40,0,-40
20233,0,0,33,0,-33
20234,1,1,102,1580,1478
20235,1,1,576,2292,1716
20236,1,1,177,1596,1419
20237,0,0,91,0,-91
20238,0,0,7,0,-7
20239,0,0,0,0,0
20240,1,1,1596,2175,579
20241,0,0,35,0,-35
20242,1,0,11,0,-11
20243,1,1,262,1223,961
20244,1,1,1223,1262,39
20245,1,1,804,1449,645
20246,1,1,372,2021,1649
20247,1,1,52,1327,1275
20248,1,0,7,0,-7
20249,1,1,269,1975,1706
20250,1,0,45,0,-45
20251,1,0,46,0,-46
20252,0,0,55,0,-55
20253,1,0,21,0,-21
20254,0,0,53,0,-53
20255,1,0,54,0,-54
20256,1,1,1758,1749,-9
20257,0,0,49,0,-49
20258,0,0,44,0,-44
20259,1,0,34,0,-34
20260,1,0,57,0,-57
20261,1,0,22,0,-22
20262,0,0,11,0,-11
20263,0,0,129,0,-129
20264,1,0,53,0,-53
20265,1,0,255,0,-255
20266,1,1,613,1572,959
20267,1,1,105,1396,1291
20268,1,0,5,0,-5
20269,0,0,2,0,-2
20270,0,0,5,0,-5
20271,0,0,5,0,-5
20272,1,1,551,1269,718
20273,0,0,93,0,-93
20274,1,1,384,1320,936
20275,1,0,14,0,-14
20276,1,0,6,0,-6
20277,0,0,22,0,-22
20278,0,0,100,0,-100
20279,1,0,32,0,-32
20280,0,0,28,0,-28
20281,1,1,1080,1508,428
20282,1,1,649,2677,2028
20283,0,0,89,0,-89
20284,0,0,59,0,-59
20285,1,0,61,0,-61
20286,1,0,30,0,-30
20287,1,0,127,0,-127
20288,1,0,52,0,-52
20289,1,0,6,0,-6
20290,1,1,374,1560,1186
20291,1,1,607,1279,672
20292,1,1,284,1553,1269
20293,0,0,85,0,-85
20294,1,1,72,2744,2672
20295,1,1,326,1532,1206
20296,1,0,89,0,-89
20297,0,0,97,0,-97
20298,1,0,4,0,-4
20299,0,0,2,0,-2
20300,1,0,28,0,-28
20301,1,0,80,0,-80
20302,0,0,84,0,-84
20303,1,1,565,1781,1216
20304,0,0,68,0,-68
20305,1,0,263,0,-263
20306,1,0,47,0,-47
20307,0,0,64,0,-64
20308,1,0,33,0,-33
20309,0,0,7,0,-7
20310,1,1,602,1486,884
20311,1,1,102,1261,1159
20312,1,0,99,0,-99
20313,1,0,9,0,-9
20314,0,0,59,0,-59
20315,1,1,404,1240,836
20316,1,0,11,0,-11
20317,0,0,58,0,-58
20318,1,0,82,0,-82
20319,1,0,115,0,-115
20320,1,1,42,1241,1199
20321,1,1,264,1591,1327
20322,0,0,14,0,-14
20323,1,1,1084,1210,126
20324,0,0,20,0,-20
20325,1,0,27,0,-27
20326,0,0,31,0,-31
20327,1,0,21,0,-21
20328,1,0,72,0,-72
20329,1,0,29,0,-29
20330,1,1,225,1219,994
20331,1,1,726,1459,733
20332,0,0,7,0,-7
20333,1,1,776,1859,1083
20334,0,0,68,0,-68
20335,1,0,3,0,-3
20336,1,1,397,1401,1004
20337,1,1,427,1589,1162
20338,1,1,179,2445,2266
20339,0,0,99,0,-99
20340,0,0,1,0,-1
20341,1,1,927,1877,950
20342,1,1,330,1273,943
20343,0,0,4,0,-4
20344,1,1,256,1558,1302
20345,0,0,11,0,-11
20346,0,0,14,0,-14
20347,1,1,149,1923,1774
20348,1,1,189,1541,1352
20349,0,0,98,0,-98
20350,0,0,121,0,-121
20351,1,1,320,1430,1110
20352,1,1,57,1660,1603
20353,1,0,10,0,-10
20354,0,0,35,0,-35
20355,0,0,3,0,-3
20356,0,0,61,0,-61
20357,0,0,21,0,-21
20358,1,1,358,1332,974
20359,1,1,174,3119,2945
20360,1,1,535,1343,808
20361,0,0,67,0,-67
20362,1,0,111,0,-111
20363,1,0,83,0,-83
20364,0,0,178,0,-178
20365,1,0,39,0,-39
20366,0,0,65,0,-65
20367,1,0,146,0,-146
20368,1,1,962,1422,460
20369,1,1,535,1387,852
20370,1,1,1245,4910,3665
20371,1,0,54,0,-54
20372,0,0,1,0,-1
20373,1,1,639,1925,1286
20374,0,0,27,0,-27
20375,0,0,24,0,-24
20376,1,1,269,1240,971
20377,0,0,240,0,-240
20378,1,0,8,0,-8
20379,1,1,97,1359,1262
20380,1,0,0,0,0
20381,0,0,14,0,-14
20382,1,1,510,1616,1106
20383,1,0,5,0,-5
20384,0,0,125,0,-125
20385,1,0,11,0,-11
20386,1,1,847,1351,504
20387,0,0,66,0,-66
20388,0,0,0,0,0
20389,0,0,28,0,-28
20390,1,0,99,0,-99
20391,1,1,195,1217,1022
20392,1,1,322,2086,1764
20393,1,0,3,0,-3
20394,0,0,23,0,-23
20395,1,1,267,1404,1137
20396,0,0,21,0,-21
20397,1,0,136,0,-136
20398,0,0,39,0,-39
20399,1,1,1056,1437,381
20400,1,1,337,1300,963
20401,1,0,11,0,-11
20402,1,0,333,0,-333
20403,1,0,55,0,-55
20404,0,0,101,0,-101
20405,1,1,221,2127,1906
20406,1,0,0,0,0
20407,1,1,2013,2081,68
20408,0,0,38,0,-38
20409,0,0,255,0,-255
20410,0,0,82,0,-82
20411,0,0,8,0,-8
20412,0,0,6,0,-6
20413,0,0,27,0,-27
20414,0,0,32,0,-32
20415,0,0,8,0,-8
20416,1,1,138,1251,1113
20417,0,0,30,0,-30
20418,1,0,32,0,-32
20419,0,0,39,0,-39
20420,1,0,36,0,-36
20421,1,1,133,1250,1117
20422,1,1,30,1216,1186
20423,1,0,34,0,-34
20424,1,1,91,2276,2185
20425,1,1,432,1204,772
20426,1,0,188,0,-188
20427,0,0,63,0,-63
20428,1,1,311,1956,1645
20429,0,0,39,0,-39
20430,1,1,320,1536,1216
20431,1,1,350,1212,862
20432,0,0,97,0,-97
20433,1,1,486,1284,798
20434,0,0,1,0,-1
20435,1,1,67,1413,1346
20436,1,0,39,0,-39
20437,1,0,49,0,-49
20438,1,0,22,0,-22
20439,0,0,140,0,-140
20440,1,1,915,1429,514
20441,0,0,17,0,-17
20442,1,1,63,1447,1384
20443,1,1,27,2072,2045
20444,1,1,744,1398,654
20445,0,0,43,0,-43
20446,0,0,35,0,-35
20447,1,1,373,1363,990
20448,1,0,76,0,-76
20449,1,0,34,0,-34
20450,1,0,51,0,-51
20451,1,0,26,0,-26
20452,1,1,54,1600,1546
20453,0,0,262,0,-262
20454,0,0,35,0,-35
20455,0,0,45,0,-45
20456,0,0,105,0,-105
20457,0,0,48,0,-48
20458,1,0,52,0,-52
20459,1,1,451,1386,935
20460,0,0,89,0,-89
20461,0,0,115,0,-115
20462,1,0,115,0,-115
20463,1,0,53,0,-53
20464,0,0,5,0,-5
20465,1,0,140,0,-140
20466,1,0,25,0,-25
20467,0,0,30,0,-30
20468,0,0,5,0,-5
20469,0,0,2,0,-2
20470,0,0,0,0,0
20471,1,1,406,1613,1207
20472,1,1,255,1389,1134
20473,0,0,38,0,-38
20474,1,1,277,1603,1326
20475,1,1,317,2225,1908
20476,0,0,56,0,-56
20477,0,0,45,0,-45
20478,1,1,712,1335,623
20479,1,0,83,0,-83
20480,1,0,28,0,-28
20481,1,0,69,0,-69
20482,0,0,7,0,-7
20483,1,1,565,3015,2450
20484,0,0,128,0,-128
20485,1,0,188,0,-188
20486,1,0,48,0,-48
20487,1,1,508,1231,723
20488,1,1,240,1200,960
20489,1,0,71,0,-71
20490,1,0,1,0,-1
20491,0,0,108,0,-108
20492,1,1,1299,2102,803
20493,1,0,41,0,-41
20494,1,1,624,1386,762
20495,1,1,528,1641,1113
20496,1,1,167,1577,1410
20497,1,1,346,2015,1669
20498,0,0,58,0,-58
20499,1,1,101,2125,2024
20500,1,1,476,1255,779
20501,1,0,7,0,-7
20502,0,0,108,0,-108
20503,0,0,21,0,-21
20504,0,0,46,0,-46
20505,0,0,5,0,-5
20506,1,0,60,0,-60
20507,1,0,17,0,-17
20508,1,0,13,0,-13
20509,1,1,395,1661,1266
20510,0,0,117,0,-117
20511,1,0,84,0,-84
20512,1,0,73,0,-73
20513,0,0,2,0,-2
20514,0,0,13,0,-13
20515,0,0,42,0,-42
20516,1,0,9,0,-9
20517,1,1,1568,2490,922
20518,0,0,45,0,-45
20519,1,1,528,1345,817
20520,1,0,24,0,-24
20521,0,0,28,0,-28
20522,0,0,158,0,-158
20523,0,0,20,0,-20
20524,0,0,35,0,-35
20525,1,1,671,1410,739
20526,1,1,1027,1653,626
20527,0,0,61,0,-61
20528,1,0,37,0,-37
20529,0,0,32,0,-32
20530,0,0,68,0,-68
20531,1,0,58,0,-58
20532,1,1,408,1445,1037
20533,1,1,301,1212,911
20534,0,0,0,0,0
20535,0,0,7,0,-7
20536,1,0,182,0,-182
20537,1,1,633,1240,607
20538,1,1,322,1233,911
20539,0,0,192,0,-192
20540,0,0,31,0,-31
20541,0,0,61,0,-61
20542,1,0,47,0,-47
20543,1,1,56,1401,1345
20544,0,0,34,0,-34
20545,1,0,0,0,0
20546,0,0,24,0,-24
20547,1,1,74,1793,1719
20548,0,0,161,0,-161
20549,0,0,10,0,-10
20550,1,0,64,0,-64
20551,0,0,42,0,-42
20552,0,0,14,0,-14
20553,1,1,794,1516,722
20554,1,1,129,1227,1098
20555,0,0,82,0,-82
20556,1,1,199,1215,1016
20557,0,0,5,0,-5
20558,1,0,11,0,-11
20559,1,1,1061,1936,875
20560,1,1,239,1362,1123
20561,1,1,1194,1296,102
20562,1,1,339,1800,1461
20563,1,0,65,0,-65
20564,1,0,0,0,0
20565,0,0,37,0,-37
20566,1,0,21,0,-21
20567,0,0,4,0,-4
20568,1,0,27,0,-27
20569,1,1,187,1281,1094
20570,1,0,12,0,-12
20571,0,0,70,0,-70
20572,1,1,518,1231,713
20573,1,0,92,0,-92
20574,1,0,15,0,-15
20575,1,0,100,0,-100
20576,1,0,42,0,-42
20577,1,0,29,0,-29
20578,0,0,1,0,-1
20579,1,1,452,1343,891
20580,0,0,2,0,-2
20581,1,1,736,1272,536
20582,0,0,77,0,-77
20583,1,0,8,0,-8
20584,1,0,95,0,-95
20585,1,0,15,0,-15
20586,1,1,2321,1235,-1086
20587,1,0,46,0,-46
20588,1,0,27,0,-27
20589,1,1,156,1708,1552
20590,1,1,721,1238,517
20591,1,0,29,0,-29
20592,0,0,54,0,-54
20593,1,0,9,0,-9
20594,1,0,50,0,-50
20595,0,0,27,0,-27
20596,1,0,61,0,-61
20597,1,1,1217,1289,72
20598,1,1,404,2442,2038
20599,1,1,1309,1339,30
20600,0,0,19,0,-19
20601,1,0,24,0,-24
20602,1,1,908,1296,388
20603,0,0,2,0,-2
20604,0,0,50,0,-50
20605,1,0,87,0,-87
20606,1,1,371,1784,1413
20607,1,1,2836,1352,-1484
20608,1,1,96,1381,1285
20609,0,0,56,0,-56
20610,0,0,28,0,-28
20611,0,0,4,0,-4
20612,1,1,707,1446,739
20613,0,0,49,0,-49
20614,1,1,541,2042,1501
20615,0,0,172,0,-172
20616,0,0,8,0,-8
20617,0,0,56,0,-56
20618,1,0,110,0,-110
20619,0,0,15,0,-15
20620,1,1,525,1260,735
20621,1,0,39,0,-39
20622,0,0,67,0,-67
20623,1,1,423,1567,1144
20624,1,0,27,0,-27
20625,0,0,10,0,-10
20626,0,0,16,0,-16
20627,0,0,14,0,-14
20628,1,0,14,0,-14
20629,1,0,153,0,-153
20630,1,0,29,0,-29
20631,1,1,1519,3814,2295
20632,0,0,31,0,-31
20633,0,0,69,0,-69
20634,1,1,559,1222,663
20635,1,0,50,0,-50
20636,1,1,832,1224,392
20637,1,1,1036,1261,225
20638,0,0,8,0,-8
20639,0,0,226,0,-226
20640,1,0,33,0,-33
20641,0,0,35,0,-35
20642,0,0,80,0,-80
20643,1,0,26,0,-26
20644,1,1,440,1892,1452
20645,0,0,75,0,-75
20646,1,1,840,1344,504
20647,1,0,223,0,-223
20648,0,0,112,0,-112
20649,1,0,40,0,-40
20650,1,0,53,0,-53
20651,1,0,76,0,-76
20652,1,0,139,0,-139
20653,0,0,38,0,-38
20654,0,0,102,0,-102
20655,0,0,20,0,-20
20656,0,0,116,0,-116
20657,0,0,1,0,-1
20658,1,0,170,0,-170
20659,0,0,20,0,-20
20660,1,0,29,0,-29
20661,1,0,92,0,-92
20662,0,0,60,0,-60
20663,1,1,179,1253,1074
20664,1,0,71,0,-71
20665,0,0,41,0,-41
20666,0,0,40,0,-40
20667,1,0,17,0,-17
20668,0,0,120,0,-120
20669,0,0,47,0,-47
20670,1,0,13,0,-13
20671,0,0,17,0,-17
20672,1,0,13,0,-13
20673,1,0,46,0,-46
20674,1,0,53,0,-53
20675,1,1,497,1302,805
20676,1,0,18,0,-18
20677,1,0,161,0,-161
20678,1,1,1463,2060,597
20679,1,0,19,0,-19
20680,1,0,32,0,-32
20681,0,0,58,0,-58
20682,1,1,208,1307,1099
20683,1,1,146,1342,1196
20684,1,1,545,2083,1538
20685,1,0,1,0,-1
20686,0,0,45,0,-45
20687,1,1,79,1499,1420
20688,1,1,510,1663,1153
20689,1,1,276,1202,926
20690,1,0,52,0,-52
20691,0,0,2,0,-2
20692,1,1,336,1392,1056
20693,0,0,21,0,-21
20694,0,0,185,0,-185
20695,1,1,678,1632,954
20696,0,0,3,0,-3
20697,1,0,21,0,-21
20698,0,0,80,0,-80
20699,0,0,18,0,-18
20700,1,0,38,0,-38
20701,1,1,204,1699,1495
20702,1,0,14,0,-14
20703,0,0,10,0,-10
20704,0,0,10,0,-10
20705,0,0,13,0,-13
20706,0,0,10,0,-10
20707,1,0,33,0,-33
20708,1,1,860,2184,1324
20709,1,0,39,0,-39
20710,1,1,277,1641,1364
20711,1,0,156,0,-156
20712,0,0,41,0,-41
20713,1,1,450,1598,1148
20714,0,0,54,0,-54
20715,0,0,55,0,-55
20716,0,0,47,0,-47
20717,0,0,29,0,-29
20718,0,0,38,0,-38
20719,0,0,171,0,-171
20720,0,0,8,0,-8
20721,1,0,169,0,-169
20722,1,0,55,0,-55
20723,1,0,25,0,-25
20724,1,1,38,1920,1882
20725,1,0,17,0,-17
20726,1,1,83,1280,1197
20727,1,1,522,1737,1215
20728,1,1,87,1324,1237
20729,1,1,330,1306,976
20730,1,1,283,1670,1387
20731,1,0,5,0,-5
20732,1,0,44,0,-44
20733,0,0,9,0,-9
20734,0,0,3,0,-3
20735,1,1,332,1585,1253
20736,1,0,3,0,-3
20737,0,0,18,0,-18
20738,0,0,8,0,-8
20739,1,1,529,1734,1205
20740,1,0,23,0,-23
20741,0,0,9,0,-9
20742,0,0,5,0,-5
20743,0,0,85,0,-85
20744,1,0,84,0,-84
20745,0,0,23,0,-23
20746,1,0,94,0,-94
20747,1,1,364,1232,868
20748,1,1,116,4584,4468
20749,1,0,35,0,-35
20750,0,0,119,0,-119
20751,0,0,35,0,-35
20752,0,0,116,0,-116
20753,1,1,417,1282,865
20754,0,0,26,0,-26
20755,1,1,115,1759,1644
20756,1,0,20,0,-20
20757,1,1,1051,2877,1826
20758,0,0,6,0,-6
20759,1,1,418,1282,864
20760,1,0,90,0,-90
20761,1,1,1023,1399,376
20762,1,1,650,1346,696
20763,1,1,320,2229,1909
20764,1,0,27,0,-27
20765,0,0,0,0,0
20766,1,1,291,1240,949
20767,1,0,17,0,-17
20768,1,1,642,1248,606
20769,0,0,45,0,-45
20770,0,0,46,0,-46
20771,1,0,113,0,-113
20772,1,0,71,0,-71
20773,0,0,126,0,-126
20774,0,0,10,0,-10
20775,1,1,117,1361,1244
20776,1,0,3,0,-3
20777,1,0,6,0,-6
20778,1,0,3,0,-3
20779,0,0,79,0,-79
20780,1,0,1,0,-1
20781,0,0,35,0,-35
20782,0,0,102,0,-102
20783,1,1,1740,1990,250
20784,1,1,1010,2589,1579
20785,0,0,35,0,-35
20786,1,1,118,1429,1311
20787,0,0,17,0,-17
20788,1,1,1001,1292,291
20789,0,0,38,0,-38
20790,0,0,3,0,-3
20791,0,0,94,0,-94
20792,1,0,33,0,-33
20793,1,1,715,1217,502
20794,1,0,62,0,-62
20795,0,0,32,0,-32
20796,0,0,7,0,-7
20797,0,0,220,0,-220
20798,1,1,1081,1560,479
20799,0,0,2,0,-2
20800,0,0,45,0,-45
20801,0,0,68,0,-68
20802,0,0,50,0,-50
20803,1,0,165,0,-165
20804,1,1,724,2103,1379
20805,0,0,0,0,0
20806,1,1,255,1365,1110
20807,0,0,36,0,-36
20808,0,0,56,0,-56
20809,1,1,60,1344,1284
20810,1,1,358,1378,1020
20811,1,0,9,0,-9
20812,1,1,442,1321,879
20813,1,0,169,0,-169
20814,0,0,49,0,-49
20815,0,0,1,0,-1
20816,1,0,7,0,-7
20817,1,1,469,1335,866
20818,1,1,704,1921,1217
20819,1,0,248,0,-248
20820,1,1,63,1231,1168
20821,0,0,28,0,-28
20822,0,0,21,0,-21
20823,1,0,89,0,-89
20824,0,0,39,0,-39
20825,1,0,35,0,-35
20826,1,0,288,0,-288
20827,0,0,52,0,-52
20828,0,0,36,0,-36
20829,0,0,140,0,-140
20830,1,0,9,0,-9
20831,0,0,83,0,-83
20832,1,0,5,0,-5
20833,1,1,367,1451,1084
20834,1,1,763,1525,762
20835,0,0,92,0,-92
20836,0,0,70,0,-70
20837,1,0,34,0,-34
20838,1,0,29,0,-29
20839,1,0,22,0,-22
20840,1,0,109,0,-109
20841,1,0,42,0,-42
20842,1,1,167,1961,1794
20843,1,0,80,0,-80
20844,0,0,5,0,-5
20845,1,0,64,0,-64
20846,0,0,89,0,-89
20847,1,0,57,0,-57
20848,1,0,85,0,-85
20849,0,0,13,0,-13
20850,0,0,1,0,-1
20851,1,1,470,1524,1054
20852,1,0,22,0,-22
20853,1,1,291,1336,1045
20854,1,0,54,0,-54
20855,1,1,586,1809,1223
20856,0,0,1,0,-1
20857,1,0,129,0,-129
20858,1,1,121,1218,1097
20859,1,1,865,1365,500
20860,1,0,17,0,-17
20861,1,1,1777,2082,305
20862,0,0,113,0,-113
20863,0,0,22,0,-22
20864,1,0,48,0,-48
20865,0,0,25,0,-25
20866,1,0,15,0,-15
20867,1,1,483,1326,843
20868,0,0,10,0,-10
20869,1,1,260,1200,940
20870,0,0,1,0,-1
20871,0,0,6,0,-6
20872,1,0,9,0,-9
20873,1,1,491,2135,1644
20874,0,0,39,0,-39
20875,0,0,83,0,-83
20876,1,0,33,0,-33
20877,0,0,74,0,-74
20878,1,1,487,1826,1339
20879,1,0,82,0,-82
20880,0,0,141,0,-141
20881,0,0,65,0,-65
20882,1,0,134,0,-134
20883,0,0,41,0,-41
20884,1,0,75,0,-75
20885,0,0,91,0,-91
20886,1,0,28,0,-28
20887,0,0,53,0,-53
20888,1,0,122,0,-122
20889,0,0,69,0,-69
20890,1,0,53,0,-53
20891,1,0,28,0,-28
20892,0,0,10,0,-10
20893,1,1,406,1313,907
20894,0,0,11,0,-11
20895,1,0,4,0,-4
20896,1,1,735,2085,1350
20897,0,0,77,0,-77
20898,0,0,25,0,-25
20899,0,0,32,0,-32
20900,1,1,573,1261,688
20901,0,0,108,0,-108
20902,1,1,505,1536,1031
20903,1,0,20,0,-20
20904,0,0,27,0,-27
20905,0,0,5,0,-5
20906,1,0,119,0,-119
20907,1,0,16,0,-16
20908,1,1,426,1323,897
20909,1,1,628,1498,870
20910,1,1,774,1404,630
20911,1,0,87,0,-87
20912,0,0,1,0,-1
20913,1,1,460,1426,966
20914,1,0,37,0,-37
20915,1,0,133,0,-133
20916,1,0,62,0,-62
20917,0,0,0,0,0
20918,1,0,29,0,-29
20919,1,1,761,1443,682
20920,1,0,58,0,-58
20921,0,0,6,0,-6
20922,1,0,26,0,-26
20923,1,1,194,1463,1269
20924,0,0,9,0,-9
20925,0,0,8,0,-8
20926,1,0,20,0,-20
20927,1,0,9,0,-9
20928,0,0,72,0,-72
20929,1,1,984,1355,371
20930,0,0,16,0,-16
20931,1,0,84,0,-84
20932,0,0,10,0,-10
20933,0,0,5,0,-5
20934,1,0,59,0,-59
20935,1,1,154,1392,1238
20936,0,0,66,0,-66
20937,1,1,1111,1664,553
20938,0,0,18,0,-18
20939,1,1,370,3468,3098
20940,1,1,607,1541,934
20941,1,0,24,0,-24
20942,0,0,17,0,-17
20943,0,0,22,0,-22
20944,1,1,73,1257,1184
20945,1,0,127,0,-127
20946,1,0,16,0,-16
20947,1,1,893,1687,794
20948,1,1,1763,1399,-364
20949,1,1,742,1938,1196
20950,0,0,57,0,-57
20951,1,1,1732,1483,-249
20952,1,1,557,1301,744
20953,1,0,74,0,-74
20954,0,0,36,0,-36
20955,0,0,71,0,-71
20956,1,1,744,1439,695
20957,0,0,0,0,0
20958,0,0,79,0,-79
20959,1,0,36,0,-36
20960,1,1,257,1374,1117
20961,1,0,14,0,-14
20962,1,0,97,0,-97
20963,0,0,95,0,-95
20964,1,0,8,0,-8
20965,1,1,175,1374,1199
20966,0,0,27,0,-27
20967,1,1,3072,1431,-1641
20968,1,1,244,1757,1513
20969,0,0,46,0,-46
20970,0,0,44,0,-44
20971,0,0,19,0,-19
20972,1,1,647,1829,1182
20973,0,0,45,0,-45
20974,0,0,50,0,-50
20975,1,0,74,0,-74
20976,1,1,291,1478,1187
20977,0,0,139,0,-139
20978,1,0,125,0,-125
20979,1,1,743,1393,650
20980,1,0,0,0,0
20981,1,1,1158,1210,52
20982,1,0,79,0,-79
20983,0,0,8,0,-8
20984,0,0,67,0,-67
20985,1,0,21,0,-21
20986,1,0,1,0,-1
20987,1,0,3,0,-3
20988,1,1,261,1314,1053
20989,1,0,107,0,-107
20990,0,0,75,0,-75
20991,1,0,69,0,-69
20992,0,0,5,0,-5
20993,1,0,25,0,-25
20994,1,1,363,1278,915
20995,0,0,22,0,-22
20996,0,0,78,0,-78
20997,0,0,82,0,-82
20998,0,0,95,0,-95
20999,0,0,68,0,-68
21000,1,0,5,0,-5
21001,0,0,50,0,-50
21002,1,1,178,1905,1727
21003,1,0,12,0,-12
21004,0,0,44,0,-44
21005,1,1,117,1700,1583
21006,1,1,1858,1528,-330
21007,1,0,124,0,-124
21008,0,0,13,0,-13
21009,1,0,47,0,-47
21010,0,0,161,0,-161
21011,0,0,6,0,-6
21012,1,1,630,2127,1497
21013,1,1,229,4146,3917
21014,0,0,32,0,-32
21015,1,0,27,0,-27
21016,1,1,887,1448,561
21017,1,1,141,1726,1585
21018,1,0,14,0,-14
21019,1,0,83,0,-83
21020,1,1,382,1354,972
21021,1,0,85,0,-85
21022,1,0,84,0,-84
21023,1,1,384,1344,960
21024,1,0,36,0,-36
21025,1,1,1874,1657,-217
21026,0,0,45,0,-45
21027,1,1,191,1508,1317
21028,1,0,253,0,-253
21029,1,1,299,1319,1020
21030,0,0,120,0,-120
21031,1,1,179,1337,1158
21032,0,0,17,0,-17
21033,1,0,9,0,-9
21034,1,1,168,1398,1230
21035,0,0,10,0,-10
21036,1,0,127,0,-127
21037,1,1,231,1615,1384
21038,1,0,39,0,-39
21039,0,0,80,0,-80
21040,1,1,837,1421,584
21041,0,0,4,0,-4
21042,1,1,520,1201,681
21043,0,0,65,0,-65
21044,1,1,1695,1583,-112
21045,1,0,12,0,-12
21046,0,0,8,0,-8
21047,0,0,10,0,-10
21048,0,0,24,0,-24
21049,0,0,28,0,-28
21050,1,1,974,1393,419
21051,1,0,96,0,-96
21052,0,0,37,0,-37
21053,0,0,98,0,-98
21054,1,0,34,0,-34
21055,0,0,94,0,-94
21056,1,1,71,1960,1889
21057,1,0,23,0,-23
21058,0,0,13,0,-13
21059,1,1,839,1893,1054
21060,1,1,228,1506,1278
21061,0,0,92,0,-92
21062,0,0,24,0,-24
21063,0,0,120,0,-120
21064,0,0,99,0,-99
21065,1,0,127,0,-127
21066,0,0,95,0,-95
21067,1,1,2150,1285,-865
21068,0,0,43,0,-43
21069,1,1,725,1287,562
21070,1,0,28,0,-28
21071,1,1,287,1498,1211
21072,0,0,5,0,-5
21073,0,0,22,0,-22
21074,1,0,25,0,-25
21075,1,1,734,1630,896
21076,0,0,6,0,-6
21077,0,0,236,0,-236
21078,1,1,562,1691,1129
21079,1,0,151,0,-151
21080,1,1,70,1428,1358
21081,0,0,8,0,-8
21082,1,1,1192,1284,92
21083,1,0,108,0,-108
21084,1,1,226,1719,1493
21085,1,1,52,1262,1210
21086,1,1,291,1337,1046
21087,1,1,1067,1940,873
21088,1,0,29,0,-29
21089,1,0,33,0,-33
21090,1,1,129,1792,1663
21091,1,0,59,0,-59
21092,1,0,46,0,-46
21093,1,0,66,0,-66
21094,0,0,59,0,-59
21095,1,1,2691,1795,-896
21096,1,1,330,1316,986
21097,1,0,33,0,-33
21098,0,0,8,0,-8
21099,1,0,0,0,0
21100,1,0,28,0,-28
21101,0,0,15,0,-15
21102,1,0,26,0,-26
21103,1,1,732,1579,847
21104,0,0,18,0,-18
21105,0,0,50,0,-50
21106,1,1,411,1500,1089
21107,1,0,85,0,-85
21108,1,1,495,1668,1173
21109,1,1,86,1852,1766
21110,0,0,26,0,-26
21111,1,0,14,0,-14
21112,1,0,25,0,-25
21113,1,0,60,0,-60
21114,1,1,259,1603,1344
21115,1,1,253,3046,2793
21116,1,1,275,2800,2525
21117,1,1,648,1211,563
21118,0,0,28,0,-28
21119,1,1,802,1312,510
21120,1,0,25,0,-25
21121,1,1,861,2026,1165
21122,0,0,97,0,-97
21123,1,0,5,0,-5
21124,0,0,80,0,-80
21125,1,1,518,1224,706
21126,1,0,20,0,-20
21127,0,0,77,0,-77
21128,1,0,37,0,-37
21129,0,0,5,0,-5
21130,1,0,31,0,-31
21131,1,1,1254,1290,36
21132,1,0,22,0,-22
21133,0,0,3,0,-3
21134,0,0,110,0,-110
21135,1,1,891,1360,469
21136,0,0,4,0,-4
21137,0,0,330,0,-330
21138,1,1,473,1279,806
21139,0,0,228,0,-228
21140,1,0,177,0,-177
21141,1,0,12,0,-12
21142,1,0,9,0,-9
21143,0,0,1,0,-1
21144,0,0,15,0,-15
21145,0,0,14,0,-14
21146,0,0,40,0,-40
21147,0,0,76,0,-76
21148,0,0,13,0,-13
21149,0,0,7,0,-7
21150,0,0,24,0,-24
21151,1,1,182,1413,1231
21152,1,1,1024,1728,704
21153,0,0,69,0,-69
21154,1,0,7,0,-7
21155,0,0,80,0,-80
21156,1,1,213,1932,1719
21157,1,1,75,1300,1225
21158,0,0,44,0,-44
21159,1,0,74,0,-74
21160,1,0,49,0,-49
21161,1,0,5,0,-5
21162,1,1,800,1219,419
21163,0,0,71,0,-71
21164,1,0,6,0,-6
21165,1,0,5,0,-5
21166,0,0,114,0,-114
21167,0,0,70,0,-70
21168,0,0,47,0,-47
21169,0,0,76,0,-76
21170,0,0,42,0,-42
21171,0,0,42,0,-42
21172,1,0,57,0,-57
21173,1,0,2,0,-2
21174,0,0,50,0,-50
21175,1,1,475,1321,846
21176,1,0,35,0,-35
21177,1,0,40,0,-40
21178,0,0,5,0,-5
21179,0,0,21,0,-21
21180,1,0,22,0,-22
21181,1,0,28,0,-28
21182,1,1,1819,1948,129
21183,1,1,171,1836,1665
21184,1,1,285,1215,930
21185,1,0,38,0,-38
21186,0,0,44,0,-44
21187,0,0,8,0,-8
21188,0,0,9,0,-9
21189,1,1,551,1620,1069
21190,0,0,66,0,-66
21191,1,1,113,2147,2034
21192,1,1,353,1221,868
21193,1,0,86,0,-86
21194,0,0,2,0,-2
21195,1,1,220,1823,1603
21196,1,0,54,0,-54
21197,1,1,578,3214,2636
21198,0,0,89,0,-89
21199,0,0,5,0,-5
21200,1,1,502,2110,1608
21201,1,0,2,0,-2
21202,1,1,598,1866,1268
21203,1,0,3,0,-3
21204,1,1,1343,1774,431
21205,1,0,47,0,-47
21206,1,1,1513,1258,-255
21207,1,0,10,0,-10
21208,1,0,45,0,-45
21209,0,0,4,0,-4
21210,0,0,174,0,-174
21211,1,0,21,0,-21
21212,0,0,6,0,-6
21213,0,0,8,0,-8
21214,0,0,242,0,-242
21215,1,1,635,1389,754
21216,0,0,35,0,-35
21217,0,0,221,0,-221
21218,1,0,12,0,-12
21219,1,0,104,0,-104
21220,1,1,295,1245,950
21221,1,1,611,1239,628
21222,0,0,13,0,-13
21223,0,0,20,0,-20
21224,1,1,428,1430,1002
21225,0,0,25,0,-25
21226,0,0,17,0,-17
21227,1,0,29,0,-29
21228,0,0,4,0,-4
21229,1,0,8,0,-8
21230,1,0,71,0,-71
21231,0,0,2,0,-2
21232,1,0,68,0,-68
21233,0,0,41,0,-41
21234,1,0,11,0,-11
21235,1,0,21,0,-21
21236,1,1,519,1747,1228
21237,1,1,157,1257,1100
21238,1,1,262,1406,1144
21239,1,1,531,1275,744
21240,1,0,245,0,-245
21241,1,0,5,0,-5
21242,0,0,190,0,-190
21243,0,0,57,0,-57
21244,0,0,57,0,-57
21245,0,0,29,0,-29
21246,0,0,72,0,-72
21247,0,0,17,0,-17
21248,1,1,834,1354,520
21249,1,0,42,0,-42
21250,0,0,185,0,-185
21251,1,1,339,1228,889
21252,1,0,56,0,-56
21253,1,0,99,0,-99
21254,0,0,72,0,-72
21255,1,1,1207,2016,809
21256,0,0,85,0,-85
21257,1,1,205,1350,1145
21258,1,1,232,1290,1058
21259,1,1,468,1595,1127
21260,0,0,3,0,-3
21261,0,0,80,0,-80
21262,1,1,95,4724,4629
21263,1,0,95,0,-95
21264,0,0,2,0,-2
21265,0,0,18,0,-18
21266,1,1,26,2705,2679
21267,1,1,167,1636,1469
21268,0,0,21,0,-21
21269,0,0,23,0,-23
21270,1,1,1086,1940,854
21271,1,0,24,0,-24
21272,0,0,26,0,-26
21273,1,0,11,0,-11
21274,1,1,2573,1616,-957
21275,1,0,15,0,-15
21276,1,1,523,1360,837
21277,1,1,1150,1801,651
21278,1,1,573,1426,853
21279,1,0,29,0,-29
21280,1,0,46,0,-46
21281,1,1,662,2028,1366
21282,0,0,104,0,-104
21283,1,1,373,2241,1868
21284,1,1,817,1361,544
21285,0,0,43,0,-43
21286,0,0,66,0,-66
21287,1,0,7,0,-7
21288,1,0,7,0,-7
21289,0,0,26,0,-26
21290,1,1,616,1602,986
21291,0,0,19,0,-19
21292,1,0,31,0,-31
21293,1,1,56,1238,1182
21294,1,0,35,0,-35
21295,1,0,29,0,-29
21296,1,0,27,0,-27
21297,1,1,100,1483,1383
21298,0,0,58,0,-58
21299,0,0,11,0,-11
21300,1,0,106,0,-106
21301,0,0,59,0,-59
21302,0,0,148,0,-148
21303,0,0,44,0,-44
21304,1,1,1517,1317,-200
21305,1,0,65,0,-65
21306,1,0,127,0,-127
21307,0,0,16,0,-16
21308,1,1,464,1365,901
21309,1,1,149,1248,1099
21310,1,1,235,1397,1162
21311,0,0,8,0,-8
21312,1,1,436,1655,1219
21313,1,0,95,0,-95
21314,0,0,21,0,-21
21315,1,1,94,3129,3035
21316,0,0,78,0,-78
21317,0,0,192,0,-192
21318,1,0,31,0,-31
21319,1,0,29,0,-29
21320,1,1,12,1835,1823
21321,1,1,71,1222,1151
21322,0,0,89,0,-89
21323,0,0,51,0,-51
21324,0,0,110,0,-110
21325,1,0,142,0,-142
21326,0,0,56,0,-56
21327,0,0,46,0,-46
21328,1,0,207,0,-207
21329,1,1,256,1469,1213
21330,0,0,169,0,-169
21331,0,0,168,0,-168
21332,0,0,76,0,-76
21333,1,0,26,0,-26
21334,1,1,29,2504,2475
21335,1,1,151,1895,1744
21336,1,1,384,1917,1533
21337,1,0,17,0,-17
21338,1,0,16,0,-16
21339,0,0,14,0,-14
21340,0,0,1,0,-1
21341,1,0,24,0,-24
21342,0,0,84,0,-84
21343,0,0,8,0,-8
21344,1,1,219,1287,1068
21345,0,0,0,0,0
21346,1,1,248,1306,1058
21347,1,0,0,0,0
21348,1,1,638,1442,804
21349,0,0,48,0,-48
21350,0,0,74,0,-74
21351,0,0,65,0,-65
21352,1,0,44,0,-44
21353,1,1,812,1663,851
21354,0,0,67,0,-67
21355,0,0,52,0,-52
21356,1,0,131,0,-131
21357,0,0,32,0,-32
21358,0,0,9,0,-9
21359,0,0,22,0,-22
21360,0,0,29,0,-29
21361,1,0,83,0,-83
21362,0,0,58,0,-58
21363,0,0,27,0,-27
21364,0,0,66,0,-66
21365,0,0,71,0,-71
21366,0,0,62,0,-62
21367,1,0,115,0,-115
21368,1,1,382,1571,1189
21369,1,0,78,0,-78
21370,1,1,1083,1468,385
21371,1,1,1672,3690,2018
21372,0,0,15,0,-15
21373,1,0,66,0,-66
21374,1,0,34,0,-34
21375,1,0,112,0,-112
21376,1,1,1165,1243,78
21377,1,1,479,1263,784
21378,1,0,151,0,-151
21379,1,1,1831,1944,113
21380,0,0,147,0,-147
21381,1,1,338,1236,898
21382,1,0,8,0,-8
21383,0,0,75,0,-75
21384,0,0,5,0,-5
21385,0,0,61,0,-61
21386,1,1,169,1334,1165
21387,1,1,188,1364,1176
21388,1,1,483,1597,1114
21389,1,1,12,1247,1235
21390,0,0,23,0,-23
21391,0,0,16,0,-16
21392,0,0,31,0,-31
21393,0,0,48,0,-48
21394,0,0,91,0,-91
21395,1,0,55,0,-55
21396,1,1,1971,1279,-692
21397,1,1,326,1752,1426
21398,0,0,21,0,-21
21399,1,1,701,1735,1034
21400,1,1,314,1625,1311
21401,1,1,491,1409,918
21402,1,0,93,0,-93
21403,1,1,456,3033,2577
21404,1,1,858,1239,381
21405,1,1,544,1632,1088
21406,1,1,907,1274,367
21407,1,1,921,1246,325
21408,1,1,128,1765,1637
21409,0,0,62,0,-62
21410,1,1,919,1567,648
21411,1,0,3,0,-3
21412,0,0,33,0,-33
21413,0,0,60,0,-60
21414,1,0,182,0,-182
21415,1,0,35,0,-35
21416,1,1,953,1242,289
21417,1,1,326,1860,1534
21418,0,0,14,0,-14
21419,0,0,9,0,-9
21420,1,0,36,0,-36
21421,1,1,163,1404,1241
21422,0,0,10,0,-10
21423,1,1,812,1310,498
21424,1,0,5,0,-5
21425,1,1,466,1420,954
21426,1,0,37,0,-37
21427,1,1,277,1354,1077
21428,0,0,19,0,-19
21429,0,0,2,0,-2
21430,0,0,70,0,-70
21431,0,0,31,0,-31
21432,0,0,1,0,-1
21433,1,1,102,1224,1122
21434,0,0,35,0,-35
21435,1,1,1042,1281,239
21436,1,0,43,0,-43
21437,0,0,191,0,-191
21438,1,0,63,0,-63
21439,1,0,12,0,-12
21440,0,0,11,0,-11
21441,1,0,160,0,-160
21442,0,0,1,0,-1
21443,1,0,57,0,-57
21444,1,1,118,1720,1602
21445,0,0,7,0,-7
21446,0,0,58,0,-58
21447,1,1,1025,1351,326
21448,1,1,419,2235,1816
21449,1,1,523,2158,1635
21450,0,0,5,0,-5
21451,0,0,8,0,-8
21452,0,0,23,0,-23
21453,0,0,17,0,-17
21454,0,0,67,0,-67
21455,0,0,27,0,-27
21456,1,0,27,0,-27
21457,1,0,6,0,-6
21458,0,0,132,0,-132
21459,1,1,217,1596,1379
21460,0,0,4,0,-4
21461,1,0,95,0,-95
21462,1,1,128,1403,1275
21463,0,0,343,0,-343
21464,0,0,69,0,-69
21465,0,0,341,0,-341
21466,1,0,106,0,-106
21467,1,0,9,0,-9
21468,1,1,1074,1833,759
21469,0,0,7,0,-7
21470,0,0,31,0,-31
21471,0,0,94,0,-94
21472,1,0,96,0,-96
21473,1,1,435,2018,1583
21474,1,1,289,1286,997
21475,1,0,1,0,-1
21476,1,1,284,1529,1245
21477,1,1,227,2119,1892
21478,1,1,420,1451,1031
21479,0,0,5,0,-5
21480,1,1,62,1746,1684
21481,1,0,0,0,0
21482,1,1,498,1721,1223
21483,1,1,1166,2660,1494
21484,0,0,146,0,-146
21485,0,0,332,0,-332
21486,1,1,204,1742,1538
21487,1,0,12,0,-12
21488,0,0,19,0,-19
21489,1,1,176,1940,1764
21490,1,1,206,2724,2518
21491,0,0,19,0,-19
21492,0,0,24,0,-24
21493,1,1,76,1893,1817
21494,0,0,68,0,-68
21495,1,0,3,0,-3
21496,1,0,36,0,-36
21497,0,0,29,0,-29
21498,0,0,42,0,-42
21499,0,0,48,0,-48
21500,0,0,155,0,-155
21501,0,0,19,0,-19
21502,0,0,138,0,-138
21503,0,0,49,0,-49
21504,1,1,229,1395,1166
21505,0,0,177,0,-177
21506,0,0,18,0,-18
21507,0,0,56,0,-56
21508,0,0,207,0,-207
21509,0,0,123,0,-123
21510,0,0,18,0,-18
21511,0,0,1,0,-1
21512,0,0,41,0,-41
21513,0,0,69,0,-69
21514,0,0,21,0,-21
21515,1,0,87,0,-87
21516,1,1,322,1286,964
21517,0,0,39,0,-39
21518,0,0,21,0,-21
21519,1,1,581,1846,1265
21520,0,0,85,0,-85
21521,1,1,777,1378,601
21522,0,0,9,0,-9
21523,0,0,6,0,-6
21524,1,0,16,0,-16
21525,0,0,11,0,-11
21526,1,1,249,1213,964
21527,0,0,5,0,-5
21528,1,0,46,0,-46
21529,0,0,7,0,-7
21530,0,0,55,0,-55
21531,1,0,8,0,-8
21532,0,0,0,0,0
21533,0,0,7,0,-7
21534,1,1,867,1515,648
21535,0,0,57,0,-57
21536,0,0,21,0,-21
21537,1,1,49,1461,1412
21538,1,0,101,0,-101
21539,1,1,1517,1850,333
21540,1,0,0,0,0
21541,0,0,48,0,-48
21542,0,0,89,0,-89
21543,1,0,77,0,-77
21544,1,0,6,0,-6
21545,0,0,51,0,-51
21546,1,0,3,0,-3
21547,0,0,111,0,-111
21548,0,0,114,0,-114
21549,1,0,60,0,-60
21550,0,0,164,0,-164
21551,0,0,96,0,-96
21552,0,0,61,0,-61
21553,1,1,138,1850,1712
21554,1,1,325,1411,1086
21555,0,0,78,0,-78
21556,0,0,30,0,-30
21557,0,0,70,0,-70
21558,0,0,91,0,-91
21559,1,1,700,1292,592
21560,1,0,91,0,-91
21561,0,0,24,0,-24
21562,1,0,28,0,-28
21563,1,0,73,0,-73
21564,1,0,6,0,-6
21565,1,0,67,0,-67
21566,1,1,1017,1280,263
21567,0,0,28,0,-28
21568,1,1,106,1481,1375
21569,1,1,1106,1320,214
21570,0,0,64,0,-64
21571,0,0,21,0,-21
21572,1,0,82,0,-82
21573,1,1,108,1320,1212
21574,0,0,54,0,-54
21575,1,1,183,1247,1064
21576,0,0,54,0,-54
21577,0,0,80,0,-80
21578,1,0,65,0,-65
21579,0,0,17,0,-17
21580,1,1,178,1218,1040
21581,1,0,16,0,-16
21582,1,1,588,1297,709
21583,1,0,45,0,-45
21584,1,1,1582,1869,287
21585,0,0,88,0,-88
21586,0,0,42,0,-42
21587,1,0,47,0,-47
21588,0,0,5,0,-5
21589,1,0,47,0,-47
21590,1,1,233,1321,1088
21591,0,0,21,0,-21
21592,0,0,106,0,-106
21593,1,0,68,0,-68
21594,1,0,126,0,-126
21595,1,0,21,0,-21
21596,1,0,62,0,-62
21597,0,0,2,0,-2
21598,1,0,111,0,-111
21599,1,1,797,2218,1421
21600,1,1,399,1212,813
21601,1,1,260,1319,1059
21602,1,0,55,0,-55
21603,1,0,74,0,-74
21604,0,0,96,0,-96
21605,0,0,43,0,-43
21606,1,0,143,0,-143
21607,1,1,962,1333,371
21608,1,1,71,1826,1755
21609,1,1,482,1343,861
21610,0,0,29,0,-29
21611,0,0,20,0,-20
21612,1,0,32,0,-32
21613,1,1,768,1253,485
21614,0,0,74,0,-74
21615,1,1,185,1808,1623
21616,0,0,60,0,-60
21617,0,0,45,0,-45
21618,1,0,0,0,0
21619,0,0,19,0,-19
21620,1,0,22,0,-22
21621,1,0,40,0,-40
21622,0,0,86,0,-86
21623,1,1,172,1506,1334
21624,1,0,10,0,-10
21625,0,0,94,0,-94
21626,1,1,445,1492,1047
21627,0,0,80,0,-80
21628,0,0,29,0,-29
21629,1,0,228,0,-228
21630,1,0,9,0,-9
21631,1,0,131,0,-131
21632,0,0,64,0,-64
21633,1,1,465,1221,756
21634,0,0,8,0,-8
21635,0,0,30,0,-30
21636,0,0,9,0,-9
21637,1,0,3,0,-3
21638,0,0,31,0,-31
21639,0,0,20,0,-20
21640,0,0,70,0,-70
21641,0,0,65,0,-65
21642,1,1,868,1222,354
21643,0,0,15,0,-15
21644,1,1,229,1347,1118
21645,0,0,34,0,-34
21646,0,0,54,0,-54
21647,1,0,14,0,-14
21648,1,0,4,0,-4
21649,1,0,21,0,-21
21650,1,1,471,1478,1007
21651,1,0,7,0,-7
21652,0,0,34,0,-34
21653,0,0,5,0,-5
21654,1,1,202,1300,1098
21655,1,1,557,2468,1911
21656,1,0,72,0,-72
21657,1,1,349,1269,920
21658,0,0,11,0,-11
21659,1,1,280,1310,1030
21660,1,1,134,1217,1083
21661,0,0,109,0,-109
21662,0,0,8,0,-8
21663,1,1,504,1206,702
21664,1,0,43,0,-43
21665,1,0,175,0,-175
21666,1,0,40,0,-40
21667,1,0,10,0,-10
21668,0,0,22,0,-22
21669,1,0,110,0,-110
21670,1,0,4,0,-4
21671,1,1,157,1281,1124
21672,1,1,381,1294,913
21673,1,1,1139,1341,202
21674,0,0,16,0,-16
21675,0,0,112,0,-112
21676,0,0,7,0,-7
21677,1,0,18,0,-18
21678,1,1,1062,1324,262
21679,1,1,394,3020,2626
21680,1,1,257,1458,1201
21681,1,0,24,0,-24
21682,0,0,3,0,-3
21683,0,0,4,0,-4
21684,0,0,26,0,-26
21685,1,1,85,1213,1128
21686,1,0,44,0,-44
21687,1,1,1195,1288,93
21688,1,1,416,1253,837
21689,1,0,16,0,-16
21690,0,0,41,0,-41
21691,1,1,217,1288,1071
21692,1,1,176,1242,1066
21693,0,0,15,0,-15
21694,1,1,529,1329,800
21695,0,0,18,0,-18
21696,1,1,337,1292,955
21697,0,0,5,0,-5
21698,0,0,2,0,-2
21699,0,0,3,0,-3
21700,1,0,37,0,-37
21701,1,1,248,1315,1067
21702,1,0,115,0,-115
21703,0,0,19,0,-19
21704,1,1,101,1219,1118
21705,1,0,178,0,-178
21706,1,1,624,1747,1123
21707,0,0,14,0,-14
21708,1,1,174,1963,1789
21709,1,0,41,0,-41
21710,0,0,78,0,-78
21711,1,0,7,0,-7
21712,1,0,18,0,-18
21713,1,0,10,0,-10
21714,1,0,38,0,-38
21715,1,0,53,0,-53
21716,1,0,180,0,-180
21717,0,0,101,0,-101
21718,1,0,5,0,-5
21719,1,0,39,0,-39
21720,0,0,51,0,-51
21721,1,0,1,0,-1
21722,1,0,8,0,-8
21723,0,0,205,0,-205
21724,1,1,136,1590,1454
21725,0,0,8,0,-8
21726,0,0,0,0,0
21727,0,0,11,0,-11
21728,0,0,72,0,-72
21729,0,0,19,0,-19
21730,1,1,296,1916,1620
21731,0,0,128,0,-128
21732,0,0,61,0,-61
21733,1,1,405,1310,905
21734,0,0,7,0,-7
21735,1,1,961,1275,314
21736,0,0,9,0,-9
21737,1,1,292,1423,1131
21738,1,1,1000,1512,512
21739,1,1,176,1227,1051
21740,0,0,28,0,-28
21741,1,1,434,2297,1863
21742,1,0,6,0,-6
21743,1,1,82,1530,1448
21744,1,1,245,1420,1175
21745,1,1,84,1277,1193
21746,1,1,172,1488,1316
21747,1,0,1,0,-1
21748,1,0,26,0,-26
21749,1,1,124,1771,1647
21750,1,0,44,0,-44
21751,1,1,899,1464,565
21752,0,0,54,0,-54
21753,0,0,86,0,-86
21754,1,1,490,2062,1572
21755,1,0,36,0,-36
21756,0,0,44,0,-44
21757,1,1,742,1864,1122
21758,0,0,41,0,-41
21759,1,0,40,0,-40
21760,1,1,1048,1769,721
21761,1,1,511,1684,1173
21762,0,0,59,0,-59
21763,1,1,934,1528,594
21764,0,0,108,0,-108
21765,1,1,694,1592,898
21766,1,1,359,2001,1642
21767,0,0,96,0,-96
21768,1,1,596,1407,811
21769,1,1,236,1817,1581
21770,0,0,31,0,-31
21771,0,0,23,0,-23
21772,1,0,47,0,-47
21773,0,0,33,0,-33
21774,0,0,15,0,-15
21775,1,0,248,0,-248
21776,0,0,29,0,-29
21777,0,0,4,0,-4
21778,0,0,105,0,-105
21779,1,1,301,1205,904
21780,1,1,168,1262,1094
21781,0,0,19,0,-19
21782,1,1,1132,1509,377
21783,1,0,8,0,-8
21784,1,0,155,0,-155
21785,0,0,7,0,-7
21786,0,0,7,0,-7
21787,1,1,970,1354,384
21788,1,1,387,1808,1421
21789,0,0,105,0,-105
21790,0,0,23,0,-23
21791,0,0,28,0,-28
21792,1,1,192,1224,1032
21793,1,0,51,0,-51
21794,1,1,280,1369,1089
21795,1,1,964,1502,538
21796,1,0,17,0,-17
21797,1,0,15,0,-15
21798,0,0,19,0,-19
21799,1,0,140,0,-140
21800,0,0,17,0,-17
21801,1,0,6,0,-6
21802,1,1,103,1249,1146
21803,1,0,93,0,-93
21804,1,1,153,1217,1064
21805,0,0,83,0,-83
21806,1,0,32,0,-32
21807,0,0,31,0,-31
21808,1,0,68,0,-68
21809,1,1,321,1296,975
21810,1,0,11,0,-11
21811,0,0,37,0,-37
21812,0,0,32,0,-32
21813,1,1,266,1312,1046
21814,1,1,189,2586,2397
21815,0,0,0,0,0
21816,1,0,8,0,-8
21817,0,0,97,0,-97
21818,1,0,98,0,-98
21819,1,1,815,2146,1331
21820,1,0,6,0,-6
21821,1,0,73,0,-73
21822,1,0,61,0,-61
21823,1,0,46,0,-46
21824,0,0,32,0,-32
21825,1,0,135,0,-135
21826,1,1,2027,1399,-628
21827,1,1,295,3497,3202
21828,1,1,334,3714,3380
21829,0,0,12,0,-12
21830,0,0,29,0,-29
21831,1,1,249,1521,1272
21832,0,0,29,0,-29
21833,1,0,77,0,-77
21834,1,1,189,2481,2292
21835,1,1,184,1201,1017
21836,1,1,325,1406,1081
21837,1,1,200,1675,1475
21838,1,1,372,1252,880
21839,1,0,88,0,-88
21840,1,1,308,1280,972
21841,1,1,409,1385,976
21842,0,0,40,0,-40
21843,0,0,58,0,-58
21844,0,0,19,0,-19
21845,1,0,41,0,-41
21846,0,0,9,0,-9
21847,1,1,177,1379,1202
21848,1,1,287,2259,1972
21849,0,0,15,0,-15
21850,0,0,91,0,-91
21851,1,1,1378,1379,1
21852,1,1,1411,1348,-63
21853,1,1,574,1263,689
21854,1,0,6,0,-6
21855,0,0,67,0,-67
21856,1,1,821,1544,723
21857,0,0,6,0,-6
21858,1,1,430,1238,808
21859,1,1,53,1472,1419
21860,1,0,57,0,-57
21861,1,0,170,0,-170
21862,1,0,23,0,-23
21863,1,1,102,1365,1263
21864,1,1,252,1534,1282
21865,0,0,38,0,-38
21866,1,0,69,0,-69
21867,0,0,71,0,-71
21868,1,1,543,1262,719
21869,0,0,36,0,-36
21870,1,1,75,1502,1427
21871,1,1,432,1298,866
21872,0,0,11,0,-11
21873,1,1,175,2281,2106
21874,1,1,360,1231,871
21875,1,0,33,0,-33
21876,0,0,34,0,-34
21877,1,1,1362,2379,1017
21878,1,0,63,0,-63
21879,1,0,2,0,-2
21880,1,0,62,0,-62
21881,1,0,19,0,-19
21882,1,0,11,0,-11
21883,0,0,47,0,-47
21884,1,0,30,0,-30
21885,1,1,484,1344,860
21886,1,0,92,0,-92
21887,1,1,922,1263,341
21888,1,0,69,0,-69
21889,1,0,1,0,-1
21890,1,0,26,0,-26
21891,1,0,37,0,-37
21892,1,1,1084,1342,258
21893,1,1,243,1229,986
21894,1,0,26,0,-26
21895,0,0,6,0,-6
21896,0,0,150,0,-150
21897,0,0,5,0,-5
21898,1,0,88,0,-88
21899,0,0,14,0,-14
21900,1,1,2504,1356,-1148
21901,0,0,153,0,-153
21902,0,0,153,0,-153
21903,0,0,15,0,-15
21904,0,0,53,0,-53
21905,1,0,59,0,-59
21906,0,0,20,0,-20
21907,0,0,10,0,-10
21908,1,1,652,1541,889
21909,1,0,41,0,-41
21910,0,0,139,0,-139
21911,1,0,37,0,-37
21912,0,0,11,0,-11
21913,1,1,527,1320,793
21914,1,0,30,0,-30
21915,0,0,84,0,-84
21916,1,0,28,0,-28
21917,1,0,16,0,-16
21918,0,0,89,0,-89
21919,0,0,44,0,-44
21920,1,1,829,1387,558
21921,1,1,627,1432,805
21922,1,1,387,1200,813
21923,1,0,35,0,-35
21924,0,0,88,0,-88
21925,0,0,91,0,-91
21926,1,0,34,0,-34
21927,1,1,978,1686,708
21928,1,1,503,1392,889
21929,0,0,49,0,-49
21930,0,0,46,0,-46
21931,0,0,72,0,-72
21932,0,0,135,0,-135
21933,0,0,12,0,-12
21934,1,1,317,1232,915
21935,0,0,39,0,-39
21936,0,0,122,0,-122
21937,1,0,29,0,-29
21938,1,0,2,0,-2
21939,0,0,27,0,-27
21940,1,1,800,1731,931
21941,1,0,122,0,-122
21942,1,1,218,1683,1465
21943,1,1,322,1282,960
21944,1,0,5,0,-5
21945,1,0,104,0,-104
21946,0,0,29,0,-29
21947,1,0,26,0,-26
21948,0,0,13,0,-13
21949,0,0,9,0,-9
21950,0,0,22,0,-22
21951,1,0,11,0,-11
21952,1,0,35,0,-35
21953,1,1,290,1472,1182
21954,1,1,226,1527,1301
21955,1,1,435,1592,1157
21956,1,1,194,1354,1160
21957,1,0,57,0,-57
21958,0,0,132,0,-132
21959,1,0,28,0,-28
21960,0,0,80,0,-80
21961,1,0,23,0,-23
21962,1,1,475,1516,1041
21963,1,0,63,0,-63
21964,1,1,219,1328,1109
21965,1,1,384,2140,1756
21966,1,1,1365,1956,591
21967,0,0,57,0,-57
21968,0,0,15,0,-15
21969,1,1,276,1579,1303
21970,0,0,14,0,-14
21971,1,0,113,0,-113
21972,1,1,52,1331,1279
21973,0,0,0,0,0
21974,1,0,58,0,-58
21975,0,0,62,0,-62
21976,0,0,22,0,-22
21977,1,1,2386,1590,-796
21978,1,1,122,1551,1429
21979,1,1,224,1229,1005
21980,0,0,46,0,-46
21981,1,1,79,1401,1322
21982,1,1,242,1396,1154
21983,1,0,1,0,-1
21984,0,0,64,0,-64
21985,1,0,24,0,-24
21986,0,0,10,0,-10
21987,0,0,63,0,-63
21988,1,0,164,0,-164
21989,0,0,192,0,-192
21990,1,1,308,1306,998
21991,0,0,107,0,-107
21992,1,0,10,0,-10
21993,1,1,363,1327,964
21994,1,1,353,1690,1337
21995,1,0,68,0,-68
21996,1,1,212,1816,1604
21997,1,0,3,0,-3
21998,1,1,382,1948,1566
21999,1,0,135,0,-135
22000,1,0,34,0,-34
22001,1,0,48,0,-48
22002,1,0,4,0,-4
22003,0,0,26,0,-26
22004,1,0,79,0,-79
22005,1,1,226,1251,1025
22006,0,0,88,0,-88
22007,0,0,33,0,-33
22008,0,0,66,0,-66
22009,1,1,775,2067,1292
22010,1,0,41,0,-41
22011,0,0,18,0,-18
22012,1,0,93,0,-93
22013,0,0,84,0,-84
22014,1,1,236,1694,1458
22015,1,1,1255,1250,-5
22016,0,0,21,0,-21
22017,1,0,151,0,-151
22018,0,0,61,0,-61
22019,1,1,729,1362,633
22020,0,0,87,0,-87
22021,0,0,134,0,-134
22022,1,0,69,0,-69
22023,1,1,1451,1412,-39
22024,0,0,36,0,-36
22025,1,1,614,1678,1064
22026,0,0,12,0,-12
22027,0,0,71,0,-71
22028,1,1,143,1267,1124
22029,0,0,28,0,-28
22030,1,0,22,0,-22
22031,1,1,661,1442,781
22032,1,0,21,0,-21
22033,0,0,37,0,-37
22034,0,0,21,0,-21
22035,1,0,21,0,-21
22036,0,0,14,0,-14
22037,1,0,4,0,-4
22038,1,1,64,2489,2425
22039,1,1,220,1445,1225
22040,1,0,62,0,-62
22041,0,0,91,0,-91
22042,1,0,7,0,-7
22043,1,0,23,0,-23
22044,0,0,38,0,-38
22045,0,0,3,0,-3
22046,1,1,328,1534,1206
22047,1,1,136,1693,1557
22048,1,1,767,2043,1276
22049,1,0,26,0,-26
22050,0,0,12,0,-12
22051,1,0,83,0,-83
22052,0,0,136,0,-136
22053,1,0,120,0,-120
22054,0,0,10,0,-10
22055,1,0,64,0,-64
22056,1,1,67,2020,1953
22057,0,0,72,0,-72
22058,0,0,16,0,-16
22059,1,0,13,0,-13
22060,0,0,16,0,-16
22061,0,0,11,0,-11
22062,1,0,66,0,-66
22063,1,0,20,0,-20
22064,1,0,0,0,0
22065,0,0,13,0,-13
22066,0,0,23,0,-23
22067,1,1,123,1258,1135
22068,0,0,21,0,-21
22069,0,0,262,0,-262
22070,1,0,25,0,-25
22071,1,1,233,1286,1053
22072,1,1,498,2461,1963
22073,1,1,368,1246,878
22074,1,1,291,1317,1026
22075,0,0,76,0,-76
22076,0,0,11,0,-11
22077,1,0,22,0,-22
22078,1,1,342,1332,990
22079,0,0,90,0,-90
22080,1,0,49,0,-49
22081,1,0,27,0,-27
22082,1,1,1269,1466,197
22083,1,1,220,1588,1368
22084,1,0,61,0,-61
22085,0,0,114,0,-114
22086,0,0,31,0,-31
22087,1,0,53,0,-53
22088,1,0,46,0,-46
22089,0,0,43,0,-43
22090,1,0,31,0,-31
22091,0,0,6,0,-6
22092,1,1,485,1447,962
22093,1,0,144,0,-144
22094,0,0,13,0,-13
22095,0,0,93,0,-93
22096,0,0,19,0,-19
22097,0,0,12,0,-12
22098,1,0,12,0,-12
22099,1,1,462,1511,1049
22100,0,0,242,0,-242
22101,0,0,53,0,-53
22102,1,1,1193,1871,678
22103,0,0,112,0,-112
22104,1,1,1720,1531,-189
22105,0,0,233,0,-233
22106,1,1,384,2136,1752
22107,1,0,5,0,-5
22108,0,0,188,0,-188
22109,1,1,270,1352,1082
22110,1,0,12,0,-12
22111,1,1,270,1543,1273
22112,1,0,64,0,-64
22113,0,0,2,0,-2
22114,1,0,46,0,-46
22115,0,0,54,0,-54
22116,0,0,6,0,-6
22117,1,0,16,0,-16
22118,0,0,43,0,-43
22119,0,0,11,0,-11
22120,0,0,207,0,-207
22121,0,0,125,0,-125
22122,1,0,53,0,-53
22123,0,0,21,0,-21
22124,0,0,22,0,-22
22125,1,0,15,0,-15
22126,0,0,77,0,-77
22127,0,0,81,0,-81
22128,1,0,16,0,-16
22129,1,1,301,1405,1104
22130,1,0,89,0,-89
22131,0,0,39,0,-39
22132,1,1,2352,1340,-1012
22133,1,1,1199,1416,217
22134,0,0,7,0,-7
22135,1,1,295,1217,922
22136,0,0,21,0,-21
22137,1,1,228,1552,1324
22138,0,0,13,0,-13
22139,1,1,484,1641,1157
22140,0,0,27,0,-27
22141,1,1,162,1863,1701
22142,1,1,110,1772,1662
22143,1,0,40,0,-40
22144,1,0,79,0,-79
22145,1,1,126,1250,1124
22146,0,0,29,0,-29
22147,1,0,60,0,-60
22148,1,1,362,1690,1328
22149,1,1,62,1536,1474
22150,0,0,21,0,-21
22151,1,0,23,0,-23
22152,0,0,2,0,-2
22153,0,0,4,0,-4
22154,0,0,155,0,-155
22155,0,0,15,0,-15
22156,0,0,1,0,-1
22157,0,0,65,0,-65
22158,0,0,15,0,-15
22159,1,1,937,1343,406
22160,1,0,117,0,-117
22161,0,0,24,0,-24
22162,1,1,510,1389,879
22163,1,0,6,0,-6
22164,1,0,11,0,-11
22165,0,0,17,0,-17
22166,1,0,113,0,-113
22167,0,0,147,0,-147
22168,0,0,25,0,-25
22169,0,0,92,0,-92
22170,1,1,72,2440,2368
22171,1,0,73,0,-73
22172,1,0,103,0,-103
22173,1,1,511,1250,739
22174,0,0,18,0,-18
22175,1,0,15,0,-15
22176,0,0,13,0,-13
22177,0,0,32,0,-32
22178,1,1,248,1528,1280
22179,0,0,6,0,-6
22180,1,1,733,1607,874
22181,1,1,335,1580,1245
22182,0,0,151,0,-151
22183,1,1,671,1787,1116
22184,0,0,34,0,-34
22185,1,0,20,0,-20
22186,0,0,4,0,-4
22187,0,0,30,0,-30
22188,1,1,570,1327,757
22189,0,0,29,0,-29
22190,1,0,119,0,-119
22191,1,1,451,1238,787
22192,0,0,24,0,-24
22193,0,0,58,0,-58
22194,1,0,7,0,-7
22195,1,1,161,1346,1185
22196,1,1,220,2333,2113
22197,0,0,9,0,-9
22198,1,0,20,0,-20
22199,0,0,58,0,-58
22200,0,0,24,0,-24
22201,1,0,27,0,-27
22202,1,0,60,0,-60
22203,1,0,61,0,-61
22204,0,0,58,0,-58
22205,1,0,0,0,0
22206,1,1,628,1743,1115
22207,1,1,158,1559,1401
22208,1,0,76,0,-76
22209,1,0,31,0,-31
22210,1,1,396,1553,1157
22211,0,0,10,0,-10
22212,1,1,410,1399,989
22213,0,0,66,0,-66
22214,1,0,29,0,-29
22215,1,0,9,0,-9
22216,1,1,92,1275,1183
22217,0,0,42,0,-42
22218,1,1,1137,1995,858
22219,1,0,0,0,0
22220,1,1,229,2011,1782
22221,0,0,108,0,-108
22222,1,0,22,0,-22
22223,1,0,31,0,-31
22224,0,0,7,0,-7
22225,0,0,14,0,-14
22226,1,0,142,0,-142
22227,1,1,774,1407,633
22228,0,0,68,0,-68
22229,1,1,748,1576,828
22230,0,0,78,0,-78
22231,1,0,34,0,-34
22232,0,0,13,0,-13
22233,1,0,123,0,-123
22234,0,0,45,0,-45
22235,1,0,27,0,-27
22236,1,1,648,2047,1399
22237,0,0,5,0,-5
22238,0,0,131,0,-131
22239,1,1,858,1241,383
22240,0,0,223,0,-223
22241,0,0,122,0,-122
22242,1,0,14,0,-14
22243,1,0,14,0,-14
22244,0,0,31,0,-31
22245,0,0,83,0,-83
22246,1,1,761,1734,973
22247,1,0,38,0,-38
22248,1,0,66,0,-66
22249,1,1,411,1338,927
22250,0,0,37,0,-37
22251,1,1,581,1521,940
22252,0,0,22,0,-22
22253,0,0,0,0,0
22254,1,0,64,0,-64
22255,1,1,111,1548,1437
22256,0,0,18,0,-18
22257,0,0,67,0,-67
22258,1,1,434,1762,1328
22259,1,0,37,0,-37
22260,0,0,34,0,-34
22261,1,1,702,1806,1104
22262,0,0,190,0,-190
22263,0,0,15,0,-15
22264,1,1,843,1313,470
22265,1,0,12,0,-12
22266,0,0,15,0,-15
22267,0,0,11,0,-11
22268,0,0,15,0,-15
22269,0,0,58,0,-58
22270,1,0,155,0,-155
22271,1,0,1,0,-1
22272,0,0,74,0,-74
22273,1,0,106,0,-106
22274,0,0,4,0,-4
22275,1,0,15,0,-15
22276,0,0,83,0,-83
22277,1,0,66,0,-66
22278,1,1,165,1721,1556
22279,1,0,45,0,-45
22280,1,1,176,1964,1788
22281,1,0,20,0,-20
22282,0,0,53,0,-53
22283,1,1,1280,1209,-71
22284,0,0,64,0,-64
22285,1,0,132,0,-132
22286,0,0,43,0,-43
22287,1,1,650,2759,2109
22288,1,0,220,0,-220
22289,1,1,583,1688,1105
22290,0,0,43,0,-43
22291,0,0,125,0,-125
22292,1,0,45,0,-45
22293,1,1,511,1685,1174
22294,1,1,2083,1294,-789
22295,0,0,33,0,-33
22296,1,1,1295,1604,309
22297,0,0,161,0,-161
22298,1,0,144,0,-144
22299,0,0,7,0,-7
22300,1,1,254,1484,1230
22301,1,0,242,0,-242
22302,0,0,72,0,-72
22303,1,1,252,1773,1521
22304,1,0,29,0,-29
22305,1,1,360,1209,849
22306,0,0,14,0,-14
22307,1,0,13,0,-13
22308,0,0,33,0,-33
22309,0,0,18,0,-18
22310,0,0,38,0,-38
22311,1,0,112,0,-112
22312,0,0,157,0,-157
22313,1,1,519,1347,828
22314,1,1,136,1387,1251
22315,1,1,383,1288,905
22316,0,0,57,0,-57
22317,0,0,42,0,-42
22318,1,0,54,0,-54
22319,0,0,65,0,-65
22320,1,1,460,1251,791
22321,1,1,669,1895,1226
22322,1,0,120,0,-120
22323,0,0,10,0,-10
22324,1,1,185,1217,1032
22325,1,0,78,0,-78
22326,1,1,2875,1394,-1481
22327,1,1,572,1420,848
22328,1,1,279,1414,1135
22329,0,0,52,0,-52
22330,1,0,55,0,-55
22331,1,0,98,0,-98
22332,0,0,63,0,-63
22333,1,1,102,2067,1965
22334,1,0,0,0,0
22335,1,1,711,1412,701
22336,1,1,778,1570,792
22337,0,0,107,0,-107
22338,1,1,145,1454,1309
22339,1,0,3,0,-3
22340,0,0,12,0,-12
22341,1,0,21,0,-21
22342,1,0,86,0,-86
22343,1,0,25,0,-25
22344,1,1,244,1439,1195
22345,1,0,49,0,-49
22346,0,0,12,0,-12
22347,1,1,371,2318,1947
22348,1,1,259,1347,1088
22349,0,0,11,0,-11
22350,1,0,39,0,-39
22351,0,0,229,0,-229
22352,0,0,27,0,-27
22353,1,1,2502,1219,-1283
22354,1,1,2000,1917,-83
22355,1,1,184,1320,1136
22356,1,0,34,0,-34
22357,1,1,233,1204,971
22358,1,0,0,0,0
22359,1,1,342,3252,2910
22360,1,1,406,1893,1487
22361,1,1,363,1253,890
22362,1,0,42,0,-42
22363,1,0,40,0,-40
22364,0,0,10,0,-10
22365,1,1,41,1435,1394
22366,0,0,44,0,-44
22367,0,0,41,0,-41
22368,1,1,233,1556,1323
22369,0,0,78,0,-78
22370,1,0,5,0,-5
22371,0,0,21,0,-21
22372,1,0,27,0,-27
22373,0,0,12,0,-12
22374,1,0,87,0,-87
22375,0,0,61,0,-61
22376,1,0,38,0,-38
22377,0,0,0,0,0
22378,1,0,69,0,-69
22379,0,0,18,0,-18
22380,1,0,18,0,-18
22381,0,0,18,0,-18
22382,1,0,57,0,-57
22383,0,0,28,0,-28
22384,0,0,6,0,-6
22385,1,1,1131,1610,479
22386,1,0,8,0,-8
22387,0,0,151,0,-151
22388,1,1,1133,2395,1262
22389,1,0,159,0,-159
22390,1,0,2,0,-2
22391,1,1,158,1869,1711
22392,0,0,194,0,-194
22393,1,1,981,1564,583
22394,1,0,4,0,-4
22395,1,0,195,0,-195
22396,0,0,17,0,-17
22397,0,0,13,0,-13
22398,1,1,250,1211,961
22399,1,1,519,1718,1199
22400,0,0,70,0,-70
22401,0,0,5,0,-5
22402,1,0,3,0,-3
22403,1,0,76,0,-76
22404,0,0,76,0,-76
22405,1,1,867,1457,590
22406,0,0,13,0,-13
22407,0,0,103,0,-103
22408,1,1,450,1536,1086
22409,0,0,32,0,-32
22410,1,0,29,0,-29
22411,0,0,38,0,-38
22412,0,0,5,0,-5
22413,0,0,82,0,-82
22414,1,1,392,1382,990
22415,1,1,430,1717,1287
22416,1,0,15,0,-15
22417,1,1,549,1238,689
22418,1,1,2217,1250,-967
22419,1,0,21,0,-21
22420,0,0,74,0,-74
22421,0,0,32,0,-32
22422,1,0,28,0,-28
22423,1,1,69,1615,1546
22424,1,0,16,0,-16
22425,1,0,17,0,-17
22426,0,0,88,0,-88
22427,1,1,702,1616,914
22428,0,0,7,0,-7
22429,1,0,88,0,-88
22430,0,0,1,0,-1
22431,0,0,27,0,-27
22432,0,0,22,0,-22
22433,0,0,37,0,-37
22434,0,0,13,0,-13
22435,0,0,2,0,-2
22436,1,0,13,0,-13
22437,0,0,40,0,-40
22438,1,1,1050,1965,915
22439,1,1,936,1249,313
22440,1,0,85,0,-85
22441,1,0,15,0,-15
22442,1,0,64,0,-64
22443,0,0,27,0,-27
22444,1,0,55,0,-55
22445,0,0,32,0,-32
22446,0,0,56,0,-56
22447,0,0,16,0,-16
22448,0,0,17,0,-17
22449,1,1,188,1729,1541
22450,0,0,51,0,-51
22451,1,0,54,0,-54
22452,1,0,48,0,-48
22453,0,0,2,0,-2
22454,0,0,100,0,-100
22455,1,1,616,3166,2550
22456,0,0,142,0,-142
22457,1,0,26,0,-26
22458,0,0,42,0,-42
22459,1,0,75,0,-75
22460,1,0,18,0,-18
22461,0,0,7,0,-7
22462,0,0,24,0,-24
22463,0,0,45,0,-45
22464,1,1,430,1403,973
22465,1,0,26,0,-26
22466,1,1,295,1276,981
22467,0,0,9,0,-9
22468,0,0,28,0,-28
22469,0,0,41,0,-41
22470,0,0,83,0,-83
22471,1,0,10,0,-10
22472,0,0,10,0,-10
22473,0,0,53,0,-53
22474,1,1,870,1602,732
22475,0,0,37,0,-37
22476,1,1,345,1356,1011
22477,1,1,710,1532,822
22478,0,0,58,0,-58
22479,1,0,9,0,-9
22480,0,0,30,0,-30
22481,1,0,0,0,0
22482,0,0,6,0,-6
22483,1,1,126,1602,1476
22484,1,1,156,1317,1161
22485,0,0,51,0,-51
22486,1,1,863,1301,438
22487,1,0,22,0,-22
22488,1,1,485,1344,859
22489,1,0,14,0,-14
22490,1,0,3,0,-3
22491,0,0,58,0,-58
22492,0,0,58,0,-58
22493,1,0,139,0,-139
22494,0,0,54,0,-54
22495,0,0,13,0,-13
22496,1,0,13,0,-13
22497,1,0,38,0,-38
22498,1,0,10,0,-10
22499,0,0,4,0,-4
22500,1,1,44,1208,1164
22501,0,0,46,0,-46
22502,1,1,710,1506,796
22503,0,0,25,0,-25
22504,1,0,5,0,-5
22505,1,1,187,1242,1055
22506,0,0,38,0,-38
22507,1,0,52,0,-52
22508,0,0,83,0,-83
22509,1,1,272,1634,1362
22510,0,0,127,0,-127
22511,1,0,24,0,-24
22512,0,0,9,0,-9
22513,1,0,43,0,-43
22514,1,0,126,0,-126
22515,1,1,107,1363,1256
22516,1,1,391,1270,879
22517,0,0,34,0,-34
22518,1,1,1541,1602,61
22519,0,0,417,0,-417
22520,1,1,763,1589,826
22521,1,1,730,1477,747
22522,0,0,7,0,-7
22523,0,0,47,0,-47
22524,0,0,45,0,-45
22525,1,0,131,0,-131
22526,1,0,56,0,-56
22527,0,0,15,0,-15
22528,1,0,73,0,-73
22529,1,1,239,1331,1092
22530,1,0,2,0,-2
22531,1,1,357,1482,1125
22532,0,0,18,0,-18
22533,1,1,697,1554,857
22534,1,1,130,1349,1219
22535,1,0,35,0,-35
22536,1,0,5,0,-5
22537,0,0,16,0,-16
22538,1,1,106,1504,1398
22539,1,1,1280,1293,13
22540,1,1,86,1443,1357
22541,0,0,360,0,-360
22542,1,1,159,1250,1091
22543,1,1,314,1860,1546
22544,0,0,1,0,-1
22545,1,0,56,0,-56
22546,0,0,21,0,-21
22547,0,0,12,0,-12
22548,1,0,110,0,-110
22549,1,1,82,1398,1316
22550,1,0,80,0,-80
22551,1,0,36,0,-36
22552,1,0,48,0,-48
22553,0,0,99,0,-99
22554,1,1,176,1645,1469
22555,1,1,535,1397,862
22556,1,1,1519,1530,11
22557,0,0,3,0,-3
22558,1,1,458,1609,1151
22559,1,0,121,0,-121
22560,1,1,476,1528,1052
22561,0,0,15,0,-15
22562,0,0,6,0,-6
22563,1,1,860,1450,590
22564,0,0,5,0,-5
22565,1,0,30,0,-30
22566,1,0,34,0,-34
22567,0,0,1,0,-1
22568,1,0,86,0,-86
22569,1,0,26,0,-26
22570,0,0,98,0,-98
22571,1,1,206,1299,1093
22572,1,1,176,1312,1136
22573,0,0,5,0,-5
22574,0,0,25,0,-25
22575,0,0,31,0,-31
22576,0,0,98,0,-98
22577,1,1,510,2854,2344
22578,1,1,272,1287,1015
22579,1,1,319,1769,1450
22580,1,1,2069,1979,-90
22581,1,1,1011,1283,272
22582,1,0,2,0,-2
22583,1,1,187,1234,1047
22584,0,0,15,0,-15
22585,0,0,14,0,-14
22586,0,0,69,0,-69
22587,1,0,16,0,-16
22588,1,1,590,1589,999
22589,0,0,50,0,-50
22590,0,0,27,0,-27
22591,0,0,26,0,-26
22592,1,1,385,2437,2052
22593,1,0,9,0,-9
22594,1,0,26,0,-26
22595,0,0,34,0,-34
22596,1,0,12,0,-12
22597,0,0,11,0,-11
22598,1,0,12,0,-12
22599,1,0,112,0,-112
22600,1,1,141,1730,1589
22601,1,1,1209,1249,40
22602,0,0,17,0,-17
22603,1,0,85,0,-85
22604,1,1,347,1356,1009
22605,0,0,82,0,-82
22606,1,1,34,1505,1471
22607,1,1,676,1306,630
22608,0,0,87,0,-87
22609,0,0,39,0,-39
22610,1,1,55,1315,1260
22611,1,0,11,0,-11
22612,1,1,130,1202,1072
22613,0,0,17,0,-17
22614,0,0,86,0,-86
22615,0,0,55,0,-55
22616,1,1,552,1229,677
22617,1,1,682,1235,553
22618,0,0,50,0,-50
22619,1,1,48,1256,1208
22620,1,0,57,0,-57
22621,1,0,59,0,-59
22622,1,1,237,1210,973
22623,1,0,27,0,-27
22624,0,0,192,0,-192
22625,0,0,18,0,-18
22626,0,0,31,0,-31
22627,1,0,6,0,-6
22628,1,1,265,1340,1075
22629,0,0,72,0,-72
22630,1,0,1,0,-1
22631,1,1,297,1372,1075
22632,1,1,194,1649,1455
22633,1,0,130,0,-130
22634,0,0,53,0,-53
22635,1,1,298,1328,1030
22636,1,0,40,0,-40
22637,0,0,11,0,-11
22638,0,0,31,0,-31
22639,0,0,2,0,-2
22640,0,0,170,0,-170
22641,1,1,309,1386,1077
22642,0,0,118,0,-118
22643,0,0,45,0,-45
22644,0,0,20,0,-20
22645,1,0,22,0,-22
22646,1,0,11,0,-11
22647,0,0,2,0,-2
22648,0,0,71,0,-71
22649,0,0,155,0,-155
22650,1,1,501,1407,906
22651,1,0,57,0,-57
22652,1,1,554,1430,876
22653,1,1,562,1548,986
22654,1,1,939,1249,310
22655,1,0,95,0,-95
22656,1,0,10,0,-10
22657,0,0,208,0,-208
22658,1,1,426,1414,988
22659,1,0,56,0,-56
22660,0,0,198,0,-198
22661,0,0,20,0,-20
22662,1,0,36,0,-36
22663,1,0,26,0,-26
22664,1,0,57,0,-57
22665,0,0,9,0,-9
22666,1,0,39,0,-39
22667,0,0,40,0,-40
22668,0,0,124,0,-124
22669,1,1,1296,1324,28
22670,1,1,414,1398,984
22671,1,1,1490,1448,-42
22672,1,1,20,1200,1180
22673,0,0,43,0,-43
22674,0,0,130,0,-130
22675,1,0,64,0,-64
22676,1,0,31,0,-31
22677,0,0,98,0,-98
22678,1,1,295,1412,1117
22679,0,0,24,0,-24
22680,1,0,39,0,-39
22681,1,1,168,1430,1262
22682,1,0,49,0,-49
22683,1,1,1327,1668,341
22684,1,1,108,1994,1886
22685,1,0,12,0,-12
22686,1,1,346,1663,1317
22687,1,0,59,0,-59
22688,0,0,56,0,-56
22689,1,0,29,0,-29
22690,1,0,54,0,-54
22691,1,0,3,0,-3
22692,0,0,54,0,-54
22693,0,0,38,0,-38
22694,1,1,582,1248,666
22695,1,1,338,1209,871
22696,1,0,20,0,-20
22697,1,1,72,1239,1167
22698,1,0,8,0,-8
22699,1,1,945,1285,340
22700,1,1,377,1764,1387
22701,1,0,33,0,-33
22702,0,0,8,0,-8
22703,1,0,19,0,-19
22704,0,0,47,0,-47
22705,0,0,122,0,-122
22706,0,0,4,0,-4
22707,0,0,5,0,-5
22708,1,0,24,0,-24
22709,0,0,4,0,-4
22710,0,0,3,0,-3
22711,0,0,68,0,-68
22712,0,0,8,0,-8
22713,1,1,251,1277,1026
22714,1,1,1123,1371,248
22715,1,1,536,1245,709
22716,1,0,9,0,-9
22717,1,0,10,0,-10
22718,1,1,20,1239,1219
22719,0,0,30,0,-30
22720,0,0,31,0,-31
22721,1,1,1360,1490,130
22722,0,0,81,0,-81
22723,1,0,10,0,-10
22724,1,0,13,0,-13
22725,1,1,315,1477,1162
22726,0,0,96,0,-96
22727,1,1,435,1500,1065
22728,0,0,9,0,-9
22729,1,0,97,0,-97
22730,0,0,14,0,-14
22731,1,0,4,0,-4
22732,1,0,10,0,-10
22733,0,0,59,0,-59
22734,1,0,33,0,-33
22735,0,0,21,0,-21
22736,1,1,215,1332,1117
22737,1,1,429,1318,889
22738,1,1,880,1207,327
22739,0,0,64,0,-64
22740,1,0,35,0,-35
22741,0,0,78,0,-78
22742,0,0,45,0,-45
22743,0,0,132,0,-132
22744,1,1,461,1220,759
22745,1,1,1693,1231,-462
22746,1,0,14,0,-14
22747,1,0,22,0,-22
22748,0,0,110,0,-110
22749,1,0,108,0,-108
22750,1,0,6,0,-6
22751,0,0,6,0,-6
22752,0,0,8,0,-8
22753,0,0,1,0,-1
22754,1,0,41,0,-41
22755,0,0,17,0,-17
22756,1,1,110,1201,1091
22757,1,0,58,0,-58
22758,1,1,893,1229,336
22759,0,0,38,0,-38
22760,1,1,649,2174,1525
22761,0,0,6,0,-6
22762,0,0,22,0,-22
22763,1,0,11,0,-11
22764,1,1,507,2122,1615
22765,1,1,275,1492,1217
22766,1,1,124,2403,2279
22767,1,1,842,1377,535
22768,1,0,35,0,-35
22769,0,0,113,0,-113
22770,0,0,119,0,-119
22771,1,1,1510,3501,1991
22772,0,0,110,0,-110
22773,0,0,34,0,-34
22774,0,0,91,0,-91
22775,0,0,79,0,-79
22776,0,0,10,0,-10
22777,0,0,13,0,-13
22778,1,0,88,0,-88
22779,1,0,16,0,-16
22780,1,1,289,1307,1018
22781,1,0,5,0,-5
22782,1,0,85,0,-85
22783,1,1,28,1747,1719
22784,0,0,1,0,-1
22785,0,0,25,0,-25
22786,1,0,97,0,-97
22787,0,0,110,0,-110
22788,0,0,16,0,-16
22789,0,0,20,0,-20
22790,0,0,19,0,-19
22791,1,0,7,0,-7
22792,1,1,472,1735,1263
22793,1,0,5,0,-5
22794,1,1,695,1621,926
22795,0,0,52,0,-52
22796,1,0,56,0,-56
22797,1,0,11,0,-11
22798,1,0,168,0,-168
22799,1,1,70,1379,1309
22800,0,0,71,0,-71
22801,0,0,144,0,-144
22802,1,0,166,0,-166
22803,0,0,20,0,-20
22804,0,0,22,0,-22
22805,0,0,5,0,-5
22806,0,0,40,0,-40
22807,0,0,12,0,-12
22808,0,0,24,0,-24
22809,1,1,18,1343,1325
22810,1,0,47,0,-47
22811,1,1,542,1311,769
22812,1,1,78,1222,1144
22813,1,1,588,1612,1024
22814,1,0,16,0,-16
22815,0,0,13,0,-13
22816,1,1,269,1549,1280
22817,1,0,49,0,-49
22818,1,0,9,0,-9
22819,0,0,143,0,-143
22820,1,0,122,0,-122
22821,1,0,67,0,-67
22822,1,0,43,0,-43
22823,0,0,13,0,-13
22824,1,0,7,0,-7
22825,0,0,117,0,-117
22826,1,1,613,1202,589
22827,1,0,10,0,-10
22828,0,0,36,0,-36
22829,0,0,83,0,-83
22830,0,0,63,0,-63
22831,1,0,143,0,-143
22832,0,0,137,0,-137
22833,1,1,935,1224,289
22834,1,0,36,0,-36
22835,1,1,183,3894,3711
22836,0,0,58,0,-58
22837,1,1,64,1707,1643
22838,1,1,269,2090,1821
22839,0,0,48,0,-48
22840,1,0,5,0,-5
22841,1,0,5,0,-5
22842,1,0,79,0,-79
22843,1,1,387,1259,872
22844,1,1,330,1445,1115
22845,1,1,535,1335,800
22846,0,0,7,0,-7
22847,0,0,19,0,-19
22848,1,0,8,0,-8
22849,1,1,1395,1203,-192
22850,0,0,4,0,-4
22851,1,0,5,0,-5
22852,0,0,39,0,-39
22853,0,0,53,0,-53
22854,0,0,101,0,-101
22855,1,1,72,1323,1251
22856,1,1,309,1716,1407
22857,1,0,37,0,-37
22858,0,0,68,0,-68
22859,1,0,39,0,-39
22860,1,0,15,0,-15
22861,0,0,74,0,-74
22862,0,0,17,0,-17
22863,0,0,46,0,-46
22864,1,1,230,1211,981
22865,0,0,6,0,-6
22866,0,0,74,0,-74
22867,0,0,32,0,-32
22868,0,0,41,0,-41
22869,0,0,16,0,-16
22870,1,0,91,0,-91
22871,0,0,35,0,-35
22872,0,0,41,0,-41
22873,1,0,3,0,-3
22874,1,1,632,1231,599
22875,0,0,0,0,0
22876,0,0,8,0,-8
22877,1,0,198,0,-198
22878,0,0,99,0,-99
22879,1,0,2,0,-2
22880,0,0,16,0,-16
22881,1,0,29,0,-29
22882,0,0,31,0,-31
22883,1,1,144,1278,1134
22884,0,0,28,0,-28
22885,1,1,1182,1273,91
22886,1,0,138,0,-138
22887,0,0,46,0,-46
22888,1,1,345,1324,979
22889,1,1,96,1366,1270
22890,0,0,70,0,-70
22891,1,1,1649,1568,-81
22892,1,0,11,0,-11
22893,0,0,59,0,-59
22894,1,1,693,2558,1865
22895,1,0,37,0,-37
22896,0,0,19,0,-19
22897,1,1,1626,1310,-316
22898,1,1,287,1217,930
22899,1,0,122,0,-122
22900,1,1,486,1663,1177
22901,1,1,313,1440,1127
22902,0,0,136,0,-136
22903,1,0,97,0,-97
22904,0,0,7,0,-7
22905,1,0,31,0,-31
22906,1,1,727,1518,791
22907,1,1,266,1211,945
22908,1,1,593,1373,780
22909,1,1,565,1299,734
22910,0,0,139,0,-139
22911,0,0,58,0,-58
22912,1,0,31,0,-31
22913,0,0,80,0,-80
22914,0,0,78,0,-78
22915,1,1,254,1236,982
22916,1,0,5,0,-5
22917,0,0,63,0,-63
22918,1,0,4,0,-4
22919,1,0,127,0,-127
22920,1,1,29,1241,1212
22921,1,1,1251,2724,1473
22922,1,1,266,1324,1058
22923,0,0,41,0,-41
22924,1,0,67,0,-67
22925,1,1,94,1795,1701
22926,1,0,21,0,-21
22927,1,1,47,1214,1167
22928,1,0,187,0,-187
22929,1,0,28,0,-28
22930,1,1,222,1437,1215
22931,0,0,16,0,-16
22932,1,1,220,1239,1019
22933,1,0,5,0,-5
22934,1,0,101,0,-101
22935,0,0,11,0,-11
22936,0,0,1,0,-1
22937,1,0,20,0,-20
22938,1,0,43,0,-43
22939,1,0,45,0,-45
22940,1,1,2473,1228,-1245
22941,1,1,857,2023,1166
22942,0,0,37,0,-37
22943,1,1,1206,1207,1
22944,0,0,35,0,-35
22945,0,0,3,0,-3
22946,1,0,138,0,-138
22947,0,0,78,0,-78
22948,1,1,91,1589,1498
22949,1,1,422,1473,1051
22950,0,0,0,0,0
22951,1,1,683,2447,1764
22952,1,1,639,1465,826
22953,0,0,4,0,-4
22954,1,0,35,0,-35
22955,0,0,101,0,-101
22956,1,0,28,0,-28
22957,1,1,165,2889,2724
22958,0,0,28,0,-28
22959,0,0,15,0,-15
22960,0,0,9,0,-9
22961,0,0,150,0,-150
22962,1,1,348,1292,944
22963,1,0,114,0,-114
22964,0,0,89,0,-89
22965,0,0,58,0,-58
22966,1,1,831,1708,877
22967,0,0,18,0,-18
22968,0,0,95,0,-95
22969,0,0,139,0,-139
22970,1,0,4,0,-4
22971,0,0,39,0,-39
22972,0,0,37,0,-37
22973,1,1,454,1882,1428
22974,1,1,246,1518,1272
22975,0,0,93,0,-93
22976,1,1,1372,1544,172
22977,1,1,1090,1422,332
22978,0,0,167,0,-167
22979,1,1,751,1206,455
22980,0,0,50,0,-50
22981,0,0,101,0,-101
22982,1,0,70,0,-70
22983,0,0,78,0,-78
22984,1,1,126,1246,1120
22985,1,0,78,0,-78
22986,1,0,26,0,-26
22987,0,0,32,0,-32
22988,1,1,229,1299,1070
22989,1,0,22,0,-22
22990,1,1,365,1648,1283
22991,0,0,64,0,-64
22992,1,1,834,2136,1302
22993,1,1,332,2011,1679
22994,1,1,811,1407,596
22995,0,0,48,0,-48
22996,1,1,384,1473,1089
22997,1,0,12,0,-12
22998,0,0,12,0,-12
22999,0,0,82,0,-82
23000,1,0,28,0,-28
23001,1,0,33,0,-33
23002,0,0,48,0,-48
23003,0,0,16,0,-16
23004,1,0,16,0,-16
23005,0,0,67,0,-67
23006,0,0,27,0,-27
23007,1,0,7,0,-7
23008,1,1,786,1414,628
23009,1,1,966,1563,597
23010,1,0,16,0,-16
23011,1,1,175,1253,1078
23012,0,0,12,0,-12
23013,0,0,96,0,-96
23014,1,0,155,0,-155
23015,0,0,63,0,-63
23016,1,1,740,2496,1756
23017,0,0,56,0,-56
23018,1,0,67,0,-67
23019,0,0,5,0,-5
23020,0,0,4,0,-4
23021,1,0,15,0,-15
23022,0,0,111,0,-111
23023,1,0,25,0,-25
23024,1,1,266,1336,1070
23025,1,1,430,2556,2126
23026,0,0,31,0,-31
23027,1,1,689,1233,544
23028,1,0,13,0,-13
23029,1,0,24,0,-24
23030,1,1,459,1214,755
23031,1,0,112,0,-112
23032,0,0,2,0,-2
23033,1,1,201,1743,1542
23034,1,1,175,4436,4261
23035,1,1,1444,1372,-72
23036,1,0,0,0,0
23037,1,1,576,1543,967
23038,0,0,8,0,-8
23039,0,0,48,0,-48
23040,0,0,109,0,-109
23041,1,1,219,1320,1101
23042,1,0,65,0,-65
23043,1,0,25,0,-25
23044,1,0,10,0,-10
23045,1,0,13,0,-13
23046,0,0,28,0,-28
23047,1,0,2,0,-2
23048,0,0,4,0,-4
23049,1,1,627,1203,576
23050,0,0,13,0,-13
23051,0,0,4,0,-4
23052,1,1,2224,1350,-874
23053,0,0,88,0,-88
23054,1,1,1078,1598,520
23055,0,0,148,0,-148
23056,0,0,7,0,-7
23057,1,0,225,0,-225
23058,1,1,958,1446,488
23059,0,0,211,0,-211
23060,1,0,4,0,-4
23061,1,1,235,2024,1789
23062,0,0,14,0,-14
23063,1,0,82,0,-82
23064,0,0,52,0,-52
23065,1,0,31,0,-31
23066,0,0,16,0,-16
23067,1,1,46,1333,1287
23068,0,0,3,0,-3
23069,0,0,111,0,-111
23070,1,1,275,1557,1282
23071,1,1,366,1394,1028
23072,1,1,664,1420,756
23073,1,0,44,0,-44
23074,1,1,202,1289,1087
23075,0,0,0,0,0
23076,0,0,67,0,-67
23077,0,0,17,0,-17
23078,1,1,1399,1362,-37
23079,1,1,228,1204,976
23080,1,1,794,1233,439
23081,1,1,803,1379,576
23082,1,1,1289,1274,-15
23083,1,0,12,0,-12
23084,1,1,1641,1370,-271
23085,0,0,53,0,-53
23086,1,0,154,0,-154
23087,0,0,5,0,-5
23088,1,0,16,0,-16
23089,0,0,41,0,-41
23090,0,0,20,0,-20
23091,1,1,45,1305,1260
23092,1,0,152,0,-152
23093,1,0,19,0,-19
23094,0,0,84,0,-84
23095,1,1,192,1501,1309
23096,1,1,1272,1308,36
23097,1,1,863,2028,1165
23098,1,0,177,0,-177
23099,0,0,139,0,-139
23100,0,0,53,0,-53
23101,0,0,19,0,-19
23102,1,0,56,0,-56
23103,1,0,29,0,-29
23104,0,0,11,0,-11
23105,0,0,61,0,-61
23106,1,0,48,0,-48
23107,0,0,25,0,-25
23108,1,0,1,0,-1
23109,1,1,16,1383,1367
23110,1,0,29,0,-29
23111,1,0,1,0,-1
23112,1,0,5,0,-5
23113,1,1,474,1219,745
23114,1,0,26,0,-26
23115,0,0,71,0,-71
23116,0,0,6,0,-6
23117,0,0,148,0,-148
23118,0,0,52,0,-52
23119,1,0,33,0,-33
23120,1,0,8,0,-8
23121,0,0,25,0,-25
23122,1,1,377,1442,1065
23123,1,0,145,0,-145
23124,0,0,142,0,-142
23125,1,1,101,1424,1323
23126,1,1,46,1373,1327
23127,0,0,0,0,0
23128,0,0,37,0,-37
23129,1,0,89,0,-89
23130,1,1,1521,2983,1462
23131,1,0,129,0,-129
23132,0,0,35,0,-35
23133,1,1,1367,1400,33
23134,1,1,303,1204,901
23135,1,1,214,1537,1323
23136,0,0,49,0,-49
23137,1,1,1377,1404,27
23138,1,1,88,1353,1265
23139,0,0,8,0,-8
23140,1,0,33,0,-33
23141,0,0,14,0,-14
23142,1,0,112,0,-112
23143,0,0,5,0,-5
23144,0,0,95,0,-95
23145,1,0,12,0,-12
23146,1,0,3,0,-3
23147,1,0,111,0,-111
23148,1,0,6,0,-6
23149,1,1,793,1347,554
23150,1,1,1048,1935,887
23151,0,0,15,0,-15
23152,0,0,30,0,-30
23153,1,0,56,0,-56
23154,0,0,226,0,-226
23155,1,1,496,1266,770
23156,0,0,290,0,-290
23157,1,0,9,0,-9
23158,0,0,86,0,-86
23159,1,0,68,0,-68
23160,1,1,91,1265,1174
23161,0,0,1,0,-1
23162,1,0,56,0,-56
23163,1,0,25,0,-25
23164,0,0,0,0,0
23165,1,1,901,1283,382
23166,1,1,146,1620,1474
23167,1,0,36,0,-36
23168,0,0,12,0,-12
23169,1,0,17,0,-17
23170,1,0,35,0,-35
23171,0,0,4,0,-4
23172,0,0,28,0,-28
23173,1,1,70,4359,4289
23174,0,0,51,0,-51
23175,1,0,63,0,-63
23176,1,0,0,0,0
23177,1,0,65,0,-65
23178,0,0,115,0,-115
23179,0,0,64,0,-64
23180,0,0,0,0,0
23181,1,0,8,0,-8
23182,1,1,599,1644,1045
23183,0,0,13,0,-13
23184,1,0,7,0,-7
23185,0,0,14,0,-14
23186,0,0,12,0,-12
23187,1,1,1246,1258,12
23188,1,0,18,0,-18
23189,0,0,1,0,-1
23190,1,1,466,1771,1305
23191,1,1,216,2062,1846
23192,1,0,16,0,-16
23193,0,0,22,0,-22
23194,0,0,21,0,-21
23195,1,0,34,0,-34
23196,0,0,37,0,-37
23197,0,0,4,0,-4
23198,1,0,20,0,-20
23199,1,0,9,0,-9
23200,1,1,78,1663,1585
23201,1,1,918,1506,588
23202,1,1,250,2787,2537
23203,0,0,19,0,-19
23204,1,0,77,0,-77
23205,1,0,32,0,-32
23206,1,1,253,1260,1007
23207,1,0,45,0,-45
23208,0,0,17,0,-17
23209,1,1,883,1887,1004
23210,1,1,190,1485,1295
23211,1,1,352,1276,924
23212,0,0,178,0,-178
23213,1,1,89,1411,1322
23214,0,0,89,0,-89
23215,1,1,409,1746,1337
23216,0,0,0,0,0
23217,1,1,145,1380,1235
23218,0,0,80,0,-80
23219,0,0,28,0,-28
23220,0,0,26,0,-26
23221,1,1,9,3476,3467
23222,0,0,161,0,-161
23223,1,1,255,1241,986
23224,1,0,8,0,-8
23225,1,1,824,14972,14148
23226,1,0,116,0,-116
23227,1,1,1002,1397,395
23228,0,0,32,0,-32
23229,1,1,306,1364,1058
23230,1,0,1,0,-1
23231,1,0,38,0,-38
23232,0,0,26,0,-26
23233,1,1,408,1461,1053
23234,0,0,39,0,-39
23235,1,0,28,0,-28
23236,1,1,1012,1585,573
23237,0,0,8,0,-8
23238,0,0,42,0,-42
23239,0,0,55,0,-55
23240,0,0,24,0,-24
23241,0,0,76,0,-76
23242,1,0,59,0,-59
23243,1,1,262,1360,1098
23244,1,1,107,1328,1221
23245,1,1,109,1389,1280
23246,0,0,31,0,-31
23247,0,0,109,0,-109
23248,1,1,301,1355,1054
23249,0,0,44,0,-44
23250,1,1,59,1425,1366
23251,1,0,284,0,-284
23252,1,0,29,0,-29
23253,0,0,202,0,-202
23254,0,0,29,0,-29
23255,1,0,37,0,-37
23256,1,0,11,0,-11
23257,0,0,76,0,-76
23258,1,1,117,1403,1286
23259,1,1,573,1538,965
23260,1,0,14,0,-14
23261,0,0,83,0,-83
23262,1,0,59,0,-59
23263,0,0,293,0,-293
23264,1,1,120,1946,1826
23265,0,0,40,0,-40
23266,1,0,147,0,-147
23267,0,0,16,0,-16
23268,1,1,117,1697,1580
23269,1,0,44,0,-44
23270,1,1,217,3325,3108
23271,0,0,56,0,-56
23272,0,0,1,0,-1
23273,1,0,9,0,-9
23274,1,0,159,0,-159
23275,1,0,2,0,-2
23276,0,0,23,0,-23
23277,1,1,194,1653,1459
23278,0,0,25,0,-25
23279,1,0,74,0,-74
23280,1,0,28,0,-28
23281,0,0,1,0,-1
23282,0,0,88,0,-88
23283,0,0,28,0,-28
23284,0,0,23,0,-23
23285,1,0,38,0,-38
23286,1,1,562,1568,1006
23287,1,1,328,1202,874
23288,1,1,491,1214,723
23289,0,0,45,0,-45
23290,1,1,167,1376,1209
23291,1,0,97,0,-97
23292,1,0,54,0,-54
23293,0,0,29,0,-29
23294,1,0,10,0,-10
23295,0,0,65,0,-65
23296,0,0,44,0,-44
23297,0,0,0,0,0
23298,1,1,1121,1585,464
23299,1,1,321,1313,992
23300,0,0,131,0,-131
23301,1,0,5,0,-5
23302,0,0,31,0,-31
23303,0,0,4,0,-4
23304,1,1,517,1239,722
23305,0,0,48,0,-48
23306,1,0,75,0,-75
23307,0,0,6,0,-6
23308,0,0,85,0,-85
23309,1,1,1173,1227,54
23310,1,0,43,0,-43
23311,1,0,29,0,-29
23312,0,0,6,0,-6
23313,0,0,18,0,-18
23314,1,1,251,1378,1127
23315,1,1,130,3821,3691
23316,1,1,277,1302,1025
23317,1,0,2,0,-2
23318,1,1,485,1962,1477
23319,0,0,190,0,-190
23320,1,0,19,0,-19
23321,1,0,76,0,-76
23322,1,1,158,1536,1378
23323,1,1,536,1266,730
23324,1,1,125,1646,1521
23325,0,0,5,0,-5
23326,0,0,16,0,-16
23327,1,0,7,0,-7
23328,1,0,163,0,-163
23329,1,1,61,1240,1179
23330,1,0,152,0,-152
23331,1,1,348,1564,1216
23332,1,0,18,0,-18
23333,1,0,16,0,-16
23334,1,0,20,0,-20
23335,1,0,29,0,-29
23336,1,0,9,0,-9
23337,0,0,136,0,-136
23338,1,0,0,0,0
23339,1,1,307,1515,1208
23340,1,1,263,1612,1349
23341,0,0,0,0,0
23342,1,1,842,1220,378
23343,1,1,14,1223,1209
23344,1,0,34,0,-34
23345,1,1,495,1253,758
23346,1,1,1331,1399,68
23347,1,0,0,0,0
23348,1,0,69,0,-69
23349,1,0,2,0,-2
23350,1,0,4,0,-4
23351,1,0,0,0,0
23352,1,1,238,2516,2278
23353,0,0,43,0,-43
23354,1,0,71,0,-71
23355,1,1,337,2551,2214
23356,0,0,140,0,-140
23357,1,1,1466,1455,-11
23358,0,0,12,0,-12
23359,0,0,211,0,-211
23360,0,0,43,0,-43
23361,0,0,9,0,-9
23362,1,1,70,1382,1312
23363,0,0,33,0,-33
23364,1,1,171,1406,1235
23365,1,0,58,0,-58
23366,0,0,49,0,-49
23367,0,0,0,0,0
23368,0,0,5,0,-5
23369,1,0,71,0,-71
23370,0,0,58,0,-58
23371,1,0,24,0,-24
23372,0,0,2,0,-2
23373,0,0,16,0,-16
23374,1,0,5,0,-5
23375,1,1,1824,1202,-622
23376,0,0,0,0,0
23377,1,1,787,2177,1390
23378,0,0,73,0,-73
23379,0,0,21,0,-21
23380,0,0,73,0,-73
23381,0,0,22,0,-22
23382,1,0,100,0,-100
23383,0,0,23,0,-23
23384,0,0,18,0,-18
23385,1,1,422,1361,939
23386,1,1,87,1824,1737
23387,1,1,1323,1411,88
23388,1,0,18,0,-18
23389,0,0,5,0,-5
23390,1,0,282,0,-282
23391,0,0,257,0,-257
23392,0,0,41,0,-41
23393,1,1,117,1356,1239
23394,1,0,38,0,-38
23395,0,0,44,0,-44
23396,0,0,11,0,-11
23397,1,1,751,1515,764
23398,0,0,18,0,-18
23399,0,0,130,0,-130
23400,1,0,32,0,-32
23401,1,0,76,0,-76
23402,0,0,38,0,-38
23403,1,1,332,1987,1655
23404,1,1,260,1226,966
23405,1,1,376,1337,961
23406,0,0,7,0,-7
23407,1,1,708,2113,1405
23408,1,0,46,0,-46
23409,1,1,886,1395,509
23410,0,0,116,0,-116
23411,1,1,156,1265,1109
23412,0,0,16,0,-16
23413,0,0,81,0,-81
23414,1,0,5,0,-5
23415,0,0,28,0,-28
23416,1,0,200,0,-200
23417,1,1,125,1494,1369
23418,1,1,88,2402,2314
23419,0,0,49,0,-49
23420,0,0,48,0,-48
23421,1,0,13,0,-13
23422,1,0,16,0,-16
23423,1,0,8,0,-8
23424,1,1,71,1326,1255
23425,1,0,4,0,-4
23426,0,0,103,0,-103
23427,0,0,72,0,-72
23428,1,1,80,1413,1333
23429,1,1,50,1273,1223
23430,1,0,90,0,-90
23431,1,1,412,1379,967
23432,0,0,10,0,-10
23433,1,0,176,0,-176
23434,1,1,349,1396,1047
23435,0,0,24,0,-24
23436,1,0,102,0,-102
23437,1,0,152,0,-152
23438,1,0,4,0,-4
23439,0,0,11,0,-11
23440,0,0,67,0,-67
23441,1,0,198,0,-198
23442,1,1,654,1786,1132
23443,0,0,74,0,-74
23444,0,0,42,0,-42
23445,1,1,77,2159,2082
23446,1,0,63,0,-63
23447,1,0,59,0,-59
23448,1,1,382,1830,1448
23449,1,1,320,1939,1619
23450,0,0,17,0,-17
23451,1,1,487,1356,869
23452,0,0,14,0,-14
23453,0,0,3,0,-3
23454,1,1,381,1765,1384
23455,1,0,17,0,-17
23456,0,0,18,0,-18
23457,1,1,57,2329,2272
23458,0,0,158,0,-158
23459,0,0,7,0,-7
23460,1,1,85,1362,1277
23461,1,0,11,0,-11
23462,1,0,20,0,-20
23463,0,0,61,0,-61
23464,0,0,68,0,-68
23465,1,0,6,0,-6
23466,1,1,302,1372,1070
23467,1,1,214,1345,1131
23468,1,0,40,0,-40
23469,1,0,268,0,-268
23470,0,0,96,0,-96
23471,1,0,10,0,-10
23472,1,1,193,1482,1289
23473,0,0,108,0,-108
23474,1,0,70,0,-70
23475,1,1,3074,1498,-1576
23476,1,0,30,0,-30
23477,1,0,19,0,-19
23478,1,1,118,1552,1434
23479,1,1,919,1431,512
23480,1,1,1229,1743,514
23481,1,0,31,0,-31
23482,1,0,18,0,-18
23483,1,1,353,3213,2860
23484,0,0,3,0,-3
23485,1,0,45,0,-45
23486,1,1,76,1340,1264
23487,1,0,3,0,-3
23488,1,1,1537,1782,245
23489,1,0,41,0,-41
23490,1,1,114,1420,1306
23491,1,0,99,0,-99
23492,1,1,384,1278,894
23493,0,0,26,0,-26
23494,0,0,6,0,-6
23495,1,0,104,0,-104
23496,0,0,84,0,-84
23497,0,0,0,0,0
23498,1,1,153,1767,1614
23499,1,0,0,0,0
23500,1,0,25,0,-25
23501,1,1,1009,1260,251
23502,1,0,2,0,-2
23503,1,1,138,1461,1323
23504,1,1,159,2403,2244
23505,1,0,186,0,-186
23506,0,0,52,0,-52
23507,1,1,687,1354,667
23508,1,0,85,0,-85
23509,1,0,63,0,-63
23510,1,1,885,2237,1352
23511,1,0,41,0,-41
23512,0,0,7,0,-7
23513,0,0,29,0,-29
23514,1,1,217,1905,1688
23515,0,0,1,0,-1
23516,1,0,7,0,-7
23517,1,1,1635,2012,377
23518,0,0,50,0,-50
23519,0,0,48,0,-48
23520,0,0,53,0,-53
23521,1,1,27,1270,1243
23522,1,1,929,1450,521
23523,0,0,84,0,-84
23524,1,0,36,0,-36
23525,0,0,31,0,-31
23526,0,0,72,0,-72
23527,1,1,312,1381,1069
23528,1,0,26,0,-26
23529,1,1,1453,3883,2430
23530,1,1,100,1421,1321
23531,0,0,102,0,-102
23532,1,1,327,1235,908
23533,0,0,14,0,-14
23534,1,1,864,1200,336
23535,1,0,3,0,-3
23536,1,0,21,0,-21
23537,1,1,1260,1280,20
23538,1,0,86,0,-86
23539,0,0,4,0,-4
23540,1,0,6,0,-6
23541,0,0,27,0,-27
23542,0,0,28,0,-28
23543,0,0,38,0,-38
23544,1,0,111,0,-111
23545,1,0,96,0,-96
23546,1,1,1598,1372,-226
23547,1,1,234,1463,1229
23548,1,1,30,1340,1310
23549,1,0,74,0,-74
23550,0,0,66,0,-66
23551,1,0,10,0,-10
23552,1,0,56,0,-56
23553,1,0,33,0,-33
23554,0,0,70,0,-70
23555,1,1,345,2418,2073
23556,1,0,22,0,-22
23557,1,0,2,0,-2
23558,1,1,439,4120,3681
23559,1,1,755,1555,800
23560,1,0,15,0,-15
23561,0,0,6,0,-6
23562,0,0,43,0,-43
23563,1,0,61,0,-61
23564,1,1,594,1254,660
23565,1,0,67,0,-67
23566,1,1,446,1842,1396
23567,0,0,9,0,-9
23568,1,1,269,1208,939
23569,1,0,10,0,-10
23570,1,1,410,3658,3248
23571,0,0,113,0,-113
23572,0,0,54,0,-54
23573,1,0,89,0,-89
23574,1,0,26,0,-26
23575,0,0,67,0,-67
23576,0,0,29,0,-29
23577,0,0,53,0,-53
23578,0,0,62,0,-62
23579,0,0,13,0,-13
23580,0,0,34,0,-34
23581,0,0,209,0,-209
23582,1,1,302,1544,1242
23583,1,0,84,0,-84
23584,1,1,182,1459,1277
23585,1,1,518,2433,1915
23586,0,0,0,0,0
23587,1,1,939,3334,2395
23588,1,0,47,0,-47
23589,0,0,77,0,-77
23590,1,0,29,0,-29
23591,1,1,192,1245,1053
23592,0,0,51,0,-51
23593,1,1,201,1649,1448
23594,1,1,360,1642,1282
23595,0,0,33,0,-33
23596,0,0,61,0,-61
23597,0,0,79,0,-79
23598,0,0,71,0,-71
23599,0,0,109,0,-109
23600,1,0,1,0,-1
23601,1,1,225,1665,1440
23602,0,0,2,0,-2
23603,1,0,70,0,-70
23604,0,0,33,0,-33
23605,0,0,25,0,-25
23606,1,0,45,0,-45
23607,0,0,30,0,-30
23608,0,0,64,0,-64
23609,0,0,33,0,-33
23610,1,0,4,0,-4
23611,0,0,3,0,-3
23612,0,0,112,0,-112
23613,0,0,102,0,-102
23614,0,0,11,0,-11
23615,1,0,13,0,-13
23616,0,0,29,0,-29
23617,0,0,6,0,-6
23618,1,1,575,1297,722
23619,0,0,13,0,-13
23620,1,0,10,0,-10
23621,0,0,148,0,-148
23622,0,0,34,0,-34
23623,0,0,149,0,-149
23624,1,0,34,0,-34
23625,1,1,39,1310,1271
23626,1,1,829,1325,496
23627,0,0,2,0,-2
23628,1,1,481,2302,1821
23629,1,0,4,0,-4
23630,1,1,622,2677,2055
23631,0,0,6,0,-6
23632,0,0,80,0,-80
23633,1,0,40,0,-40
23634,0,0,8,0,-8
23635,0,0,34,0,-34
23636,0,0,65,0,-65
23637,1,1,352,1455,1103
23638,1,1,310,2517,2207
23639,0,0,53,0,-53
23640,1,0,2,0,-2
23641,1,1,633,1266,633
23642,1,1,58,1250,1192
23643,1,0,87,0,-87
23644,1,0,3,0,-3
23645,0,0,79,0,-79
23646,0,0,11,0,-11
23647,1,0,22,0,-22
23648,1,0,20,0,-20
23649,0,0,38,0,-38
23650,0,0,90,0,-90
23651,1,0,64,0,-64
23652,1,0,7,0,-7
23653,1,0,54,0,-54
23654,0,0,157,0,-157
23655,1,0,40,0,-40
23656,1,0,133,0,-133
23657,0,0,28,0,-28
23658,0,0,16,0,-16
23659,1,1,1379,1347,-32
23660,1,1,186,1560,1374
23661,0,0,48,0,-48
23662,1,0,30,0,-30
23663,1,0,49,0,-49
23664,1,1,519,1361,842
23665,1,0,41,0,-41
23666,0,0,39,0,-39
23667,0,0,22,0,-22
23668,1,1,83,1279,1196
23669,0,0,154,0,-154
23670,1,0,18,0,-18
23671,0,0,119,0,-119
23672,1,0,71,0,-71
23673,0,0,17,0,-17
23674,1,1,134,1469,1335
23675,0,0,53,0,-53
23676,1,0,85,0,-85
23677,1,0,5,0,-5
23678,1,0,27,0,-27
23679,1,1,285,1221,936
23680,1,1,634,1430,796
23681,1,1,1014,2304,1290
23682,0,0,36,0,-36
23683,0,0,15,0,-15
23684,1,1,3168,1540,-1628
23685,1,0,6,0,-6
23686,1,1,310,1962,1652
23687,1,1,26,1398,1372
23688,1,1,326,1486,1160
23689,0,0,29,0,-29
23690,0,0,65,0,-65
23691,1,0,65,0,-65
23692,1,1,338,1266,928
23693,0,0,5,0,-5
23694,0,0,15,0,-15
23695,1,0,56,0,-56
23696,1,0,34,0,-34
23697,1,1,19,1306,1287
23698,1,1,662,1317,655
23699,0,0,15,0,-15
23700,1,0,27,0,-27
23701,0,0,29,0,-29
23702,0,0,91,0,-91
23703,1,1,25,1806,1781
23704,1,0,65,0,-65
23705,1,0,7,0,-7
23706,1,0,125,0,-125
23707,0,0,89,0,-89
23708,0,0,76,0,-76
23709,1,0,61,0,-61
23710,1,0,86,0,-86
23711,1,1,113,1750,1637
23712,1,1,931,1279,348
23713,1,1,457,1380,923
23714,1,0,59,0,-59
23715,1,0,54,0,-54
23716,0,0,66,0,-66
23717,0,0,16,0,-16
23718,0,0,1,0,-1
23719,1,0,150,0,-150
23720,0,0,129,0,-129
23721,1,1,420,1960,1540
23722,1,0,40,0,-40
23723,1,1,75,1467,1392
23724,0,0,27,0,-27
23725,0,0,3,0,-3
23726,0,0,35,0,-35
23727,1,0,114,0,-114
23728,0,0,97,0,-97
23729,1,1,734,1248,514
23730,1,1,306,1480,1174
23731,1,1,470,1306,836
23732,1,0,32,0,-32
23733,0,0,16,0,-16
23734,0,0,62,0,-62
23735,1,0,22,0,-22
23736,0,0,9,0,-9
23737,1,1,607,1803,1196
23738,1,1,61,1216,1155
23739,1,1,92,1202,1110
23740,1,0,22,0,-22
23741,1,0,78,0,-78
23742,0,0,11,0,-11
23743,1,1,873,1252,379
23744,1,0,84,0,-84
23745,1,0,17,0,-17
23746,0,0,1,0,-1
23747,1,1,321,1253,932
23748,1,1,1261,1525,264
23749,1,1,537,1278,741
23750,0,0,4,0,-4
23751,1,0,89,0,-89
23752,0,0,129,0,-129
23753,0,0,83,0,-83
23754,1,0,5,0,-5
23755,1,1,824,1467,643
23756,0,0,60,0,-60
23757,1,1,622,1928,1306
23758,0,0,6,0,-6
23759,0,0,92,0,-92
23760,0,0,194,0,-194
23761,1,1,1348,1232,-116
23762,0,0,138,0,-138
23763,1,0,191,0,-191
23764,0,0,90,0,-90
23765,1,1,190,1725,1535
23766,1,0,51,0,-51
23767,0,0,11,0,-11
23768,1,0,1,0,-1
23769,1,0,154,0,-154
23770,0,0,19,0,-19
23771,0,0,8,0,-8
23772,1,0,38,0,-38
23773,0,0,20,0,-20
23774,1,0,83,0,-83
23775,1,1,1941,1569,-372
23776,0,0,89,0,-89
23777,1,0,55,0,-55
23778,1,1,1618,1771,153
23779,0,0,19,0,-19
23780,1,0,58,0,-58
23781,1,1,133,1326,1193
23782,1,1,347,1564,1217
23783,1,0,37,0,-37
23784,0,0,165,0,-165
23785,0,0,12,0,-12
23786,1,0,23,0,-23
23787,1,1,1190,1815,625
23788,0,0,99,0,-99
23789,1,0,42,0,-42
23790,1,1,180,1363,1183
23791,1,1,58,1347,1289
23792,0,0,44,0,-44
23793,1,0,41,0,-41
23794,0,0,11,0,-11
23795,1,1,40,1296,1256
23796,0,0,46,0,-46
23797,1,0,13,0,-13
23798,1,1,485,2666,2181
23799,1,0,51,0,-51
23800,0,0,13,0,-13
23801,1,1,117,1701,1584
23802,1,0,77,0,-77
23803,1,1,426,1369,943
23804,1,0,51,0,-51
23805,1,0,19,0,-19
23806,0,0,24,0,-24
23807,0,0,7,0,-7
23808,0,0,34,0,-34
23809,1,0,4,0,-4
23810,1,1,1232,1283,51
23811,0,0,157,0,-157
23812,0,0,85,0,-85
23813,0,0,118,0,-118
23814,0,0,28,0,-28
23815,0,0,18,0,-18
23816,1,0,66,0,-66
23817,1,1,943,1641,698
23818,1,1,677,2168,1491
23819,1,1,302,1369,1067
23820,0,0,43,0,-43
23821,1,0,2,0,-2
23822,0,0,125,0,-125
23823,1,1,548,1296,748
23824,0,0,61,0,-61
23825,0,0,23,0,-23
23826,1,0,22,0,-22
23827,1,0,44,0,-44
23828,0,0,55,0,-55
23829,1,0,36,0,-36
23830,1,0,54,0,-54
23831,1,0,95,0,-95
23832,1,0,15,0,-15
23833,1,0,25,0,-25
23834,1,1,67,1628,1561
23835,1,0,30,0,-30
23836,0,0,33,0,-33
23837,1,1,134,1952,1818
23838,1,0,45,0,-45
23839,1,0,26,0,-26
23840,1,1,116,1557,1441
23841,1,1,267,1855,1588
23842,1,1,208,1643,1435
23843,1,0,71,0,-71
23844,1,0,0,0,0
23845,0,0,33,0,-33
23846,1,1,537,1304,767
23847,1,0,35,0,-35
23848,0,0,20,0,-20
23849,1,1,2001,1319,-682
23850,0,0,24,0,-24
23851,0,0,39,0,-39
23852,1,0,90,0,-90
23853,0,0,60,0,-60
23854,1,0,11,0,-11
23855,1,1,273,1319,1046
23856,1,1,236,3663,3427
23857,1,0,37,0,-37
23858,1,0,43,0,-43
23859,1,1,140,1234,1094
23860,0,0,24,0,-24
23861,1,0,20,0,-20
23862,1,0,19,0,-19
23863,1,1,410,1609,1199
23864,0,0,12,0,-12
23865,1,0,50,0,-50
23866,1,1,2079,1383,-696
23867,1,0,80,0,-80
23868,1,1,378,1276,898
23869,1,1,603,1539,936
23870,1,1,1000,1277,277
23871,0,0,3,0,-3
23872,1,1,373,1494,1121
23873,1,0,82,0,-82
23874,0,0,133,0,-133
23875,0,0,6,0,-6
23876,1,0,42,0,-42
23877,1,1,137,1491,1354
23878,1,0,161,0,-161
23879,1,0,27,0,-27
23880,1,1,1228,1460,232
23881,1,1,132,1509,1377
23882,1,1,575,1502,927
23883,1,0,43,0,-43
23884,1,1,676,1324,648
23885,1,0,4,0,-4
23886,1,0,100,0,-100
23887,1,0,114,0,-114
23888,0,0,35,0,-35
23889,0,0,9,0,-9
23890,0,0,33,0,-33
23891,1,0,4,0,-4
23892,1,0,44,0,-44
23893,1,1,495,1242,747
23894,1,0,61,0,-61
23895,1,1,349,1751,1402
23896,1,0,9,0,-9
23897,0,0,37,0,-37
23898,1,0,3,0,-3
23899,1,0,17,0,-17
23900,1,0,58,0,-58
23901,0,0,86,0,-86
23902,1,1,427,2152,1725
23903,1,0,120,0,-120
23904,1,1,675,1239,564
23905,0,0,58,0,-58
23906,1,0,15,0,-15
23907,1,0,41,0,-41
23908,1,1,293,1691,1398
23909,0,0,26,0,-26
23910,0,0,77,0,-77
23911,0,0,7,0,-7
23912,1,0,94,0,-94
23913,0,0,22,0,-22
23914,1,1,48,1448,1400
23915,0,0,46,0,-46
23916,1,1,545,1327,782
23917,1,1,1194,1891,697
23918,0,0,13,0,-13
23919,0,0,5,0,-5
23920,1,1,836,2499,1663
23921,0,0,16,0,-16
23922,1,0,92,0,-92
23923,1,1,184,1293,1109
23924,0,0,100,0,-100
23925,0,0,19,0,-19
23926,0,0,46,0,-46
23927,0,0,51,0,-51
23928,1,1,136,1798,1662
23929,1,0,5,0,-5
23930,0,0,69,0,-69
23931,0,0,32,0,-32
23932,0,0,15,0,-15
23933,0,0,10,0,-10
23934,1,1,1169,1446,277
23935,0,0,29,0,-29
23936,1,0,87,0,-87
23937,1,0,103,0,-103
23938,1,0,26,0,-26
23939,0,0,7,0,-7
23940,1,0,56,0,-56
23941,1,1,581,1552,971
23942,1,1,479,1510,1031
23943,0,0,96,0,-96
23944,0,0,17,0,-17
23945,1,1,85,1309,1224
23946,1,0,44,0,-44
23947,0,0,60,0,-60
23948,1,0,160,0,-160
23949,1,1,2001,1524,-477
23950,1,1,397,1743,1346
23951,1,1,197,1277,1080
23952,0,0,40,0,-40
23953,1,0,7,0,-7
23954,1,0,16,0,-16
23955,0,0,65,0,-65
23956,0,0,9,0,-9
23957,1,1,149,1593,1444
23958,1,1,768,1278,510
23959,0,0,127,0,-127
23960,1,1,922,1205,283
23961,0,0,54,0,-54
23962,1,1,283,1220,937
23963,1,0,8,0,-8
23964,1,1,273,1888,1615
23965,1,1,351,1347,996
23966,0,0,28,0,-28
23967,1,1,232,1272,1040
23968,0,0,47,0,-47
23969,0,0,27,0,-27
23970,0,0,34,0,-34
23971,1,1,289,1311,1022
23972,0,0,31,0,-31
23973,1,0,11,0,-11
23974,0,0,11,0,-11
23975,1,1,113,1510,1397
23976,1,1,834,1659,825
23977,1,0,6,0,-6
23978,0,0,27,0,-27
23979,1,1,1541,1456,-85
23980,1,1,954,1234,280
23981,1,0,12,0,-12
23982,1,0,9,0,-9
23983,1,1,723,1797,1074
23984,1,1,458,1245,787
23985,0,0,117,0,-117
23986,1,0,14,0,-14
23987,0,0,86,0,-86
23988,1,1,144,1339,1195
23989,0,0,18,0,-18
23990,0,0,54,0,-54
23991,1,1,34,1597,1563
23992,1,1,455,1447,992
23993,1,1,480,1274,794
23994,0,0,35,0,-35
23995,1,1,152,1358,1206
23996,1,1,504,1332,828
23997,1,0,98,0,-98
23998,1,0,108,0,-108
23999,1,1,476,1451,975
24000,1,1,405,1317,912
24001,1,1,131,1214,1083
24002,1,0,122,0,-122
24003,0,0,34,0,-34
24004,0,0,52,0,-52
24005,1,0,4,0,-4
24006,0,0,53,0,-53
24007,0,0,81,0,-81
24008,1,0,132,0,-132
24009,1,0,130,0,-130
24010,1,0,0,0,0
24011,0,0,96,0,-96
24012,1,1,293,1941,1648
24013,0,0,40,0,-40
24014,0,0,91,0,-91
24015,0,0,226,0,-226
24016,1,1,453,1906,1453
24017,1,1,390,1565,1175
24018,1,1,780,1303,523
24019,1,0,14,0,-14
24020,1,0,60,0,-60
24021,0,0,88,0,-88
24022,1,1,611,1495,884
24023,0,0,293,0,-293
24024,0,0,28,0,-28
24025,1,1,93,1338,1245
24026,0,0,113,0,-113
24027,0,0,5,0,-5
24028,0,0,57,0,-57
24029,1,1,897,1626,729
24030,0,0,136,0,-136
24031,1,0,16,0,-16
24032,0,0,53,0,-53
24033,0,0,30,0,-30
24034,0,0,66,0,-66
24035,1,0,2,0,-2
24036,1,0,120,0,-120
24037,0,0,185,0,-185
24038,1,0,78,0,-78
24039,1,0,104,0,-104
24040,1,1,464,1295,831
24041,1,0,11,0,-11
24042,1,1,594,1243,649
24043,0,0,6,0,-6
24044,1,1,123,1812,1689
24045,1,1,419,1221,802
24046,0,0,126,0,-126
24047,1,0,142,0,-142
24048,0,0,132,0,-132
24049,1,1,122,1550,1428
24050,1,1,219,1721,1502
24051,0,0,0,0,0
24052,1,1,69,1471,1402
24053,1,0,18,0,-18
24054,1,1,678,1636,958
24055,0,0,5,0,-5
24056,1,1,968,1219,251
24057,0,0,98,0,-98
24058,1,1,134,1350,1216
24059,1,1,298,1233,935
24060,1,0,22,0,-22
24061,0,0,1,0,-1
24062,1,0,1,0,-1
24063,1,0,53,0,-53
24064,1,1,1567,1802,235
24065,0,0,23,0,-23
24066,1,0,166,0,-166
24067,1,1,1220,1368,148
24068,0,0,9,0,-9
24069,1,1,327,1260,933
24070,0,0,164,0,-164
24071,1,0,32,0,-32
24072,0,0,62,0,-62
24073,0,0,74,0,-74
24074,0,0,4,0,-4
24075,0,0,109,0,-109
24076,0,0,8,0,-8
24077,1,1,1626,2395,769
24078,1,1,1074,1501,427
24079,1,0,21,0,-21
24080,1,1,208,1312,1104
24081,1,0,47,0,-47
24082,1,1,28,2741,2713
24083,0,0,54,0,-54
24084,1,1,726,2411,1685
24085,0,0,19,0,-19
24086,0,0,9,0,-9
24087,1,1,344,1651,1307
24088,1,1,843,1201,358
24089,0,0,84,0,-84
24090,1,0,18,0,-18
24091,1,1,143,1571,1428
24092,0,0,8,0,-8
24093,0,0,92,0,-92
24094,1,0,13,0,-13
24095,0,0,1,0,-1
24096,0,0,36,0,-36
24097,1,0,52,0,-52
24098,0,0,66,0,-66
24099,0,0,40,0,-40
24100,1,1,544,1963,1419
24101,1,1,75,2099,2024
24102,1,1,705,1343,638
24103,1,1,218,1589,1371
24104,1,1,707,1751,1044
24105,0,0,56,0,-56
24106,1,1,192,1563,1371
24107,0,0,169,0,-169
24108,1,0,25,0,-25
24109,1,1,1145,1205,60
24110,0,0,18,0,-18
24111,0,0,21,0,-21
24112,1,0,6,0,-6
24113,0,0,108,0,-108
24114,0,0,32,0,-32
24115,1,1,56,1300,1244
24116,0,0,42,0,-42
24117,1,0,107,0,-107
24118,0,0,19,0,-19
24119,0,0,1,0,-1
24120,0,0,70,0,-70
24121,0,0,67,0,-67
24122,1,0,9,0,-9
24123,0,0,26,0,-26
24124,1,1,593,1364,771
24125,0,0,0,0,0
24126,0,0,47,0,-47
24127,1,0,32,0,-32
24128,1,1,695,1284,589
24129,1,1,836,1280,444
24130,1,0,86,0,-86
24131,0,0,63,0,-63
24132,1,1,942,2239,1297
24133,0,0,21,0,-21
24134,1,1,79,1372,1293
24135,1,1,1245,1408,163
24136,0,0,56,0,-56
24137,1,0,31,0,-31
24138,0,0,18,0,-18
24139,1,0,14,0,-14
24140,1,1,2532,1392,-1140
24141,1,1,2070,1203,-867
24142,0,0,50,0,-50
24143,0,0,109,0,-109
24144,1,0,1,0,-1
24145,1,0,11,0,-11
24146,0,0,47,0,-47
24147,1,0,159,0,-159
24148,1,1,1160,1376,216
24149,1,0,12,0,-12
24150,0,0,58,0,-58
24151,0,0,39,0,-39
24152,0,0,13,0,-13
24153,1,1,103,2051,1948
24154,1,1,108,1369,1261
24155,1,0,160,0,-160
24156,0,0,7,0,-7
24157,0,0,24,0,-24
24158,0,0,37,0,-37
24159,1,0,5,0,-5
24160,0,0,77,0,-77
24161,1,1,170,1270,1100
24162,0,0,32,0,-32
24163,1,0,58,0,-58
24164,1,1,104,2023,1919
24165,1,0,23,0,-23
24166,1,0,55,0,-55
24167,0,0,31,0,-31
24168,1,1,264,1214,950
24169,1,0,119,0,-119
24170,0,0,30,0,-30
24171,1,0,40,0,-40
24172,0,0,50,0,-50
24173,0,0,114,0,-114
24174,1,1,214,1287,1073
24175,1,1,67,1696,1629
24176,0,0,106,0,-106
24177,1,1,408,1447,1039
24178,1,1,239,1261,1022
24179,0,0,79,0,-79
24180,1,0,22,0,-22
24181,1,1,751,1554,803
24182,1,0,51,0,-51
24183,1,0,23,0,-23
24184,1,0,75,0,-75
24185,0,0,78,0,-78
24186,0,0,23,0,-23
24187,0,0,51,0,-51
24188,0,0,34,0,-34
24189,1,1,61,1396,1335
24190,1,0,87,0,-87
24191,1,0,17,0,-17
24192,0,0,20,0,-20
24193,1,0,155,0,-155
24194,1,1,374,1254,880
24195,1,1,1548,1263,-285
24196,0,0,178,0,-178
24197,1,0,6,0,-6
24198,1,0,108,0,-108
24199,0,0,112,0,-112
24200,0,0,70,0,-70
24201,0,0,75,0,-75
24202,0,0,72,0,-72
24203,1,0,22,0,-22
24204,1,0,178,0,-178
24205,1,1,239,1347,1108
24206,0,0,8,0,-8
24207,1,1,219,1460,1241
24208,1,0,59,0,-59
24209,1,0,59,0,-59
24210,0,0,36,0,-36
24211,0,0,51,0,-51
24212,1,0,131,0,-131
24213,1,1,155,1501,1346
24214,0,0,137,0,-137
24215,1,1,271,1210,939
24216,1,1,169,4437,4268
24217,0,0,108,0,-108
24218,1,0,24,0,-24
24219,1,0,24,0,-24
24220,0,0,59,0,-59
24221,1,0,42,0,-42
24222,0,0,7,0,-7
24223,0,0,78,0,-78
24224,0,0,4,0,-4
24225,1,0,21,0,-21
24226,0,0,15,0,-15
24227,0,0,20,0,-20
24228,1,1,400,1690,1290
24229,1,1,91,1359,1268
24230,0,0,3,0,-3
24231,0,0,276,0,-276
24232,1,0,39,0,-39
24233,0,0,10,0,-10
24234,1,1,747,1274,527
24235,1,0,6,0,-6
24236,1,0,94,0,-94
24237,1,1,583,1306,723
24238,0,0,25,0,-25
24239,1,1,532,1746,1214
24240,0,0,94,0,-94
24241,1,0,30,0,-30
24242,0,0,37,0,-37
24243,0,0,6,0,-6
24244,0,0,39,0,-39
24245,1,0,79,0,-79
24246,0,0,104,0,-104
24247,1,0,74,0,-74
24248,0,0,15,0,-15
24249,0,0,5,0,-5
24250,1,1,720,1880,1160
24251,0,0,50,0,-50
24252,1,1,386,1595,1209
24253,1,0,11,0,-11
24254,0,0,63,0,-63
24255,1,1,56,1631,1575
24256,1,1,137,3058,2921
24257,0,0,140,0,-140
24258,1,0,37,0,-37
24259,1,0,51,0,-51
24260,0,0,13,0,-13
24261,0,0,31,0,-31
24262,1,0,109,0,-109
24263,1,1,160,1579,1419
24264,0,0,51,0,-51
24265,0,0,46,0,-46
24266,0,0,27,0,-27
24267,1,1,517,1373,856
24268,1,0,46,0,-46
24269,1,1,305,1995,1690
24270,0,0,66,0,-66
24271,1,1,252,1438,1186
24272,1,0,72,0,-72
24273,1,0,57,0,-57
24274,1,1,311,1246,935
24275,1,0,68,0,-68
24276,0,0,11,0,-11
24277,1,0,8,0,-8
24278,1,0,13,0,-13
24279,1,1,258,1347,1089
24280,1,1,19,1237,1218
24281,1,1,230,1379,1149
24282,0,0,5,0,-5
24283,1,1,1322,1219,-103
24284,1,0,49,0,-49
24285,1,1,814,1968,1154
24286,0,0,110,0,-110
24287,1,1,936,1952,1016
24288,1,0,85,0,-85
24289,0,0,8,0,-8
24290,1,0,89,0,-89
24291,0,0,38,0,-38
24292,0,0,24,0,-24
24293,0,0,83,0,-83
24294,1,1,1491,1792,301
24295,0,0,34,0,-34
24296,1,1,951,1397,446
24297,1,1,738,1917,1179
24298,1,1,376,1213,837
24299,0,0,55,0,-55
24300,0,0,14,0,-14
24301,1,0,4,0,-4
24302,0,0,20,0,-20
24303,0,0,23,0,-23
24304,0,0,72,0,-72
24305,0,0,160,0,-160
24306,1,1,139,1250,1111
24307,0,0,6,0,-6
24308,1,1,1575,1333,-242
24309,0,0,0,0,0
24310,1,1,115,1933,1818
24311,1,1,1023,1694,671
24312,1,1,513,1260,747
24313,1,1,505,1366,861
24314,1,1,638,1249,611
24315,1,1,98,2929,2831
24316,1,0,63,0,-63
24317,1,0,76,0,-76
24318,1,1,399,1267,868
24319,1,1,205,1266,1061
24320,1,0,53,0,-53
24321,1,1,747,1285,538
24322,1,1,1152,1945,793
24323,1,0,25,0,-25
24324,1,0,55,0,-55
24325,1,0,70,0,-70
24326,1,1,148,1409,1261
24327,1,0,94,0,-94
24328,0,0,72,0,-72
24329,1,0,92,0,-92
24330,0,0,46,0,-46
24331,1,0,149,0,-149
24332,0,0,25,0,-25
24333,0,0,20,0,-20
24334,1,0,6,0,-6
24335,1,0,23,0,-23
24336,1,1,289,1581,1292
24337,1,1,372,1841,1469
24338,1,1,1268,1380,112
24339,1,0,4,0,-4
24340,0,0,8,0,-8
24341,0,0,4,0,-4
24342,1,1,501,1568,1067
24343,1,0,170,0,-170
24344,1,1,638,2747,2109
24345,0,0,27,0,-27
24346,1,1,268,1293,1025
24347,1,0,77,0,-77
24348,1,0,85,0,-85
24349,1,0,211,0,-211
24350,1,1,437,1636,1199
24351,1,0,34,0,-34
24352,1,1,1494,1984,490
24353,1,1,415,2206,1791
24354,0,0,32,0,-32
24355,0,0,24,0,-24
24356,1,0,92,0,-92
24357,1,1,277,1379,1102
24358,1,0,45,0,-45
24359,1,1,133,1390,1257
24360,1,1,448,2129,1681
24361,1,0,57,0,-57
24362,1,0,3,0,-3
24363,1,1,805,1542,737
24364,0,0,68,0,-68
24365,1,1,63,1399,1336
24366,1,1,653,1579,926
24367,1,1,134,1649,1515
24368,1,0,9,0,-9
24369,1,0,82,0,-82
24370,0,0,54,0,-54
24371,1,1,210,1239,1029
24372,0,0,11,0,-11
24373,1,1,220,1376,1156
24374,1,0,16,0,-16
24375,0,0,38,0,-38
24376,1,0,0,0,0
24377,1,1,611,1326,715
24378,0,0,150,0,-150
24379,1,1,670,1202,532
24380,1,1,681,1974,1293
24381,0,0,40,0,-40
24382,1,0,43,0,-43
24383,1,0,53,0,-53
24384,0,0,72,0,-72
24385,1,1,527,1248,721
24386,1,0,9,0,-9
24387,0,0,54,0,-54
24388,1,1,408,1444,1036
24389,1,1,1147,1315,168
24390,1,0,78,0,-78
24391,1,1,175,1305,1130
24392,0,0,33,0,-33
24393,0,0,25,0,-25
24394,0,0,23,0,-23
24395,0,0,5,0,-5
24396,1,1,445,1528,1083
24397,1,0,4,0,-4
24398,1,0,31,0,-31
24399,0,0,38,0,-38
24400,0,0,53,0,-53
24401,0,0,7,0,-7
24402,0,0,3,0,-3
24403,0,0,14,0,-14
24404,1,1,1767,1258,-509
24405,0,0,54,0,-54
24406,1,1,441,1522,1081
24407,1,0,16,0,-16
24408,1,1,376,1484,1108
24409,1,0,5,0,-5
24410,1,1,160,1533,1373
24411,1,1,127,1677,1550
24412,1,0,50,0,-50
24413,1,1,411,1358,947
24414,1,0,5,0,-5
24415,1,0,220,0,-220
24416,0,0,3,0,-3
24417,1,0,89,0,-89
24418,1,0,27,0,-27
24419,1,1,1054,1743,689
24420,0,0,114,0,-114
24421,1,0,83,0,-83
24422,0,0,30,0,-30
24423,1,1,885,1238,353
24424,1,1,844,1204,360
24425,0,0,38,0,-38
24426,0,0,38,0,-38
24427,1,1,571,1657,1086
24428,1,1,196,2435,2239
24429,1,0,147,0,-147
24430,0,0,97,0,-97
24431,0,0,80,0,-80
24432,0,0,66,0,-66
24433,1,0,144,0,-144
24434,1,0,32,0,-32
24435,0,0,50,0,-50
24436,0,0,37,0,-37
24437,1,0,169,0,-169
24438,1,1,418,1254,836
24439,1,0,4,0,-4
24440,1,1,1192,1349,157
24441,0,0,133,0,-133
24442,1,0,5,0,-5
24443,1,0,53,0,-53
24444,1,1,397,2583,2186
24445,0,0,58,0,-58
24446,1,1,124,1709,1585
24447,1,1,1432,4705,3273
24448,1,0,125,0,-125
24449,0,0,102,0,-102
24450,1,0,0,0,0
24451,1,1,99,1498,1399
24452,1,0,50,0,-50
24453,1,1,808,1747,939
24454,0,0,72,0,-72
24455,1,0,26,0,-26
24456,0,0,80,0,-80
24457,0,0,3,0,-3
24458,0,0,27,0,-27
24459,1,0,123,0,-123
24460,1,1,350,1325,975
24461,1,1,1015,1437,422
24462,1,1,465,1255,790
24463,0,0,81,0,-81
24464,1,0,10,0,-10
24465,1,0,199,0,-199
24466,1,1,1119,2060,941
24467,1,0,82,0,-82
24468,1,0,7,0,-7
24469,0,0,142,0,-142
24470,1,1,302,1441,1139
24471,1,1,68,1491,1423
24472,1,1,152,1424,1272
24473,0,0,28,0,-28
24474,1,1,1207,1239,32
24475,1,0,59,0,-59
24476,1,1,1172,1405,233
24477,0,0,44,0,-44
24478,1,1,690,1385,695
24479,1,1,553,1331,778
24480,0,0,66,0,-66
24481,0,0,442,0,-442
24482,1,1,517,1437,920
24483,1,1,286,1522,1236
24484,0,0,5,0,-5
24485,0,0,16,0,-16
24486,1,0,29,0,-29
24487,1,1,484,1246,762
24488,1,0,51,0,-51
24489,0,0,84,0,-84
24490,1,0,65,0,-65
24491,0,0,41,0,-41
24492,1,1,203,1381,1178
24493,0,0,141,0,-141
24494,1,1,203,1252,1049
24495,1,1,1182,1912,730
24496,1,0,102,0,-102
24497,1,0,104,0,-104
24498,1,1,608,1611,1003
24499,0,0,82,0,-82
24500,1,0,17,0,-17
24501,0,0,35,0,-35
24502,0,0,2,0,-2
24503,1,1,322,1614,1292
24504,1,0,23,0,-23
24505,0,0,152,0,-152
24506,1,1,435,1244,809
24507,0,0,78,0,-78
24508,1,0,48,0,-48
24509,0,0,136,0,-136
24510,0,0,101,0,-101
24511,1,0,53,0,-53
24512,1,1,731,1500,769
24513,0,0,17,0,-17
24514,1,1,464,1443,979
24515,1,0,46,0,-46
24516,1,0,77,0,-77
24517,0,0,23,0,-23
24518,1,1,95,1966,1871
24519,1,0,248,0,-248
24520,1,0,47,0,-47
24521,0,0,170,0,-170
24522,1,1,235,2408,2173
24523,1,1,1410,1247,-163
24524,0,0,51,0,-51
24525,1,0,25,0,-25
24526,0,0,24,0,-24
24527,0,0,16,0,-16
24528,0,0,19,0,-19
24529,1,0,101,0,-101
24530,1,0,50,0,-50
24531,1,1,368,1294,926
24532,0,0,116,0,-116
24533,0,0,46,0,-46
24534,1,1,1667,1517,-150
24535,1,0,51,0,-51
24536,0,0,62,0,-62
24537,1,1,135,1518,1383
24538,0,0,53,0,-53
24539,0,0,120,0,-120
24540,1,1,64,1485,1421
24541,0,0,7,0,-7
24542,1,1,420,1472,1052
24543,1,1,58,1585,1527
24544,0,0,0,0,0
24545,1,0,59,0,-59
24546,1,1,341,1357,1016
24547,1,0,49,0,-49
24548,1,1,146,1251,1105
24549,0,0,17,0,-17
24550,0,0,95,0,-95
24551,1,0,34,0,-34
24552,0,0,77,0,-77
24553,0,0,87,0,-87
24554,1,0,6,0,-6
24555,1,0,63,0,-63
24556,1,1,529,1712,1183
24557,0,0,15,0,-15
24558,0,0,62,0,-62
24559,1,1,754,1820,1066
24560,1,0,22,0,-22
24561,1,0,16,0,-16
24562,1,0,30,0,-30
24563,0,0,34,0,-34
24564,0,0,19,0,-19
24565,1,0,2,0,-2
24566,0,0,13,0,-13
24567,1,1,332,1827,1495
24568,1,0,68,0,-68
24569,0,0,35,0,-35
24570,1,1,478,1267,789
24571,0,0,19,0,-19
24572,1,0,187,0,-187
24573,0,0,100,0,-100
24574,0,0,21,0,-21
24575,0,0,16,0,-16
24576,0,0,7,0,-7
24577,0,0,125,0,-125
24578,0,0,95,0,-95
24579,0,0,20,0,-20
24580,1,0,4,0,-4
24581,1,1,1429,1218,-211
24582,1,0,42,0,-42
24583,0,0,1,0,-1
24584,1,0,22,0,-22
24585,1,0,16,0,-16
24586,0,0,1,0,-1
24587,1,0,72,0,-72
24588,1,1,472,2393,1921
24589,1,0,3,0,-3
24590,1,0,167,0,-167
24591,0,0,72,0,-72
24592,1,0,4,0,-4
24593,1,1,552,1656,1104
24594,1,1,507,2522,2015
24595,0,0,1,0,-1
24596,0,0,2,0,-2
24597,0,0,133,0,-133
24598,1,1,472,1687,1215
24599,1,0,3,0,-3
24600,0,0,10,0,-10
24601,1,1,808,1436,628
24602,1,0,41,0,-41
24603,1,1,745,1326,581
24604,1,0,24,0,-24
24605,1,1,153,1224,1071
24606,1,0,71,0,-71
24607,0,0,97,0,-97
24608,0,0,211,0,-211
24609,1,1,702,1225,523
24610,0,0,2,0,-2
24611,0,0,47,0,-47
24612,0,0,8,0,-8
24613,1,0,57,0,-57
24614,0,0,94,0,-94
24615,1,0,37,0,-37
24616,1,1,620,1511,891
24617,0,0,116,0,-116
24618,1,0,22,0,-22
24619,1,1,154,1233,1079
24620,1,1,2177,1685,-492
24621,1,0,12,0,-12
24622,0,0,57,0,-57
24623,1,1,258,2169,1911
24624,1,1,477,1338,861
24625,0,0,51,0,-51
24626,0,0,18,0,-18
24627,1,1,15,2135,2120
24628,1,1,517,1382,865
24629,1,0,79,0,-79
24630,0,0,30,0,-30
24631,1,1,504,1282,778
24632,1,0,40,0,-40
24633,0,0,180,0,-180
24634,1,0,11,0,-11
24635,0,0,174,0,-174
24636,1,0,45,0,-45
24637,1,0,7,0,-7
24638,1,0,70,0,-70
24639,1,0,155,0,-155
24640,1,0,38,0,-38
24641,1,0,20,0,-20
24642,1,1,432,1319,887
24643,1,1,106,1801,1695
24644,1,0,144,0,-144
24645,1,0,52,0,-52
24646,1,0,53,0,-53
24647,1,0,5,0,-5
24648,0,0,55,0,-55
24649,0,0,42,0,-42
24650,1,0,6,0,-6
24651,1,1,1042,1246,204
24652,1,1,102,1268,1166
24653,0,0,50,0,-50
24654,1,0,35,0,-35
24655,0,0,88,0,-88
24656,0,0,0,0,0
24657,1,0,55,0,-55
24658,1,1,115,1262,1147
24659,1,0,33,0,-33
24660,1,1,255,1331,1076
24661,1,1,51,1988,1937
24662,1,1,346,1218,872
24663,0,0,27,0,-27
24664,1,1,447,1594,1147
24665,1,0,17,0,-17
24666,0,0,37,0,-37
24667,0,0,32,0,-32
24668,0,0,17,0,-17
24669,0,0,56,0,-56
24670,1,0,3,0,-3
24671,1,1,206,1629,1423
24672,0,0,27,0,-27
24673,0,0,35,0,-35
24674,1,1,179,1996,1817
24675,1,0,50,0,-50
24676,1,1,470,2089,1619
24677,0,0,15,0,-15
24678,1,1,152,1696,1544
24679,1,1,535,1202,667
24680,0,0,52,0,-52
24681,1,1,288,1696,1408
24682,1,1,340,1495,1155
24683,1,1,809,2138,1329
24684,1,1,674,1722,1048
24685,1,1,217,2712,2495
24686,1,0,64,0,-64
24687,0,0,12,0,-12
24688,0,0,26,0,-26
24689,1,0,164,0,-164
24690,1,1,458,1576,1118
24691,1,1,50,1312,1262
24692,1,0,29,0,-29
24693,1,1,415,1282,867
24694,1,1,490,1478,988
24695,0,0,77,0,-77
24696,1,0,5,0,-5
24697,0,0,51,0,-51
24698,0,0,228,0,-228
24699,1,0,275,0,-275
24700,0,0,13,0,-13
24701,1,1,245,1282,1037
24702,1,0,1,0,-1
24703,1,0,62,0,-62
24704,1,0,59,0,-59
24705,1,1,521,1735,1214
24706,0,0,83,0,-83
24707,1,1,112,1775,1663
24708,0,0,21,0,-21
24709,1,1,246,1294,1048
24710,0,0,97,0,-97
24711,1,0,37,0,-37
24712,1,1,166,1530,1364
24713,0,0,8,0,-8
24714,1,0,42,0,-42
24715,1,0,156,0,-156
24716,1,0,3,0,-3
24717,0,0,61,0,-61
24718,1,0,42,0,-42
24719,0,0,40,0,-40
24720,1,1,601,2204,1603
24721,0,0,139,0,-139
24722,0,0,31,0,-31
24723,1,0,7,0,-7
24724,1,0,258,0,-258
24725,1,0,4,0,-4
24726,1,0,97,0,-97
24727,1,1,338,1711,1373
24728,0,0,1,0,-1
24729,1,0,214,0,-214
24730,1,0,22,0,-22
24731,1,0,75,0,-75
24732,1,0,7,0,-7
24733,1,0,7,0,-7
24734,0,0,82,0,-82
24735,0,0,135,0,-135
24736,0,0,66,0,-66
24737,0,0,57,0,-57
24738,0,0,12,0,-12
24739,1,1,249,1617,1368
24740,0,0,0,0,0
24741,1,0,59,0,-59
24742,1,1,233,1282,1049
24743,1,1,178,1311,1133
24744,1,1,366,2594,2228
24745,1,1,356,1459,1103
24746,1,1,746,1681,935
24747,1,0,51,0,-51
24748,1,1,834,1363,529
24749,0,0,24,0,-24
24750,1,0,81,0,-81
24751,1,1,1394,1317,-77
24752,0,0,10,0,-10
24753,1,1,268,1231,963
24754,1,0,60,0,-60
24755,0,0,18,0,-18
24756,1,1,94,1397,1303
24757,1,0,26,0,-26
24758,1,0,16,0,-16
24759,1,0,65,0,-65
24760,1,1,724,2131,1407
24761,0,0,71,0,-71
24762,1,1,95,2911,2816
24763,1,0,6,0,-6
24764,0,0,31,0,-31
24765,1,1,128,1517,1389
24766,1,0,5,0,-5
24767,1,1,1349,1516,167
24768,0,0,18,0,-18
24769,1,1,455,1728,1273
24770,1,1,305,4697,4392
24771,1,1,1100,2113,1013
24772,0,0,5,0,-5
24773,1,1,1228,1316,88
24774,1,0,63,0,-63
24775,1,1,1100,1391,291
24776,1,0,25,0,-25
24777,1,0,69,0,-69
24778,1,1,719,2342,1623
24779,1,0,30,0,-30
24780,0,0,32,0,-32
24781,1,0,42,0,-42
24782,0,0,196,0,-196
24783,1,1,274,1932,1658
24784,0,0,49,0,-49
24785,0,0,51,0,-51
24786,1,0,24,0,-24
24787,1,1,875,4134,3259
24788,1,0,37,0,-37
24789,1,1,22,1760,1738
24790,0,0,43,0,-43
24791,0,0,2,0,-2
24792,1,0,64,0,-64
24793,1,0,29,0,-29
24794,1,0,13,0,-13
24795,0,0,50,0,-50
24796,1,0,50,0,-50
24797,0,0,30,0,-30
24798,0,0,227,0,-227
24799,0,0,32,0,-32
24800,1,1,371,1268,897
24801,1,0,66,0,-66
24802,0,0,50,0,-50
24803,1,1,68,2111,2043
24804,0,0,12,0,-12
24805,1,0,80,0,-80
24806,1,0,10,0,-10
24807,0,0,32,0,-32
24808,0,0,7,0,-7
24809,1,1,162,1313,1151
24810,0,0,19,0,-19
24811,1,0,118,0,-118
24812,0,0,21,0,-21
24813,1,1,634,1579,945
24814,1,0,4,0,-4
24815,1,1,631,1821,1190
24816,1,1,211,1551,1340
24817,1,1,447,2632,2185
24818,0,0,56,0,-56
24819,0,0,16,0,-16
24820,1,0,7,0,-7
24821,1,1,260,1304,1044
24822,1,1,1068,1527,459
24823,0,0,140,0,-140
24824,0,0,88,0,-88
24825,1,0,24,0,-24
24826,1,0,72,0,-72
24827,0,0,7,0,-7
24828,0,0,39,0,-39
24829,0,0,21,0,-21
24830,0,0,65,0,-65
24831,0,0,61,0,-61
24832,1,1,753,1912,1159
24833,1,1,283,1258,975
24834,1,1,204,1443,1239
24835,1,0,21,0,-21
24836,1,1,1471,1529,58
24837,0,0,102,0,-102
24838,1,1,62,1241,1179
24839,0,0,79,0,-79
24840,1,0,26,0,-26
24841,1,1,878,1240,362
24842,0,0,128,0,-128
24843,1,1,1366,1605,239
24844,1,1,243,1644,1401
24845,0,0,34,0,-34
24846,1,1,277,2368,2091
24847,1,1,563,1677,1114
24848,0,0,37,0,-37
24849,0,0,75,0,-75
24850,0,0,94,0,-94
24851,1,1,453,1309,856
24852,1,0,271,0,-271
24853,1,0,69,0,-69
24854,0,0,48,0,-48
24855,1,1,311,1821,1510
24856,0,0,60,0,-60
24857,0,0,12,0,-12
24858,0,0,4,0,-4
24859,1,0,45,0,-45
24860,1,0,23,0,-23
24861,1,1,134,1200,1066
24862,0,0,130,0,-130
24863,1,0,140,0,-140
24864,1,1,2377,1677,-700
24865,0,0,11,0,-11
24866,1,1,2979,2330,-649
24867,1,1,633,2216,1583
24868,1,1,1025,1220,195
24869,1,1,453,1797,1344
24870,0,0,7,0,-7
24871,1,0,40,0,-40
24872,1,0,1,0,-1
24873,1,0,59,0,-59
24874,1,0,4,0,-4
24875,1,0,47,0,-47
24876,1,0,56,0,-56
24877,1,0,6,0,-6
24878,1,0,58,0,-58
24879,1,0,18,0,-18
24880,0,0,48,0,-48
24881,0,0,2,0,-2
24882,0,0,41,0,-41
24883,1,1,384,1841,1457
24884,0,0,9,0,-9
24885,0,0,74,0,-74
24886,1,0,28,0,-28
24887,1,0,16,0,-16
24888,1,0,93,0,-93
24889,1,1,255,1339,1084
24890,1,1,19,1252,1233
24891,1,1,195,1227,1032
24892,1,1,437,1887,1450
24893,1,0,58,0,-58
24894,1,1,109,1210,1101
24895,1,1,163,1211,1048
24896,0,0,14,0,-14
24897,0,0,52,0,-52
24898,0,0,69,0,-69
24899,1,0,4,0,-4
24900,0,0,12,0,-12
24901,1,1,207,2021,1814
24902,1,1,66,1788,1722
24903,0,0,59,0,-59
24904,1,0,8,0,-8
24905,0,0,17,0,-17
24906,0,0,7,0,-7
24907,0,0,49,0,-49
24908,0,0,56,0,-56
24909,0,0,12,0,-12
24910,0,0,19,0,-19
24911,1,1,461,1379,918
24912,0,0,121,0,-121
24913,0,0,26,0,-26
24914,1,1,318,2689,2371
24915,1,0,50,0,-50
24916,1,0,17,0,-17
24917,0,0,55,0,-55
24918,1,0,34,0,-34
24919,0,0,26,0,-26
24920,1,0,88,0,-88
24921,0,0,18,0,-18
24922,1,1,1035,4435,3400
24923,1,1,288,1475,1187
24924,0,0,6,0,-6
24925,1,0,72,0,-72
24926,0,0,15,0,-15
24927,1,0,29,0,-29
24928,0,0,15,0,-15
24929,1,1,215,1227,1012
24930,0,0,16,0,-16
24931,0,0,34,0,-34
24932,1,1,625,1246,621
24933,1,1,348,2768,2420
24934,1,0,49,0,-49
24935,0,0,45,0,-45
24936,0,0,23,0,-23
24937,0,0,9,0,-9
24938,0,0,13,0,-13
24939,1,0,46,0,-46
24940,0,0,89,0,-89
24941,0,0,6,0,-6
24942,1,0,0,0,0
24943,0,0,17,0,-17
24944,1,0,25,0,-25
24945,1,0,24,0,-24
24946,1,0,59,0,-59
24947,1,0,29,0,-29
24948,0,0,68,0,-68
24949,0,0,104,0,-104
24950,1,0,1,0,-1
24951,1,1,274,1254,980
24952,0,0,21,0,-21
24953,0,0,33,0,-33
24954,1,0,14,0,-14
24955,1,1,2322,3095,773
24956,0,0,15,0,-15
24957,1,1,108,1202,1094
24958,1,0,111,0,-111
24959,0,0,19,0,-19
24960,1,0,30,0,-30
24961,1,1,1284,1772,488
24962,0,0,18,0,-18
24963,0,0,96,0,-96
24964,0,0,5,0,-5
24965,0,0,0,0,0
24966,0,0,12,0,-12
24967,0,0,45,0,-45
24968,1,0,103,0,-103
24969,1,1,3555,1756,-1799
24970,1,0,25,0,-25
24971,1,0,81,0,-81
24972,1,0,79,0,-79
24973,1,1,887,1343,456
24974,1,0,401,0,-401
24975,0,0,23,0,-23
24976,1,1,339,1252,913
24977,0,0,48,0,-48
24978,1,0,69,0,-69
24979,1,0,172,0,-172
24980,1,1,1016,1301,285
24981,0,0,9,0,-9
24982,1,1,1154,1531,377
24983,1,1,580,1266,686
24984,1,1,171,1253,1082
24985,1,1,230,2091,1861
24986,1,1,853,2230,1377
24987,0,0,18,0,-18
24988,1,1,480,1387,907
24989,1,0,81,0,-81
24990,1,0,31,0,-31
24991,1,1,270,1472,1202
24992,0,0,102,0,-102
24993,1,0,110,0,-110
24994,0,0,10,0,-10
24995,1,0,90,0,-90
24996,1,1,187,2124,1937
24997,0,0,101,0,-101
24998,1,1,241,1868,1627
24999,1,1,1445,1797,352
25000,0,0,12,0,-12
25001,0,0,39,0,-39
25002,1,1,467,1880,1413
25003,1,1,206,1314,1108
25004,1,1,316,1463,1147
25005,1,0,26,0,-26
25006,1,1,1206,1340,134
25007,0,0,24,0,-24
25008,1,1,585,1887,1302
25009,1,1,198,1211,1013
25010,1,1,110,1434,1324
25011,1,0,13,0,-13
25012,0,0,7,0,-7
25013,1,1,667,1356,689
25014,1,1,109,3007,2898
25015,0,0,59,0,-59
25016,1,1,131,1894,1763
25017,0,0,20,0,-20
25018,1,1,190,2177,1987
25019,1,0,93,0,-93
25020,0,0,6,0,-6
25021,0,0,36,0,-36
25022,0,0,146,0,-146
25023,1,1,281,1296,1015
25024,0,0,25,0,-25
25025,1,1,303,1358,1055
25026,1,1,194,1456,1262
25027,0,0,58,0,-58
25028,1,0,16,0,-16
25029,1,0,176,0,-176
25030,1,0,86,0,-86
25031,1,0,163,0,-163
25032,1,0,136,0,-136
25033,1,1,241,1409,1168
25034,0,0,2,0,-2
25035,0,0,37,0,-37
25036,1,0,181,0,-181
25037,0,0,64,0,-64
25038,1,1,586,1841,1255
25039,1,0,56,0,-56
25040,1,1,339,1726,1387
25041,1,1,170,1280,1110
25042,1,1,870,1212,342
25043,0,0,6,0,-6
25044,1,0,60,0,-60
25045,1,1,231,1238,1007
25046,1,1,1418,1934,516
25047,1,0,194,0,-194
25048,1,0,6,0,-6
25049,1,1,127,1946,1819
25050,0,0,2,0,-2
25051,0,0,59,0,-59
25052,1,1,555,1369,814
25053,0,0,62,0,-62
25054,0,0,94,0,-94
25055,0,0,8,0,-8
25056,0,0,13,0,-13
25057,1,1,1206,2341,1135
25058,1,0,25,0,-25
25059,0,0,5,0,-5
25060,1,1,960,1922,962
25061,1,1,674,1362,688
25062,1,1,216,1249,1033
25063,0,0,49,0,-49
25064,1,0,18,0,-18
25065,1,1,607,1805,1198
25066,1,0,50,0,-50
25067,0,0,14,0,-14
25068,1,0,12,0,-12
25069,0,0,86,0,-86
25070,1,0,23,0,-23
25071,0,0,16,0,-16
25072,0,0,68,0,-68
25073,1,0,3,0,-3
25074,0,0,26,0,-26
25075,1,1,166,2731,2565
25076,1,0,78,0,-78
25077,1,1,259,1313,1054
25078,0,0,41,0,-41
25079,1,1,303,1202,899
25080,0,0,19,0,-19
25081,0,0,8,0,-8
25082,0,0,86,0,-86
25083,0,0,226,0,-226
25084,0,0,35,0,-35
25085,1,1,226,1296,1070
25086,1,1,367,2650,2283
25087,0,0,18,0,-18
25088,1,1,248,1744,1496
25089,0,0,36,0,-36
25090,1,0,58,0,-58
25091,1,1,771,1264,493
25092,0,0,93,0,-93
25093,0,0,2,0,-2
25094,1,1,553,1396,843
25095,1,1,1418,1206,-212
25096,0,0,111,0,-111
25097,1,1,293,1450,1157
25098,0,0,30,0,-30
25099,0,0,13,0,-13
25100,0,0,133,0,-133
25101,0,0,20,0,-20
25102,0,0,10,0,-10
25103,1,1,92,2073,1981
25104,1,0,13,0,-13
25105,0,0,46,0,-46
25106,0,0,76,0,-76
25107,0,0,1,0,-1
25108,1,1,198,1758,1560
25109,1,1,986,1340,354
25110,1,0,53,0,-53
25111,1,0,76,0,-76
25112,1,0,129,0,-129
25113,1,0,179,0,-179
25114,0,0,266,0,-266
25115,0,0,10,0,-10
25116,1,0,4,0,-4
25117,0,0,63,0,-63
25118,0,0,67,0,-67
25119,1,1,69,1629,1560
25120,1,1,469,1207,738
25121,1,1,1141,1342,201
25122,1,1,328,1452,1124
25123,1,0,27,0,-27
25124,0,0,73,0,-73
25125,1,0,24,0,-24
25126,1,0,21,0,-21
25127,1,1,79,2653,2574
25128,0,0,39,0,-39
25129,1,1,256,1238,982
25130,1,1,358,1372,1014
25131,1,0,27,0,-27
25132,1,1,876,1294,418
25133,1,0,63,0,-63
25134,0,0,6,0,-6
25135,1,1,46,1392,1346
25136,1,0,14,0,-14
25137,1,1,712,1938,1226
25138,0,0,43,0,-43
25139,0,0,22,0,-22
25140,0,0,128,0,-128
25141,1,0,74,0,-74
25142,0,0,19,0,-19
25143,0,0,3,0,-3
25144,0,0,8,0,-8
25145,1,1,1399,1296,-103
25146,0,0,26,0,-26
25147,1,0,45,0,-45
25148,1,1,222,1402,1180
25149,1,1,50,1204,1154
25150,1,1,65,2062,1997
25151,0,0,26,0,-26
25152,1,1,858,2014,1156
25153,0,0,2,0,-2
25154,0,0,49,0,-49
25155,0,0,75,0,-75
25156,0,0,60,0,-60
25157,1,1,417,1203,786
25158,1,0,2,0,-2
25159,1,1,90,1297,1207
25160,1,1,888,1879,991
25161,0,0,3,0,-3
25162,1,1,130,1698,1568
25163,1,1,489,1295,806
25164,1,0,107,0,-107
25165,1,0,24,0,-24
25166,1,0,9,0,-9
25167,0,0,8,0,-8
25168,1,0,22,0,-22
25169,0,0,23,0,-23
25170,0,0,36,0,-36
25171,1,1,2660,2175,-485
25172,1,1,1015,1370,355
25173,1,1,958,1380,422
25174,1,1,61,1375,1314
25175,0,0,31,0,-31
25176,1,1,228,1374,1146
25177,1,0,94,0,-94
25178,1,0,17,0,-17
25179,1,1,212,1231,1019
25180,1,0,122,0,-122
25181,1,0,11,0,-11
25182,0,0,72,0,-72
25183,0,0,5,0,-5
25184,1,1,224,1208,984
25185,1,1,661,1332,671
25186,0,0,4,0,-4
25187,1,0,41,0,-41
25188,0,0,57,0,-57
25189,1,1,455,1205,750
25190,0,0,4,0,-4
25191,0,0,76,0,-76
25192,0,0,157,0,-157
25193,0,0,5,0,-5
25194,0,0,99,0,-99
25195,0,0,5,0,-5
25196,1,1,355,1647,1292
25197,0,0,77,0,-77
25198,0,0,8,0,-8
25199,0,0,2,0,-2
25200,1,1,735,1530,795
25201,0,0,31,0,-31
25202,1,1,57,1391,1334
25203,0,0,37,0,-37
25204,1,0,22,0,-22
25205,0,0,182,0,-182
25206,1,0,28,0,-28
25207,0,0,26,0,-26
25208,1,0,135,0,-135
25209,1,0,78,0,-78
25210,1,1,295,1837,1542
25211,0,0,8,0,-8
25212,1,0,28,0,-28
25213,1,1,507,1383,876
25214,0,0,17,0,-17
25215,1,1,421,1346,925
25216,0,0,21,0,-21
25217,0,0,110,0,-110
25218,1,1,252,1458,1206
25219,1,1,270,1372,1102
25220,0,0,25,0,-25
25221,0,0,49,0,-49
25222,0,0,4,0,-4
25223,1,0,80,0,-80
25224,0,0,6,0,-6
25225,1,0,44,0,-44
25226,1,1,436,1728,1292
25227,0,0,6,0,-6
25228,1,1,516,1262,746
25229,1,1,183,1212,1029
25230,1,0,36,0,-36
25231,0,0,46,0,-46
25232,0,0,24,0,-24
25233,1,0,8,0,-8
25234,1,0,24,0,-24
25235,0,0,9,0,-9
25236,1,1,96,1422,1326
25237,0,0,1,0,-1
25238,1,1,347,1269,922
25239,1,1,50,3109,3059
25240,1,0,16,0,-16
25241,0,0,11,0,-11
25242,1,1,272,1301,1029
25243,1,1,165,1324,1159
25244,0,0,54,0,-54
25245,1,0,52,0,-52
25246,1,0,9,0,-9
25247,1,1,361,1774,1413
25248,1,0,4,0,-4
25249,0,0,32,0,-32
25250,0,0,4,0,-4
25251,0,0,56,0,-56
25252,1,0,81,0,-81
25253,0,0,10,0,-10
25254,1,1,162,2216,2054
25255,1,1,578,1424,846
25256,0,0,21,0,-21
25257,0,0,18,0,-18
25258,0,0,156,0,-156
25259,0,0,10,0,-10
25260,0,0,34,0,-34
25261,0,0,62,0,-62
25262,0,0,135,0,-135
25263,1,0,135,0,-135
25264,1,0,52,0,-52
25265,1,1,212,1461,1249
25266,0,0,52,0,-52
25267,0,0,22,0,-22
25268,0,0,4,0,-4
25269,1,1,1736,1306,-430
25270,0,0,24,0,-24
25271,1,1,637,2677,2040
25272,1,0,196,0,-196
25273,1,0,39,0,-39
25274,1,0,89,0,-89
25275,1,1,615,1210,595
25276,0,0,28,0,-28
25277,0,0,43,0,-43
25278,0,0,39,0,-39
25279,1,1,277,1358,1081
25280,1,0,80,0,-80
25281,1,1,125,1353,1228
25282,0,0,28,0,-28
25283,1,0,24,0,-24
25284,0,0,56,0,-56
25285,1,1,279,1362,1083
25286,1,0,99,0,-99
25287,1,1,992,3270,2278
25288,1,1,790,1500,710
25289,0,0,1,0,-1
25290,1,1,533,1267,734
25291,1,0,0,0,0
25292,0,0,12,0,-12
25293,0,0,31,0,-31
25294,1,0,5,0,-5
25295,1,1,552,1293,741
25296,1,0,95,0,-95
25297,0,0,13,0,-13
25298,0,0,33,0,-33
25299,0,0,8,0,-8
25300,0,0,58,0,-58
25301,1,1,3745,2172,-1573
25302,1,1,617,1302,685
25303,0,0,70,0,-70
25304,1,0,4,0,-4
25305,1,0,31,0,-31
25306,0,0,37,0,-37
25307,1,0,54,0,-54
25308,1,1,358,1387,1029
25309,1,0,60,0,-60
25310,0,0,33,0,-33
25311,1,0,23,0,-23
25312,0,0,44,0,-44
25313,0,0,4,0,-4
25314,1,1,367,1538,1171
25315,0,0,9,0,-9
25316,1,0,5,0,-5
25317,0,0,62,0,-62
25318,1,0,0,0,0
25319,0,0,19,0,-19
25320,1,0,6,0,-6
25321,0,0,50,0,-50
25322,0,0,56,0,-56
25323,1,1,566,1492,926
25324,1,0,47,0,-47
25325,0,0,22,0,-22
25326,1,0,31,0,-31
25327,1,1,489,2453,1964
25328,1,0,77,0,-77
25329,0,0,8,0,-8
25330,1,0,14,0,-14
25331,1,0,5,0,-5
25332,0,0,53,0,-53
25333,1,1,518,1245,727
25334,0,0,97,0,-97
25335,0,0,166,0,-166
25336,1,0,27,0,-27
25337,1,0,67,0,-67
25338,1,0,23,0,-23
25339,0,0,36,0,-36
25340,0,0,29,0,-29
25341,0,0,35,0,-35
25342,0,0,63,0,-63
25343,0,0,40,0,-40
25344,1,0,79,0,-79
25345,1,0,8,0,-8
25346,0,0,24,0,-24
25347,0,0,18,0,-18
25348,1,0,66,0,-66
25349,1,1,1903,2098,195
25350,0,0,22,0,-22
25351,1,1,84,1369,1285
25352,0,0,28,0,-28
25353,1,0,71,0,-71
25354,0,0,34,0,-34
25355,0,0,91,0,-91
25356,0,0,18,0,-18
25357,0,0,9,0,-9
25358,1,0,27,0,-27
25359,1,0,216,0,-216
25360,1,0,27,0,-27
25361,1,0,69,0,-69
25362,1,1,112,1934,1822
25363,1,0,28,0,-28
25364,0,0,44,0,-44
25365,0,0,6,0,-6
25366,0,0,79,0,-79
25367,1,1,472,1274,802
25368,1,1,155,2361,2206
25369,1,0,6,0,-6
25370,1,1,166,1433,1267
25371,1,1,1098,1621,523
25372,1,0,0,0,0
25373,1,1,790,1208,418
25374,1,0,100,0,-100
25375,0,0,157,0,-157
25376,0,0,0,0,0
25377,1,0,66,0,-66
25378,0,0,35,0,-35
25379,1,0,89,0,-89
25380,1,1,121,1264,1143
25381,0,0,22,0,-22
25382,0,0,19,0,-19
25383,1,1,775,1713,938
25384,0,0,9,0,-9
25385,1,1,315,1204,889
25386,1,1,236,1739,1503
25387,0,0,212,0,-212
25388,1,0,21,0,-21
25389,1,1,1359,1295,-64
25390,0,0,113,0,-113
25391,0,0,42,0,-42
25392,0,0,9,0,-9
25393,0,0,39,0,-39
25394,0,0,11,0,-11
25395,0,0,36,0,-36
25396,1,1,604,1238,634
25397,0,0,4,0,-4
25398,1,1,273,1657,1384
25399,1,0,1,0,-1
25400,1,1,574,2102,1528
25401,0,0,10,0,-10
25402,1,0,40,0,-40
25403,1,0,44,0,-44
25404,0,0,30,0,-30
25405,0,0,34,0,-34
25406,1,1,91,1372,1281
25407,1,1,279,2499,2220
25408,1,1,301,1256,955
25409,1,1,884,4598,3714
25410,0,0,1,0,-1
25411,0,0,0,0,0
25412,0,0,53,0,-53
25413,0,0,10,0,-10
25414,1,0,142,0,-142
25415,1,0,166,0,-166
25416,1,1,974,1929,955
25417,1,0,34,0,-34
25418,1,0,10,0,-10
25419,1,0,62,0,-62
25420,1,1,663,1478,815
25421,1,0,24,0,-24
25422,1,0,92,0,-92
25423,0,0,13,0,-13
25424,0,0,30,0,-30
25425,1,1,1537,1689,152
25426,1,0,82,0,-82
25427,0,0,95,0,-95
25428,1,0,10,0,-10
25429,1,0,30,0,-30
25430,1,1,139,1392,1253
25431,0,0,8,0,-8
25432,0,0,125,0,-125
25433,0,0,49,0,-49
25434,1,1,230,1270,1040
25435,0,0,45,0,-45
25436,1,0,0,0,0
25437,1,1,301,1587,1286
25438,1,1,466,1276,810
25439,1,1,136,1247,1111
25440,1,0,18,0,-18
25441,0,0,95,0,-95
25442,0,0,48,0,-48
25443,1,0,36,0,-36
25444,0,0,37,0,-37
25445,1,0,2,0,-2
25446,0,0,18,0,-18
25447,1,1,159,1293,1134
25448,1,0,12,0,-12
25449,0,0,20,0,-20
25450,0,0,13,0,-13
25451,1,1,101,1887,1786
25452,0,0,114,0,-114
25453,1,1,1915,1271,-644
25454,1,0,114,0,-114
25455,0,0,24,0,-24
25456,0,0,28,0,-28
25457,0,0,33,0,-33
25458,1,1,463,1359,896
25459,1,1,471,1277,806
25460,1,0,62,0,-62
25461,1,0,121,0,-121
25462,1,0,35,0,-35
25463,1,0,9,0,-9
25464,1,0,12,0,-12
25465,0,0,6,0,-6
25466,0,0,204,0,-204
25467,0,0,64,0,-64
25468,0,0,2,0,-2
25469,1,1,96,1303,1207
25470,1,0,40,0,-40
25471,1,1,905,1615,710
25472,1,1,1036,1555,519
25473,1,1,103,1247,1144
25474,1,0,70,0,-70
25475,0,0,0,0,0
25476,1,1,530,1505,975
25477,0,0,46,0,-46
25478,0,0,155,0,-155
25479,1,0,0,0,0
25480,0,0,139,0,-139
25481,0,0,17,0,-17
25482,1,1,89,1260,1171
25483,0,0,47,0,-47
25484,0,0,7,0,-7
25485,1,1,1369,1243,-126
25486,1,0,41,0,-41
25487,0,0,106,0,-106
25488,1,1,111,1808,1697
25489,1,0,50,0,-50
25490,0,0,12,0,-12
25491,1,0,62,0,-62
25492,0,0,41,0,-41
25493,1,1,111,1221,1110
25494,1,0,127,0,-127
25495,0,0,20,0,-20
25496,1,1,109,1352,1243
25497,0,0,15,0,-15
25498,0,0,14,0,-14
25499,1,1,2393,1216,-1177
25500,0,0,38,0,-38
25501,1,0,53,0,-53
25502,1,1,215,1657,1442
25503,1,1,228,1595,1367
25504,1,0,31,0,-31
25505,1,0,30,0,-30
25506,1,0,17,0,-17
25507,1,0,8,0,-8
25508,0,0,47,0,-47
25509,1,0,79,0,-79
25510,0,0,25,0,-25
25511,1,0,80,0,-80
25512,0,0,22,0,-22
25513,1,0,138,0,-138
25514,0,0,82,0,-82
25515,0,0,9,0,-9
25516,1,1,518,1324,806
25517,1,1,108,2691,2583
25518,1,1,72,1845,1773
25519,1,0,31,0,-31
25520,0,0,36,0,-36
25521,0,0,4,0,-4
25522,1,0,29,0,-29
25523,1,1,99,1259,1160
25524,0,0,24,0,-24
25525,1,1,414,1444,1030
25526,1,0,135,0,-135
25527,1,1,565,1278,713
25528,0,0,3,0,-3
25529,0,0,92,0,-92
25530,0,0,62,0,-62
25531,0,0,48,0,-48
25532,0,0,9,0,-9
25533,1,0,238,0,-238
25534,1,1,371,1629,1258
25535,1,0,79,0,-79
25536,1,0,42,0,-42
25537,1,0,21,0,-21
25538,0,0,34,0,-34
25539,1,0,22,0,-22
25540,1,0,20,0,-20
25541,1,0,9,0,-9
25542,0,0,108,0,-108
25543,1,0,51,0,-51
25544,1,1,114,1339,1225
25545,0,0,94,0,-94
25546,0,0,6,0,-6
25547,1,0,3,0,-3
25548,1,1,251,2650,2399
25549,1,0,58,0,-58
25550,1,1,73,1281,1208
25551,0,0,12,0,-12
25552,1,1,640,1229,589
25553,1,0,5,0,-5
25554,0,0,24,0,-24
25555,1,0,121,0,-121
25556,1,0,10,0,-10
25557,1,1,247,1211,964
25558,1,1,199,1697,1498
25559,1,1,682,1412,730
25560,0,0,84,0,-84
25561,0,0,17,0,-17
25562,1,1,78,1350,1272
25563,1,1,27,2016,1989
25564,0,0,18,0,-18
25565,0,0,94,0,-94
25566,1,1,280,1513,1233
25567,1,1,487,1208,721
25568,1,1,107,1347,1240
25569,0,0,125,0,-125
25570,1,1,429,1411,982
25571,1,1,371,1275,904
25572,0,0,102,0,-102
25573,1,0,46,0,-46
25574,1,0,63,0,-63
25575,1,1,544,1213,669
25576,0,0,72,0,-72
25577,1,1,670,2552,1882
25578,1,1,1070,1289,219
25579,0,0,1,0,-1
25580,0,0,17,0,-17
25581,1,1,193,1412,1219
25582,1,1,308,1394,1086
25583,1,0,2,0,-2
25584,0,0,81,0,-81
25585,1,1,1330,1300,-30
25586,0,0,29,0,-29
25587,1,0,76,0,-76
25588,1,1,451,1278,827
25589,1,0,19,0,-19
25590,1,0,22,0,-22
25591,1,0,38,0,-38
25592,1,1,104,1706,1602
25593,1,0,107,0,-107
25594,1,1,580,1385,805
25595,0,0,21,0,-21
25596,1,1,1754,1215,-539
25597,0,0,65,0,-65
25598,1,1,295,1531,1236
25599,0,0,31,0,-31
25600,0,0,125,0,-125
25601,0,0,15,0,-15
25602,1,1,33,1463,1430
25603,0,0,25,0,-25
25604,0,0,8,0,-8
25605,1,0,101,0,-101
25606,0,0,32,0,-32
25607,1,0,9,0,-9
25608,1,1,665,1412,747
25609,0,0,124,0,-124
25610,1,0,49,0,-49
25611,0,0,63,0,-63
25612,0,0,1,0,-1
25613,1,0,35,0,-35
25614,0,0,68,0,-68
25615,0,0,17,0,-17
25616,0,0,3,0,-3
25617,1,1,327,2108,1781
25618,0,0,38,0,-38
25619,1,1,253,1754,1501
25620,0,0,26,0,-26
25621,1,0,66,0,-66
25622,1,0,24,0,-24
25623,1,0,74,0,-74
25624,1,0,1,0,-1
25625,1,0,36,0,-36
25626,1,0,55,0,-55
25627,1,1,302,2311,2009
25628,1,1,97,1711,1614
25629,0,0,44,0,-44
25630,1,0,26,0,-26
25631,1,0,79,0,-79
25632,0,0,20,0,-20
25633,1,1,952,1206,254
25634,1,0,0,0,0
25635,1,0,20,0,-20
25636,1,0,144,0,-144
25637,1,0,0,0,0
25638,0,0,44,0,-44
25639,1,1,590,1333,743
25640,1,1,1048,1210,162
25641,1,0,96,0,-96
25642,0,0,50,0,-50
25643,1,0,43,0,-43
25644,1,0,19,0,-19
25645,1,0,37,0,-37
25646,0,0,1,0,-1
25647,1,0,3,0,-3
25648,1,0,47,0,-47
25649,1,0,9,0,-9
25650,0,0,7,0,-7
25651,1,1,1056,1323,267
25652,0,0,49,0,-49
25653,1,0,143,0,-143
25654,1,0,67,0,-67
25655,1,0,167,0,-167
25656,1,1,1961,1218,-743
25657,1,1,698,1236,538
25658,1,0,9,0,-9
25659,1,0,65,0,-65
25660,1,0,55,0,-55
25661,1,1,94,1367,1273
25662,1,1,116,1433,1317
25663,1,0,4,0,-4
25664,0,0,33,0,-33
25665,1,1,1174,2735,1561
25666,1,0,45,0,-45
25667,1,1,307,1306,999
25668,0,0,41,0,-41
25669,1,1,494,1245,751
25670,0,0,54,0,-54
25671,0,0,72,0,-72
25672,1,0,22,0,-22
25673,0,0,27,0,-27
25674,0,0,22,0,-22
25675,1,0,64,0,-64
25676,1,1,878,2020,1142
25677,0,0,33,0,-33
25678,0,0,24,0,-24
25679,1,0,7,0,-7
25680,0,0,19,0,-19
25681,1,0,43,0,-43
25682,0,0,22,0,-22
25683,0,0,28,0,-28
25684,0,0,33,0,-33
25685,0,0,42,0,-42
25686,1,0,1,0,-1
25687,1,0,148,0,-148
25688,0,0,4,0,-4
25689,1,1,386,1510,1124
25690,1,0,16,0,-16
25691,0,0,22,0,-22
25692,1,0,47,0,-47
25693,0,0,13,0,-13
25694,0,0,41,0,-41
25695,1,0,1,0,-1
25696,0,0,27,0,-27
25697,1,1,838,1309,471
25698,1,1,478,1553,1075
25699,0,0,10,0,-10
25700,1,1,94,1420,1326
25701,1,1,663,1374,711
25702,0,0,8,0,-8
25703,0,0,16,0,-16
25704,1,0,14,0,-14
25705,1,0,24,0,-24
25706,0,0,8,0,-8
25707,0,0,2,0,-2
25708,1,1,818,1208,390
25709,0,0,3,0,-3
25710,1,1,265,1560,1295
25711,0,0,29,0,-29
25712,1,1,24,2636,2612
25713,1,0,23,0,-23
25714,1,0,145,0,-145
25715,1,1,766,1732,966
25716,0,0,85,0,-85
25717,0,0,103,0,-103
25718,0,0,64,0,-64
25719,1,0,25,0,-25
25720,0,0,17,0,-17
25721,1,1,313,1246,933
25722,1,1,83,1267,1184
25723,1,0,13,0,-13
25724,0,0,80,0,-80
25725,1,1,736,1515,779
25726,1,0,99,0,-99
25727,0,0,91,0,-91
25728,1,0,18,0,-18
25729,1,0,183,0,-183
25730,0,0,19,0,-19
25731,1,1,113,1612,1499
25732,0,0,30,0,-30
25733,1,0,2,0,-2
25734,1,1,898,1242,344
25735,1,1,547,2918,2371
25736,1,1,1023,1954,931
25737,1,0,25,0,-25
25738,0,0,11,0,-11
25739,1,1,1081,2397,1316
25740,1,1,404,1369,965
25741,1,0,210,0,-210
25742,1,0,20,0,-20
25743,1,1,406,1757,1351
25744,1,1,623,1508,885
25745,0,0,23,0,-23
25746,0,0,1,0,-1
25747,1,1,343,1496,1153
25748,1,0,87,0,-87
25749,0,0,2,0,-2
25750,1,1,40,1276,1236
25751,1,1,729,1274,545
25752,1,1,157,1488,1331
25753,1,1,176,1352,1176
25754,1,0,37,0,-37
25755,1,1,487,1438,951
25756,1,0,154,0,-154
25757,1,0,47,0,-47
25758,1,0,39,0,-39
25759,1,1,22,1352,1330
25760,0,0,139,0,-139
25761,1,1,347,1960,1613
25762,1,0,106,0,-106
25763,1,1,2113,1504,-609
25764,0,0,14,0,-14
25765,1,0,46,0,-46
25766,0,0,33,0,-33
25767,1,1,628,2201,1573
25768,0,0,6,0,-6
25769,0,0,115,0,-115
25770,0,0,14,0,-14
25771,1,0,168,0,-168
25772,0,0,95,0,-95
25773,1,0,27,0,-27
25774,1,0,11,0,-11
25775,1,1,1161,1646,485
25776,1,0,15,0,-15
25777,1,1,720,1302,582
25778,0,0,3,0,-3
25779,0,0,125,0,-125
25780,0,0,15,0,-15
25781,1,1,153,1271,1118
25782,0,0,11,0,-11
25783,1,0,42,0,-42
25784,1,1,480,1267,787
25785,1,0,12,0,-12
25786,0,0,101,0,-101
25787,1,0,72,0,-72
25788,0,0,13,0,-13
25789,0,0,15,0,-15
25790,1,1,282,1276,994
25791,1,1,314,1214,900
25792,1,1,650,1710,1060
25793,1,0,3,0,-3
25794,1,1,237,1804,1567
25795,1,0,83,0,-83
25796,1,1,256,1351,1095
25797,0,0,70,0,-70
25798,0,0,43,0,-43
25799,0,0,13,0,-13
25800,0,0,46,0,-46
25801,0,0,69,0,-69
25802,1,1,231,1338,1107
25803,0,0,2,0,-2
25804,0,0,31,0,-31
25805,1,0,8,0,-8
25806,1,0,5,0,-5
25807,0,0,15,0,-15
25808,0,0,57,0,-57
25809,0,0,58,0,-58
25810,0,0,9,0,-9
25811,1,1,730,1480,750
25812,0,0,65,0,-65
25813,1,0,4,0,-4
25814,1,0,11,0,-11
25815,0,0,17,0,-17
25816,0,0,56,0,-56
25817,0,0,9,0,-9
25818,0,0,41,0,-41
25819,0,0,5,0,-5
25820,1,0,6,0,-6
25821,1,0,20,0,-20
25822,1,1,455,1647,1192
25823,1,1,2525,1224,-1301
25824,1,1,437,1371,934
25825,0,0,48,0,-48
25826,1,0,3,0,-3
25827,1,1,368,1490,1122
25828,1,0,90,0,-90
25829,1,0,1,0,-1
25830,1,0,13,0,-13
25831,1,1,630,1540,910
25832,1,1,863,1671,808
25833,1,1,181,1464,1283
25834,1,1,920,1428,508
25835,1,0,26,0,-26
25836,0,0,16,0,-16
25837,1,0,58,0,-58
25838,0,0,29,0,-29
25839,1,0,71,0,-71
25840,1,0,18,0,-18
25841,0,0,0,0,0
25842,0,0,1,0,-1
25843,1,0,4,0,-4
25844,0,0,16,0,-16
25845,0,0,47,0,-47
25846,1,1,191,1467,1276
25847,0,0,73,0,-73
25848,1,1,511,1412,901
25849,0,0,39,0,-39
25850,0,0,43,0,-43
25851,0,0,27,0,-27
25852,1,0,27,0,-27
25853,1,0,16,0,-16
25854,1,1,145,2111,1966
25855,1,0,3,0,-3
25856,1,1,932,1688,756
25857,0,0,36,0,-36
25858,1,1,217,1458,1241
25859,1,1,515,1404,889
25860,0,0,60,0,-60
25861,1,1,1366,1378,12
25862,1,1,344,2705,2361
25863,0,0,89,0,-89
25864,1,0,8,0,-8
25865,1,1,2360,2153,-207
25866,1,0,5,0,-5
25867,1,1,215,1971,1756
25868,1,1,206,1224,1018
25869,1,0,127,0,-127
25870,0,0,10,0,-10
25871,1,1,907,1297,390
25872,1,0,44,0,-44
25873,0,0,65,0,-65
25874,0,0,14,0,-14
25875,0,0,24,0,-24
25876,1,1,314,1242,928
25877,0,0,1,0,-1
25878,1,0,0,0,0
25879,1,1,189,3576,3387
25880,0,0,11,0,-11
25881,1,0,10,0,-10
25882,0,0,125,0,-125
25883,1,0,42,0,-42
25884,0,0,44,0,-44
25885,1,1,394,1682,1288
25886,1,1,387,1639,1252
25887,1,0,11,0,-11
25888,1,1,106,1407,1301
25889,0,0,6,0,-6
25890,0,0,43,0,-43
25891,0,0,76,0,-76
25892,1,1,734,1429,695
25893,1,0,11,0,-11
25894,0,0,74,0,-74
25895,1,1,329,1380,1051
25896,1,0,38,0,-38
25897,0,0,17,0,-17
25898,1,1,1201,2441,1240
25899,1,0,11,0,-11
25900,0,0,69,0,-69
25901,0,0,9,0,-9
25902,1,0,20,0,-20
25903,0,0,29,0,-29
25904,0,0,47,0,-47
25905,1,1,1109,1231,122
25906,0,0,32,0,-32
25907,1,1,1175,1504,329
25908,1,0,11,0,-11
25909,0,0,20,0,-20
25910,1,1,243,1364,1121
25911,0,0,9,0,-9
25912,1,1,73,1393,1320
25913,1,1,1221,1533,312
25914,1,1,463,1486,1023
25915,1,1,146,1202,1056
25916,0,0,30,0,-30
25917,0,0,10,0,-10
25918,1,0,42,0,-42
25919,1,1,504,1348,844
25920,1,0,6,0,-6
25921,1,0,90,0,-90
25922,0,0,266,0,-266
25923,1,1,342,1336,994
25924,0,0,66,0,-66
25925,1,1,132,1463,1331
25926,1,0,8,0,-8
25927,1,0,143,0,-143
25928,1,0,45,0,-45
25929,1,0,73,0,-73
25930,1,0,1,0,-1
25931,1,1,1222,1334,112
25932,1,1,125,1325,1200
25933,0,0,63,0,-63
25934,0,0,17,0,-17
25935,0,0,46,0,-46
25936,0,0,102,0,-102
25937,1,1,495,1265,770
25938,0,0,40,0,-40
25939,0,0,58,0,-58
25940,1,1,290,1255,965
25941,1,0,126,0,-126
25942,1,0,35,0,-35
25943,0,0,140,0,-140
25944,1,1,579,1327,748
25945,1,1,337,1435,1098
25946,0,0,24,0,-24
25947,0,0,7,0,-7
25948,1,0,139,0,-139
25949,1,1,146,1726,1580
25950,1,1,1036,2186,1150
25951,1,0,66,0,-66
25952,0,0,9,0,-9
25953,1,1,746,1240,494
25954,0,0,95,0,-95
25955,1,0,15,0,-15
25956,0,0,87,0,-87
25957,0,0,27,0,-27
25958,0,0,24,0,-24
25959,0,0,346,0,-346
25960,1,1,903,1462,559
25961,0,0,114,0,-114
25962,0,0,73,0,-73
25963,0,0,14,0,-14
25964,0,0,56,0,-56
25965,1,0,16,0,-16
25966,0,0,110,0,-110
25967,1,0,213,0,-213
25968,0,0,17,0,-17
25969,1,1,174,1202,1028
25970,1,0,14,0,-14
25971,1,1,573,1439,866
25972,1,0,121,0,-121
25973,0,0,36,0,-36
25974,0,0,114,0,-114
25975,0,0,27,0,-27
25976,0,0,13,0,-13
25977,0,0,1,0,-1
25978,1,1,478,1418,940
25979,1,1,231,1461,1230
25980,1,1,157,1621,1464
25981,1,1,286,1968,1682
25982,0,0,32,0,-32
25983,1,0,17,0,-17
25984,1,1,152,1202,1050
25985,1,1,759,1959,1200
25986,1,0,18,0,-18
25987,1,1,582,1211,629
25988,0,0,8,0,-8
25989,1,0,19,0,-19
25990,1,1,2091,1468,-623
25991,1,1,196,1226,1030
25992,1,1,2072,1359,-713
25993,0,0,73,0,-73
25994,0,0,1,0,-1
25995,1,0,30,0,-30
25996,1,1,272,1684,1412
25997,0,0,8,0,-8
25998,1,1,625,1319,694
25999,1,0,49,0,-49
26000,0,0,38,0,-38
26001,0,0,201,0,-201
26002,0,0,44,0,-44
26003,0,0,13,0,-13
26004,1,1,663,1406,743
26005,0,0,44,0,-44
26006,0,0,7,0,-7
26007,1,0,32,0,-32
26008,0,0,154,0,-154
26009,0,0,100,0,-100
26010,1,0,45,0,-45
26011,1,0,6,0,-6
26012,1,0,7,0,-7
26013,1,1,646,1453,807
26014,0,0,19,0,-19
26015,1,1,334,1219,885
26016,1,1,477,1368,891
26017,0,0,17,0,-17
26018,0,0,19,0,-19
26019,0,0,52,0,-52
26020,1,0,8,0,-8
26021,1,1,1332,1259,-73
26022,0,0,34,0,-34
26023,1,0,37,0,-37
26024,1,0,7,0,-7
26025,1,0,13,0,-13
26026,1,0,52,0,-52
26027,1,1,204,1235,1031
26028,1,1,115,4513,4398
26029,0,0,2,0,-2
26030,0,0,85,0,-85
26031,0,0,34,0,-34
26032,1,1,455,1291,836
26033,0,0,90,0,-90
26034,0,0,25,0,-25
26035,1,0,107,0,-107
26036,1,0,65,0,-65
26037,1,1,61,1473,1412
26038,0,0,57,0,-57
26039,1,0,67,0,-67
26040,1,1,1360,2096,736
26041,0,0,60,0,-60
26042,1,0,36,0,-36
26043,0,0,5,0,-5
26044,0,0,54,0,-54
26045,1,0,60,0,-60
26046,0,0,40,0,-40
26047,0,0,105,0,-105
26048,1,1,1203,1460,257
26049,1,1,404,1319,915
26050,1,0,17,0,-17
26051,1,0,189,0,-189
26052,1,1,384,1388,1004
26053,1,1,136,1248,1112
26054,0,0,103,0,-103
26055,0,0,0,0,0
26056,1,1,59,1298,1239
26057,0,0,51,0,-51
26058,1,1,1446,1328,-118
26059,0,0,48,0,-48
26060,1,1,252,2540,2288
26061,1,1,1861,1306,-555
26062,1,1,84,1380,1296
26063,1,0,9,0,-9
26064,0,0,27,0,-27
26065,1,1,530,1800,1270
26066,1,0,27,0,-27
26067,0,0,54,0,-54
26068,0,0,114,0,-114
26069,0,0,64,0,-64
26070,1,0,5,0,-5
26071,1,0,43,0,-43
26072,1,0,21,0,-21
26073,0,0,205,0,-205
26074,1,0,184,0,-184
26075,1,0,71,0,-71
26076,1,0,51,0,-51
26077,0,0,85,0,-85
26078,1,0,90,0,-90
26079,1,1,211,1271,1060
26080,1,0,30,0,-30
26081,0,0,11,0,-11
26082,1,1,1466,1247,-219
26083,0,0,6,0,-6
26084,0,0,135,0,-135
26085,1,0,81,0,-81
26086,1,0,87,0,-87
26087,1,1,36,1975,1939
26088,0,0,115,0,-115
26089,0,0,56,0,-56
26090,0,0,14,0,-14
26091,0,0,106,0,-106
26092,1,0,42,0,-42
26093,1,0,48,0,-48
26094,0,0,101,0,-101
26095,1,0,63,0,-63
26096,0,0,99,0,-99
26097,1,0,25,0,-25
26098,1,1,909,2074,1165
26099,0,0,81,0,-81
26100,1,1,502,1373,871
26101,1,1,215,1201,986
26102,1,1,105,1524,1419
26103,0,0,54,0,-54
26104,1,0,12,0,-12
26105,0,0,19,0,-19
26106,0,0,78,0,-78
26107,1,0,102,0,-102
26108,1,0,71,0,-71
26109,1,1,184,2444,2260
26110,1,0,32,0,-32
26111,0,0,79,0,-79
26112,0,0,11,0,-11
26113,1,1,636,1216,580
26114,0,0,57,0,-57
26115,1,1,269,1771,1502
26116,0,0,2,0,-2
26117,0,0,28,0,-28
26118,0,0,6,0,-6
26119,1,1,97,1528,1431
26120,1,0,51,0,-51
26121,1,1,182,4045,3863
26122,1,0,15,0,-15
26123,1,1,514,1254,740
26124,1,1,55,1418,1363
26125,1,0,66,0,-66
26126,0,0,134,0,-134
26127,0,0,55,0,-55
26128,0,0,17,0,-17
26129,1,0,27,0,-27
26130,1,0,44,0,-44
26131,1,1,715,1535,820
26132,1,1,238,2098,1860
26133,1,0,53,0,-53
26134,1,1,325,1303,978
26135,0,0,24,0,-24
26136,0,0,38,0,-38
26137,0,0,11,0,-11
26138,0,0,37,0,-37
26139,0,0,36,0,-36
26140,0,0,17,0,-17
26141,0,0,24,0,-24
26142,0,0,105,0,-105
26143,1,0,2,0,-2
26144,1,0,0,0,0
26145,0,0,0,0,0
26146,1,0,16,0,-16
26147,1,1,144,1431,1287
26148,0,0,12,0,-12
26149,1,0,47,0,-47
26150,1,1,139,1425,1286
26151,0,0,50,0,-50
26152,1,1,737,1992,1255
26153,1,0,11,0,-11
26154,0,0,6,0,-6
26155,1,1,822,1573,751
26156,0,0,142,0,-142
26157,1,1,987,1495,508
26158,0,0,35,0,-35
26159,0,0,56,0,-56
26160,1,0,38,0,-38
26161,0,0,10,0,-10
26162,1,1,643,1306,663
26163,1,0,79,0,-79
26164,1,0,9,0,-9
26165,0,0,84,0,-84
26166,0,0,161,0,-161
26167,1,0,16,0,-16
26168,0,0,32,0,-32
26169,0,0,32,0,-32
26170,1,0,48,0,-48
26171,0,0,4,0,-4
26172,1,0,31,0,-31
26173,0,0,7,0,-7
26174,0,0,12,0,-12
26175,1,1,759,1927,1168
26176,0,0,24,0,-24
26177,0,0,93,0,-93
26178,1,0,29,0,-29
26179,1,0,33,0,-33
26180,0,0,31,0,-31
26181,1,1,595,1254,659
26182,1,1,153,1731,1578
26183,1,0,109,0,-109
26184,1,0,34,0,-34
26185,0,0,12,0,-12
26186,1,1,118,1583,1465
26187,0,0,7,0,-7
26188,1,0,55,0,-55
26189,1,0,20,0,-20
26190,1,0,29,0,-29
26191,1,0,46,0,-46
26192,1,0,31,0,-31
26193,1,1,161,1562,1401
26194,1,0,36,0,-36
26195,1,1,604,1364,760
26196,0,0,52,0,-52
26197,0,0,29,0,-29
26198,0,0,7,0,-7
26199,1,1,516,1698,1182
26200,1,1,312,1803,1491
26201,1,0,28,0,-28
26202,1,0,123,0,-123
26203,0,0,41,0,-41
26204,0,0,45,0,-45
26205,1,1,362,1542,1180
26206,1,1,312,1343,1031
26207,1,0,15,0,-15
26208,0,0,35,0,-35
26209,1,0,23,0,-23
26210,1,1,719,1762,1043
26211,0,0,13,0,-13
26212,1,0,28,0,-28
26213,0,0,1,0,-1
26214,1,1,497,1298,801
26215,1,0,29,0,-29
26216,0,0,14,0,-14
26217,1,0,15,0,-15
26218,0,0,26,0,-26
26219,1,1,233,1391,1158
26220,0,0,24,0,-24
26221,0,0,69,0,-69
26222,1,0,68,0,-68
26223,0,0,133,0,-133
26224,0,0,46,0,-46
26225,0,0,75,0,-75
26226,1,0,19,0,-19
26227,1,1,75,1344,1269
26228,0,0,44,0,-44
26229,1,1,84,2150,2066
26230,0,0,20,0,-20
26231,1,0,190,0,-190
26232,1,1,502,2399,1897
26233,1,0,32,0,-32
26234,1,0,5,0,-5
26235,0,0,61,0,-61
26236,0,0,50,0,-50
26237,1,1,2012,1483,-529
26238,1,0,38,0,-38
26239,0,0,258,0,-258
26240,1,1,162,2012,1850
26241,0,0,27,0,-27
26242,0,0,59,0,-59
26243,1,0,15,0,-15
26244,1,1,715,2328,1613
26245,1,1,471,1304,833
26246,1,1,1269,1256,-13
26247,0,0,39,0,-39
26248,0,0,8,0,-8
26249,1,1,486,1516,1030
26250,0,0,1,0,-1
26251,1,1,63,1690,1627
26252,1,1,212,1335,1123
26253,1,1,1037,1493,456
26254,1,1,1223,1279,56
26255,0,0,57,0,-57
26256,1,1,613,1376,763
26257,1,0,16,0,-16
26258,1,1,343,1990,1647
26259,0,0,41,0,-41
26260,0,0,149,0,-149
26261,1,1,230,2042,1812
26262,1,1,236,1401,1165
26263,1,0,148,0,-148
26264,1,0,6,0,-6
26265,1,1,163,1599,1436
26266,1,0,42,0,-42
26267,1,0,16,0,-16
26268,1,1,1221,1296,75
26269,1,1,573,1601,1028
26270,0,0,13,0,-13
26271,0,0,51,0,-51
26272,1,0,12,0,-12
26273,0,0,13,0,-13
26274,1,0,125,0,-125
26275,0,0,48,0,-48
26276,1,0,28,0,-28
26277,0,0,6,0,-6
26278,0,0,21,0,-21
26279,1,1,197,1428,1231
26280,1,1,1441,1332,-109
26281,0,0,44,0,-44
26282,1,1,638,1410,772
26283,1,1,250,2383,2133
26284,0,0,89,0,-89
26285,1,1,743,1401,658
26286,1,0,12,0,-12
26287,1,0,62,0,-62
26288,1,0,25,0,-25
26289,0,0,24,0,-24
26290,0,0,21,0,-21
26291,1,1,773,1230,457
26292,1,1,531,1273,742
26293,1,1,351,2639,2288
26294,1,1,1379,1652,273
26295,0,0,56,0,-56
26296,1,0,36,0,-36
26297,0,0,43,0,-43
26298,1,1,1659,1204,-455
26299,0,0,24,0,-24
26300,1,1,694,1840,1146
26301,1,1,266,1404,1138
26302,1,1,482,1232,750
26303,1,0,35,0,-35
26304,0,0,33,0,-33
26305,0,0,39,0,-39
26306,1,0,158,0,-158
26307,1,0,20,0,-20
26308,1,1,490,1223,733
26309,0,0,85,0,-85
26310,1,0,54,0,-54
26311,1,1,594,1838,1244
26312,0,0,40,0,-40
26313,0,0,15,0,-15
26314,1,1,306,1462,1156
26315,0,0,31,0,-31
26316,0,0,32,0,-32
26317,1,1,630,1397,767
26318,0,0,112,0,-112
26319,1,1,374,1687,1313
26320,1,0,13,0,-13
26321,0,0,224,0,-224
26322,1,1,455,1245,790
26323,1,1,205,1239,1034
26324,0,0,13,0,-13
26325,1,0,74,0,-74
26326,1,1,175,4242,4067
26327,0,0,11,0,-11
26328,1,1,295,2978,2683
26329,1,1,213,1627,1414
26330,0,0,52,0,-52
26331,1,0,18,0,-18
26332,1,0,4,0,-4
26333,1,1,377,1424,1047
26334,0,0,108,0,-108
26335,1,1,261,1858,1597
26336,1,0,78,0,-78
26337,1,1,948,1439,491
26338,1,1,399,2815,2416
26339,0,0,159,0,-159
26340,1,1,218,1265,1047
26341,1,1,54,1337,1283
26342,1,0,21,0,-21
26343,0,0,171,0,-171
26344,1,1,295,1877,1582
26345,0,0,78,0,-78
26346,1,1,1002,1848,846
26347,0,0,1,0,-1
26348,1,1,723,1429,706
26349,1,0,91,0,-91
26350,1,0,91,0,-91
26351,0,0,19,0,-19
26352,1,0,98,0,-98
26353,1,0,49,0,-49
26354,0,0,15,0,-15
26355,0,0,1,0,-1
26356,0,0,48,0,-48
26357,1,1,656,2234,1578
26358,1,1,1477,2087,610
26359,0,0,66,0,-66
26360,0,0,31,0,-31
26361,1,1,244,2416,2172
26362,0,0,10,0,-10
26363,0,0,1,0,-1
26364,0,0,32,0,-32
26365,1,0,73,0,-73
26366,0,0,31,0,-31
26367,1,1,1000,1215,215
26368,1,1,1179,1279,100
26369,1,1,139,1381,1242
26370,1,1,521,1209,688
26371,1,0,259,0,-259
26372,0,0,54,0,-54
26373,1,0,2,0,-2
26374,1,0,1,0,-1
26375,0,0,15,0,-15
26376,0,0,5,0,-5
26377,1,0,27,0,-27
26378,0,0,44,0,-44
26379,1,0,41,0,-41
26380,0,0,123,0,-123
26381,1,0,111,0,-111
26382,1,1,580,1569,989
26383,0,0,158,0,-158
26384,1,1,384,1349,965
26385,1,0,41,0,-41
26386,1,0,98,0,-98
26387,1,1,226,1208,982
26388,1,1,397,1324,927
26389,1,0,47,0,-47
26390,0,0,47,0,-47
26391,1,0,49,0,-49
26392,0,0,32,0,-32
26393,1,1,160,2015,1855
26394,1,1,448,1208,760
26395,1,0,226,0,-226
26396,0,0,84,0,-84
26397,1,1,255,4583,4328
26398,0,0,53,0,-53
26399,0,0,61,0,-61
26400,0,0,76,0,-76
26401,1,1,546,1674,1128
26402,1,0,24,0,-24
26403,1,0,17,0,-17
26404,1,0,0,0,0
26405,0,0,108,0,-108
26406,0,0,40,0,-40
26407,1,1,408,1364,956
26408,0,0,43,0,-43
26409,1,0,47,0,-47
26410,1,0,24,0,-24
26411,0,0,55,0,-55
26412,0,0,7,0,-7
26413,0,0,75,0,-75
26414,1,0,28,0,-28
26415,1,0,41,0,-41
26416,1,0,27,0,-27
26417,1,1,1641,1316,-325
26418,0,0,68,0,-68
26419,1,0,6,0,-6
26420,1,0,249,0,-249
26421,1,0,45,0,-45
26422,0,0,52,0,-52
26423,0,0,46,0,-46
26424,0,0,76,0,-76
26425,1,0,16,0,-16
26426,1,0,3,0,-3
26427,1,1,488,1216,728
26428,1,0,49,0,-49
26429,0,0,34,0,-34
26430,1,0,2,0,-2
26431,1,1,207,1301,1094
26432,1,0,17,0,-17
26433,1,1,2562,1520,-1042
26434,1,1,180,1709,1529
26435,0,0,50,0,-50
26436,1,1,34,2470,2436
26437,0,0,96,0,-96
26438,1,1,755,1272,517
26439,1,1,142,1208,1066
26440,1,1,657,1544,887
26441,0,0,53,0,-53
26442,1,1,355,1476,1121
26443,1,0,58,0,-58
26444,1,0,67,0,-67
26445,1,1,330,2150,1820
26446,0,0,19,0,-19
26447,0,0,234,0,-234
26448,1,0,18,0,-18
26449,1,1,1505,1381,-124
26450,0,0,26,0,-26
26451,0,0,43,0,-43
26452,1,1,846,1790,944
26453,1,0,49,0,-49
26454,1,0,110,0,-110
26455,0,0,5,0,-5
26456,0,0,27,0,-27
26457,1,0,165,0,-165
26458,1,0,58,0,-58
26459,1,0,36,0,-36
26460,0,0,0,0,0
26461,1,0,42,0,-42
26462,1,0,75,0,-75
26463,1,0,21,0,-21
26464,0,0,58,0,-58
26465,1,1,294,1220,926
26466,1,1,480,1674,1194
26467,0,0,129,0,-129
26468,1,0,99,0,-99
26469,1,0,1,0,-1
26470,0,0,134,0,-134
26471,1,0,62,0,-62
26472,1,1,268,1375,1107
26473,0,0,12,0,-12
26474,1,0,19,0,-19
26475,1,1,569,1228,659
26476,1,1,212,1224,1012
26477,1,0,37,0,-37
26478,1,0,61,0,-61
26479,1,1,1641,1510,-131
26480,1,0,52,0,-52
26481,0,0,0,0,0
26482,0,0,2,0,-2
26483,1,1,213,1719,1506
26484,1,1,1575,1520,-55
26485,0,0,116,0,-116
26486,1,1,413,2230,1817
26487,0,0,7,0,-7
26488,0,0,75,0,-75
26489,0,0,85,0,-85
26490,1,1,1656,1531,-125
26491,1,1,425,1343,918
26492,0,0,118,0,-118
26493,1,1,142,1628,1486
26494,0,0,26,0,-26
26495,1,0,174,0,-174
26496,1,1,332,1563,1231
26497,1,0,32,0,-32
26498,1,0,4,0,-4
26499,0,0,9,0,-9
26500,1,1,1939,1497,-442
26501,0,0,59,0,-59
26502,0,0,10,0,-10
26503,0,0,5,0,-5
26504,1,0,9,0,-9
26505,0,0,47,0,-47
26506,0,0,3,0,-3
26507,1,0,163,0,-163
26508,1,1,103,1334,1231
26509,0,0,52,0,-52
26510,1,1,1403,1362,-41
26511,1,0,50,0,-50
26512,1,1,833,1457,624
26513,1,0,16,0,-16
26514,1,0,18,0,-18
26515,0,0,49,0,-49
26516,1,1,216,1379,1163
26517,1,0,33,0,-33
26518,1,1,646,1265,619
26519,1,1,224,1359,1135
26520,1,0,22,0,-22
26521,1,1,163,1257,1094
26522,1,1,120,1423,1303
26523,1,0,41,0,-41
26524,0,0,33,0,-33
26525,0,0,86,0,-86
26526,0,0,120,0,-120
26527,0,0,97,0,-97
26528,1,0,25,0,-25
26529,1,0,23,0,-23
26530,0,0,58,0,-58
26531,1,1,370,1554,1184
26532,1,0,0,0,0
26533,0,0,27,0,-27
26534,0,0,108,0,-108
26535,1,0,4,0,-4
26536,1,0,88,0,-88
26537,1,0,17,0,-17
26538,0,0,19,0,-19
26539,1,0,22,0,-22
26540,0,0,27,0,-27
26541,1,1,333,2745,2412
26542,1,0,29,0,-29
26543,1,0,58,0,-58
26544,0,0,10,0,-10
26545,0,0,61,0,-61
26546,1,0,18,0,-18
26547,1,0,1,0,-1
26548,1,1,513,1262,749
26549,0,0,14,0,-14
26550,1,0,22,0,-22
26551,0,0,56,0,-56
26552,0,0,84,0,-84
26553,1,0,30,0,-30
26554,0,0,44,0,-44
26555,0,0,26,0,-26
26556,1,0,28,0,-28
26557,0,0,1,0,-1
26558,0,0,64,0,-64
26559,1,1,614,1224,610
26560,1,0,13,0,-13
26561,1,0,31,0,-31
26562,1,0,35,0,-35
26563,1,1,251,1542,1291
26564,1,0,121,0,-121
26565,0,0,8,0,-8
26566,1,0,145,0,-145
26567,0,0,3,0,-3
26568,0,0,78,0,-78
26569,0,0,88,0,-88
26570,1,1,559,1235,676
26571,0,0,15,0,-15
26572,1,0,26,0,-26
26573,1,1,1351,2662,1311
26574,1,0,106,0,-106
26575,1,0,5,0,-5
26576,1,1,210,1632,1422
26577,1,0,5,0,-5
26578,1,0,53,0,-53
26579,0,0,4,0,-4
26580,0,0,9,0,-9
26581,0,0,35,0,-35
26582,1,1,711,1217,506
26583,1,0,44,0,-44
26584,1,1,951,1220,269
26585,1,0,6,0,-6
26586,1,0,35,0,-35
26587,1,1,189,1649,1460
26588,1,1,636,1253,617
26589,0,0,53,0,-53
26590,1,0,185,0,-185
26591,1,1,850,1816,966
26592,1,0,6,0,-6
26593,1,1,861,1276,415
26594,1,1,1616,2571,955
26595,1,1,61,2199,2138
26596,1,1,148,1259,1111
26597,0,0,56,0,-56
26598,0,0,59,0,-59
26599,1,1,456,1620,1164
26600,0,0,24,0,-24
26601,1,0,36,0,-36
26602,0,0,1,0,-1
26603,0,0,7,0,-7
26604,1,0,75,0,-75
26605,0,0,45,0,-45
26606,0,0,63,0,-63
26607,0,0,22,0,-22
26608,0,0,268,0,-268
26609,1,1,466,1297,831
26610,0,0,7,0,-7
26611,0,0,53,0,-53
26612,1,1,143,1582,1439
26613,1,0,108,0,-108
26614,1,0,26,0,-26
26615,1,1,980,1296,316
26616,0,0,195,0,-195
26617,1,0,79,0,-79
26618,1,1,271,1212,941
26619,0,0,6,0,-6
26620,1,0,23,0,-23
26621,1,0,43,0,-43
26622,0,0,6,0,-6
26623,1,1,443,2365,1922
26624,1,0,54,0,-54
26625,0,0,143,0,-143
26626,0,0,32,0,-32
26627,0,0,22,0,-22
26628,1,1,163,2084,1921
26629,1,1,78,1290,1212
26630,0,0,128,0,-128
26631,1,0,2,0,-2
26632,1,0,17,0,-17
26633,1,1,798,1280,482
26634,0,0,93,0,-93
26635,1,0,83,0,-83
26636,0,0,47,0,-47
26637,1,1,706,1657,951
26638,1,0,23,0,-23
26639,1,1,1204,1745,541
26640,1,0,65,0,-65
26641,1,0,21,0,-21
26642,0,0,35,0,-35
26643,0,0,56,0,-56
26644,1,0,11,0,-11
26645,0,0,94,0,-94
26646,0,0,17,0,-17
26647,1,1,695,1635,940
26648,0,0,273,0,-273
26649,1,1,29,1242,1213
26650,0,0,21,0,-21
26651,0,0,80,0,-80
26652,1,0,8,0,-8
26653,0,0,56,0,-56
26654,0,0,118,0,-118
26655,1,0,15,0,-15
26656,1,1,868,1208,340
26657,1,0,19,0,-19
26658,0,0,6,0,-6
26659,1,0,16,0,-16
26660,0,0,63,0,-63
26661,0,0,27,0,-27
26662,1,0,11,0,-11
26663,1,0,18,0,-18
26664,1,1,490,1419,929
26665,0,0,24,0,-24
26666,0,0,162,0,-162
26667,1,0,73,0,-73
26668,1,0,33,0,-33
26669,1,1,126,1775,1649
26670,0,0,46,0,-46
26671,0,0,31,0,-31
26672,0,0,6,0,-6
26673,1,1,943,1387,444
26674,1,0,34,0,-34
26675,0,0,44,0,-44
26676,1,0,12,0,-12
26677,0,0,19,0,-19
26678,1,1,317,1354,1037
26679,0,0,54,0,-54
26680,0,0,50,0,-50
26681,0,0,14,0,-14
26682,1,0,14,0,-14
26683,1,0,7,0,-7
26684,1,0,94,0,-94
26685,1,1,608,1570,962
26686,1,0,4,0,-4
26687,1,1,890,1508,618
26688,1,0,16,0,-16
26689,1,0,2,0,-2
26690,0,0,36,0,-36
26691,0,0,48,0,-48
26692,0,0,37,0,-37
26693,1,1,320,1250,930
26694,0,0,231,0,-231
26695,0,0,36,0,-36
26696,0,0,103,0,-103
26697,1,0,22,0,-22
26698,1,1,290,1322,1032
26699,1,1,331,1619,1288
26700,1,0,59,0,-59
26701,1,0,213,0,-213
26702,1,1,447,1535,1088
26703,0,0,10,0,-10
26704,0,0,18,0,-18
26705,1,1,138,3326,3188
26706,0,0,44,0,-44
26707,1,1,181,1689,1508
26708,1,0,62,0,-62
26709,1,0,96,0,-96
26710,0,0,19,0,-19
26711,0,0,84,0,-84
26712,1,1,412,1324,912
26713,1,0,29,0,-29
26714,1,1,269,1467,1198
26715,1,0,47,0,-47
26716,0,0,72,0,-72
26717,1,1,683,1452,769
26718,1,0,25,0,-25
26719,1,1,1290,1297,7
26720,0,0,26,0,-26
26721,1,1,345,1235,890
26722,0,0,33,0,-33
26723,0,0,27,0,-27
26724,1,1,340,1801,1461
26725,1,1,713,1286,573
26726,1,0,52,0,-52
26727,1,0,32,0,-32
26728,0,0,128,0,-128
26729,1,0,42,0,-42
26730,1,0,43,0,-43
26731,0,0,60,0,-60
26732,1,0,52,0,-52
26733,1,1,191,1237,1046
26734,0,0,99,0,-99
26735,1,1,182,1446,1264
26736,1,0,21,0,-21
26737,1,1,559,2080,1521
26738,1,1,88,1208,1120
26739,0,0,48,0,-48
26740,0,0,3,0,-3
26741,1,0,92,0,-92
26742,1,0,49,0,-49
26743,1,0,117,0,-117
26744,1,1,291,1208,917
26745,0,0,17,0,-17
26746,1,1,378,1217,839
26747,0,0,49,0,-49
26748,1,1,546,1595,1049
26749,0,0,7,0,-7
26750,1,1,743,1286,543
26751,1,0,42,0,-42
26752,0,0,2,0,-2
26753,0,0,8,0,-8
26754,0,0,190,0,-190
26755,1,1,860,1935,1075
26756,1,1,613,1444,831
26757,0,0,0,0,0
26758,1,1,756,1245,489
26759,0,0,13,0,-13
26760,0,0,341,0,-341
26761,0,0,14,0,-14
26762,1,1,575,1696,1121
26763,0,0,1,0,-1
26764,0,0,52,0,-52
26765,0,0,0,0,0
26766,0,0,78,0,-78
26767,1,0,18,0,-18
26768,0,0,6,0,-6
26769,0,0,264,0,-264
26770,0,0,96,0,-96
26771,1,0,14,0,-14
26772,1,1,242,1645,1403
26773,0,0,6,0,-6
26774,1,1,678,1592,914
26775,1,0,16,0,-16
26776,1,1,664,1452,788
26777,1,0,140,0,-140
26778,1,0,11,0,-11
26779,0,0,1,0,-1
26780,1,0,48,0,-48
26781,1,1,176,1270,1094
26782,1,0,0,0,0
26783,0,0,3,0,-3
26784,0,0,48,0,-48
26785,1,0,95,0,-95
26786,1,0,153,0,-153
26787,1,1,212,1255,1043
26788,1,1,297,1248,951
26789,0,0,68,0,-68
26790,1,1,423,1256,833
26791,1,1,36,1390,1354
26792,1,0,105,0,-105
26793,1,1,210,1218,1008
26794,0,0,43,0,-43
26795,0,0,56,0,-56
26796,1,0,161,0,-161
26797,1,0,50,0,-50
26798,1,1,420,1465,1045
26799,0,0,85,0,-85
26800,0,0,29,0,-29
26801,1,1,866,1263,397
26802,1,0,23,0,-23
26803,1,0,239,0,-239
26804,1,0,9,0,-9
26805,1,1,194,1427,1233
26806,1,1,114,1539,1425
26807,1,1,831,2732,1901
26808,0,0,49,0,-49
26809,0,0,44,0,-44
26810,1,1,580,1469,889
26811,0,0,7,0,-7
26812,1,0,36,0,-36
26813,1,1,341,1256,915
26814,1,1,72,1358,1286
26815,0,0,78,0,-78
26816,1,0,18,0,-18
26817,1,0,112,0,-112
26818,0,0,1,0,-1
26819,1,1,668,1837,1169
26820,1,1,2087,1906,-181
26821,1,0,47,0,-47
26822,1,1,608,1266,658
26823,1,1,668,1306,638
26824,1,1,1365,1226,-139
26825,1,0,3,0,-3
26826,1,0,15,0,-15
26827,1,0,20,0,-20
26828,1,1,688,1289,601
26829,0,0,9,0,-9
26830,0,0,66,0,-66
26831,1,0,16,0,-16
26832,1,1,160,1214,1054
26833,1,0,84,0,-84
26834,0,0,113,0,-113
26835,1,0,158,0,-158
26836,0,0,4,0,-4
26837,0,0,82,0,-82
26838,1,1,368,1327,959
26839,0,0,12,0,-12
26840,0,0,49,0,-49
26841,1,0,33,0,-33
26842,1,1,355,1348,993
26843,0,0,40,0,-40
26844,0,0,94,0,-94
26845,1,1,661,1787,1126
26846,1,0,9,0,-9
26847,1,0,54,0,-54
26848,0,0,6,0,-6
26849,1,1,642,1286,644
26850,1,0,130,0,-130
26851,1,0,27,0,-27
26852,0,0,59,0,-59
26853,0,0,51,0,-51
26854,1,0,52,0,-52
26855,1,1,472,2202,1730
26856,1,1,201,1891,1690
26857,1,0,23,0,-23
26858,1,0,70,0,-70
26859,1,0,103,0,-103
26860,1,1,1019,1578,559
26861,0,0,102,0,-102
26862,0,0,57,0,-57
26863,1,0,41,0,-41
26864,1,0,17,0,-17
26865,1,0,110,0,-110
26866,1,0,172,0,-172
26867,1,0,47,0,-47
26868,0,0,19,0,-19
26869,1,1,344,1681,1337
26870,0,0,24,0,-24
26871,1,1,87,1351,1264
26872,1,1,217,1366,1149
26873,1,1,548,1953,1405
26874,1,1,179,1407,1228
26875,1,1,992,1646,654
26876,1,0,30,0,-30
26877,1,0,5,0,-5
26878,1,1,554,1357,803
26879,1,0,20,0,-20
26880,1,0,16,0,-16
26881,1,0,20,0,-20
26882,1,0,57,0,-57
26883,0,0,49,0,-49
26884,0,0,33,0,-33
26885,0,0,120,0,-120
26886,1,0,6,0,-6
26887,0,0,108,0,-108
26888,0,0,60,0,-60
26889,0,0,9,0,-9
26890,1,1,37,1259,1222
26891,0,0,84,0,-84
26892,0,0,164,0,-164
26893,0,0,24,0,-24
26894,1,0,37,0,-37
26895,0,0,70,0,-70
26896,0,0,83,0,-83
26897,1,0,70,0,-70
26898,1,0,6,0,-6
26899,1,0,131,0,-131
26900,1,0,76,0,-76
26901,1,1,1090,1475,385
26902,1,1,1250,1230,-20
26903,1,0,4,0,-4
26904,1,0,90,0,-90
26905,0,0,8,0,-8
26906,1,0,52,0,-52
26907,0,0,85,0,-85
26908,0,0,19,0,-19
26909,1,1,1797,1593,-204
26910,0,0,84,0,-84
26911,0,0,41,0,-41
26912,1,1,101,1450,1349
26913,0,0,50,0,-50
26914,0,0,285,0,-285
26915,1,0,28,0,-28
26916,0,0,54,0,-54
26917,1,1,474,1772,1298
26918,1,0,160,0,-160
26919,1,0,125,0,-125
26920,0,0,11,0,-11
26921,1,0,4,0,-4
26922,1,1,62,1284,1222
26923,0,0,101,0,-101
26924,1,1,271,1326,1055
26925,1,0,30,0,-30
26926,0,0,21,0,-21
26927,0,0,34,0,-34
26928,1,0,7,0,-7
26929,0,0,56,0,-56
26930,0,0,6,0,-6
26931,0,0,105,0,-105
26932,0,0,49,0,-49
26933,1,0,16,0,-16
26934,1,1,58,1212,1154
26935,1,1,279,1305,1026
26936,1,1,629,1638,1009
26937,0,0,2,0,-2
26938,0,0,29,0,-29
26939,1,0,48,0,-48
26940,1,0,56,0,-56
26941,0,0,20,0,-20
26942,0,0,42,0,-42
26943,0,0,109,0,-109
26944,0,0,7,0,-7
26945,1,0,68,0,-68
26946,0,0,12,0,-12
26947,1,1,429,1652,1223
26948,0,0,11,0,-11
26949,1,0,33,0,-33
26950,1,0,87,0,-87
26951,1,0,51,0,-51
26952,1,0,3,0,-3
26953,1,0,54,0,-54
26954,1,1,434,1292,858
26955,1,0,23,0,-23
26956,1,0,4,0,-4
26957,0,0,17,0,-17
26958,0,0,25,0,-25
26959,0,0,34,0,-34
26960,1,1,1081,1706,625
26961,0,0,17,0,-17
26962,1,0,17,0,-17
26963,0,0,57,0,-57
26964,0,0,73,0,-73
26965,1,0,68,0,-68
26966,1,0,11,0,-11
26967,1,1,904,1427,523
26968,0,0,0,0,0
26969,0,0,0,0,0
26970,0,0,47,0,-47
26971,1,0,143,0,-143
26972,0,0,60,0,-60
26973,1,1,976,1221,245
26974,0,0,22,0,-22
26975,0,0,31,0,-31
26976,1,1,1461,1214,-247
26977,1,1,32,1343,1311
26978,0,0,13,0,-13
26979,1,0,70,0,-70
26980,0,0,61,0,-61
26981,1,1,616,1203,587
26982,1,1,455,1312,857
26983,1,1,1120,3085,1965
26984,0,0,119,0,-119
26985,1,1,204,1308,1104
26986,0,0,60,0,-60
26987,1,0,49,0,-49
26988,1,1,233,1229,996
26989,0,0,31,0,-31
26990,1,0,5,0,-5
26991,1,0,89,0,-89
26992,1,0,25,0,-25
26993,1,1,733,2430,1697
26994,0,0,25,0,-25
26995,1,1,1075,1644,569
26996,0,0,8,0,-8
26997,1,1,580,1745,1165
26998,1,1,444,1469,1025
26999,0,0,46,0,-46
27000,0,0,83,0,-83
27001,0,0,2,0,-2
27002,1,1,482,1594,1112
27003,1,1,1175,1565,390
27004,0,0,33,0,-33
27005,0,0,68,0,-68
27006,1,0,251,0,-251
27007,1,1,94,1739,1645
27008,1,1,756,1331,575
27009,1,1,1269,1766,497
27010,0,0,69,0,-69
27011,0,0,18,0,-18
27012,1,1,93,3583,3490
27013,1,0,5,0,-5
27014,1,1,135,1662,1527
27015,1,1,389,1266,877
27016,1,0,72,0,-72
27017,0,0,22,0,-22
27018,0,0,69,0,-69
27019,0,0,23,0,-23
27020,1,0,54,0,-54
27021,0,0,0,0,0
27022,1,0,1,0,-1
27023,1,1,500,1259,759
27024,1,0,13,0,-13
27025,1,0,68,0,-68
27026,1,0,0,0,0
27027,1,0,1,0,-1
27028,1,1,88,1228,1140
27029,1,0,9,0,-9
27030,1,1,258,1383,1125
27031,0,0,35,0,-35
27032,0,0,122,0,-122
27033,1,1,537,1656,1119
27034,1,0,54,0,-54
27035,1,1,1014,1469,455
27036,1,1,208,1463,1255
27037,1,1,491,2501,2010
27038,1,0,8,0,-8
27039,1,0,51,0,-51
27040,0,0,39,0,-39
27041,1,1,22,1550,1528
27042,1,0,53,0,-53
27043,0,0,79,0,-79
27044,1,1,568,1488,920
27045,0,0,13,0,-13
27046,1,1,542,1240,698
27047,0,0,22,0,-22
27048,0,0,49,0,-49
27049,0,0,8,0,-8
27050,0,0,50,0,-50
27051,0,0,24,0,-24
27052,0,0,18,0,-18
27053,0,0,19,0,-19
27054,1,0,49,0,-49
27055,0,0,114,0,-114
27056,0,0,68,0,-68
27057,0,0,123,0,-123
27058,1,1,937,1204,267
27059,0,0,26,0,-26
27060,1,1,282,1710,1428
27061,0,0,42,0,-42
27062,1,1,711,1572,861
27063,1,0,16,0,-16
27064,0,0,1,0,-1
27065,1,1,1170,1723,553
27066,0,0,40,0,-40
27067,1,0,63,0,-63
27068,1,1,57,1303,1246
27069,1,1,595,2081,1486
27070,1,1,302,1216,914
27071,1,0,32,0,-32
27072,1,1,1519,2625,1106
27073,0,0,65,0,-65
27074,1,0,32,0,-32
27075,1,0,4,0,-4
27076,0,0,41,0,-41
27077,0,0,34,0,-34
27078,1,1,398,1254,856
27079,1,0,7,0,-7
27080,0,0,4,0,-4
27081,1,1,784,1204,420
27082,0,0,82,0,-82
27083,1,1,894,1413,519
27084,1,0,16,0,-16
27085,0,0,12,0,-12
27086,1,1,1569,1245,-324
27087,1,1,288,1292,1004
27088,0,0,3,0,-3
27089,0,0,105,0,-105
27090,0,0,41,0,-41
27091,0,0,111,0,-111
27092,0,0,152,0,-152
27093,1,0,80,0,-80
27094,1,0,91,0,-91
27095,1,1,816,2441,1625
27096,1,1,228,1392,1164
27097,1,0,11,0,-11
27098,1,0,3,0,-3
27099,0,0,34,0,-34
27100,1,0,9,0,-9
27101,0,0,97,0,-97
27102,1,1,1598,1200,-398
27103,0,0,0,0,0
27104,0,0,50,0,-50
27105,0,0,0,0,0
27106,1,0,8,0,-8
27107,0,0,1,0,-1
27108,1,1,356,1347,991
27109,1,0,18,0,-18
27110,1,1,699,1466,767
27111,1,0,104,0,-104
27112,0,0,69,0,-69
27113,0,0,87,0,-87
27114,1,0,12,0,-12
27115,0,0,114,0,-114
27116,1,1,147,1662,1515
27117,0,0,116,0,-116
27118,1,1,446,1275,829
27119,0,0,39,0,-39
27120,0,0,0,0,0
27121,1,1,1365,1296,-69
27122,0,0,3,0,-3
27123,1,1,178,1387,1209
27124,1,1,233,1295,1062
27125,1,1,127,1540,1413
27126,0,0,43,0,-43
27127,1,0,41,0,-41
27128,1,1,316,1263,947
27129,1,0,74,0,-74
27130,1,1,808,1564,756
27131,1,1,413,1245,832
27132,1,1,1303,1906,603
27133,0,0,8,0,-8
27134,1,0,169,0,-169
27135,0,0,24,0,-24
27136,0,0,6,0,-6
27137,1,0,143,0,-143
27138,0,0,0,0,0
27139,0,0,24,0,-24
27140,1,1,89,1411,1322
27141,1,0,98,0,-98
27142,1,1,185,1368,1183
27143,0,0,32,0,-32
27144,1,0,41,0,-41
27145,0,0,24,0,-24
27146,0,0,84,0,-84
27147,0,0,104,0,-104
27148,0,0,45,0,-45
27149,1,0,100,0,-100
27150,1,0,7,0,-7
27151,0,0,10,0,-10
27152,1,1,87,1821,1734
27153,1,0,2,0,-2
27154,1,1,1051,1237,186
27155,0,0,83,0,-83
27156,1,1,2980,1259,-1721
27157,0,0,42,0,-42
27158,0,0,30,0,-30
27159,0,0,6,0,-6
27160,1,1,177,1380,1203
27161,0,0,52,0,-52
27162,1,0,85,0,-85
27163,0,0,138,0,-138
27164,1,1,1201,1276,75
27165,1,1,185,1688,1503
27166,0,0,45,0,-45
27167,1,1,1743,1731,-12
27168,0,0,212,0,-212
27169,1,0,1,0,-1
27170,0,0,29,0,-29
27171,0,0,29,0,-29
27172,0,0,38,0,-38
27173,1,1,156,1780,1624
27174,1,1,107,1414,1307
27175,1,1,1123,1214,91
27176,0,0,45,0,-45
27177,1,0,82,0,-82
27178,0,0,110,0,-110
27179,1,1,669,2417,1748
27180,1,1,198,2175,1977
27181,1,1,667,1288,621
27182,1,1,295,2791,2496
27183,1,0,1,0,-1
27184,1,0,19,0,-19
27185,0,0,56,0,-56
27186,0,0,48,0,-48
27187,0,0,3,0,-3
27188,1,1,485,1413,928
27189,1,1,312,1238,926
27190,1,1,1167,1463,296
27191,1,0,92,0,-92
27192,1,1,11,1253,1242
27193,1,1,1230,1323,93
27194,1,0,4,0,-4
27195,0,0,98,0,-98
27196,0,0,64,0,-64
27197,1,1,542,1643,1101
27198,0,0,14,0,-14
27199,0,0,18,0,-18
27200,1,1,174,1333,1159
27201,0,0,97,0,-97
27202,0,0,194,0,-194
27203,0,0,42,0,-42
27204,0,0,267,0,-267
27205,1,1,293,1263,970
27206,0,0,26,0,-26
27207,1,1,38,1359,1321
27208,1,0,47,0,-47
27209,0,0,19,0,-19
27210,1,1,416,1918,1502
27211,1,1,591,2588,1997
27212,0,0,32,0,-32
27213,1,0,79,0,-79
27214,1,0,38,0,-38
27215,1,1,357,1218,861
27216,1,0,38,0,-38
27217,0,0,118,0,-118
27218,1,1,394,1278,884
27219,1,0,63,0,-63
27220,0,0,20,0,-20
27221,1,0,29,0,-29
27222,1,1,94,1211,1117
27223,1,1,91,1254,1163
27224,0,0,80,0,-80
27225,0,0,31,0,-31
27226,1,0,59,0,-59
27227,1,1,633,1204,571
27228,1,0,34,0,-34
27229,1,0,38,0,-38
27230,0,0,193,0,-193
27231,0,0,42,0,-42
27232,0,0,14,0,-14
27233,1,0,4,0,-4
27234,0,0,27,0,-27
27235,1,0,123,0,-123
27236,1,1,927,1315,388
27237,0,0,46,0,-46
27238,1,0,51,0,-51
27239,0,0,82,0,-82
27240,0,0,57,0,-57
27241,1,1,1483,1539,56
27242,1,0,30,0,-30
27243,0,0,15,0,-15
27244,0,0,15,0,-15
27245,1,0,94,0,-94
27246,1,0,8,0,-8
27247,0,0,58,0,-58
27248,1,0,60,0,-60
27249,1,0,87,0,-87
27250,0,0,7,0,-7
27251,1,1,916,1444,528
27252,0,0,13,0,-13
27253,1,1,187,1437,1250
27254,1,1,254,1200,946
27255,0,0,53,0,-53
27256,1,1,723,2253,1530
27257,0,0,7,0,-7
27258,1,1,740,1823,1083
27259,0,0,43,0,-43
27260,1,1,691,1382,691
27261,0,0,12,0,-12
27262,0,0,4,0,-4
27263,1,0,7,0,-7
27264,1,1,208,1299,1091
27265,1,0,6,0,-6
27266,1,1,53,1255,1202
27267,0,0,97,0,-97
27268,0,0,135,0,-135
27269,0,0,30,0,-30
27270,1,0,13,0,-13
27271,1,0,119,0,-119
27272,1,0,252,0,-252
27273,0,0,97,0,-97
27274,0,0,0,0,0
27275,0,0,7,0,-7
27276,0,0,47,0,-47
27277,0,0,80,0,-80
27278,1,1,828,1265,437
27279,0,0,9,0,-9
27280,1,1,1105,1250,145
27281,0,0,190,0,-190
27282,1,0,13,0,-13
27283,1,1,345,1815,1470
27284,1,1,253,1585,1332
27285,1,1,415,1335,920
27286,1,0,126,0,-126
27287,1,1,194,1606,1412
27288,1,0,14,0,-14
27289,1,0,1,0,-1
27290,1,0,26,0,-26
27291,1,1,2759,4655,1896
27292,1,1,470,1498,1028
27293,0,0,127,0,-127
27294,1,1,10,1235,1225
27295,1,1,50,1246,1196
27296,0,0,26,0,-26
27297,1,1,545,2728,2183
27298,0,0,16,0,-16
27299,1,0,7,0,-7
27300,1,0,12,0,-12
27301,0,0,56,0,-56
27302,0,0,8,0,-8
27303,0,0,49,0,-49
27304,1,1,622,1347,725
27305,0,0,39,0,-39
27306,1,1,1201,1413,212
27307,1,0,10,0,-10
27308,1,1,16,1295,1279
27309,1,1,799,1303,504
27310,0,0,184,0,-184
27311,1,1,803,1445,642
27312,1,0,62,0,-62
27313,0,0,40,0,-40
27314,1,0,39,0,-39
27315,1,0,4,0,-4
27316,1,0,55,0,-55
27317,1,0,34,0,-34
27318,0,0,65,0,-65
27319,1,1,135,1587,1452
27320,0,0,20,0,-20
27321,1,0,111,0,-111
27322,1,0,0,0,0
27323,1,0,57,0,-57
27324,1,1,228,1450,1222
27325,1,0,127,0,-127
27326,1,1,453,1403,950
27327,0,0,59,0,-59
27328,1,0,123,0,-123
27329,1,0,0,0,0
27330,0,0,49,0,-49
27331,1,0,10,0,-10
27332,0,0,57,0,-57
27333,0,0,6,0,-6
27334,0,0,17,0,-17
27335,1,0,51,0,-51
27336,0,0,38,0,-38
27337,1,0,46,0,-46
27338,1,1,564,1211,647
27339,0,0,17,0,-17
27340,1,0,34,0,-34
27341,1,0,64,0,-64
27342,1,1,2066,2447,381
27343,1,0,50,0,-50
27344,1,1,97,1255,1158
27345,0,0,113,0,-113
27346,0,0,30,0,-30
27347,0,0,138,0,-138
27348,0,0,105,0,-105
27349,1,1,315,2104,1789
27350,1,0,5,0,-5
27351,1,0,59,0,-59
27352,0,0,127,0,-127
27353,0,0,51,0,-51
27354,1,0,2,0,-2
27355,1,0,139,0,-139
27356,0,0,5,0,-5
27357,0,0,20,0,-20
27358,1,1,674,1244,570
27359,0,0,28,0,-28
27360,1,0,46,0,-46
27361,1,0,26,0,-26
27362,1,1,860,1865,1005
27363,0,0,73,0,-73
27364,1,0,49,0,-49
27365,0,0,34,0,-34
27366,0,0,38,0,-38
27367,1,1,1050,1501,451
27368,0,0,13,0,-13
27369,1,0,76,0,-76
27370,1,1,696,1389,693
27371,1,0,56,0,-56
27372,1,1,873,1211,338
27373,1,0,107,0,-107
27374,1,1,196,1438,1242
27375,1,0,20,0,-20
27376,1,1,110,1705,1595
27377,1,0,130,0,-130
27378,1,0,7,0,-7
27379,1,0,27,0,-27
27380,0,0,68,0,-68
27381,0,0,30,0,-30
27382,0,0,125,0,-125
27383,1,1,304,1607,1303
27384,1,1,331,1295,964
27385,1,0,47,0,-47
27386,0,0,2,0,-2
27387,1,1,247,1260,1013
27388,0,0,24,0,-24
27389,1,0,7,0,-7
27390,1,0,4,0,-4
27391,1,1,964,1703,739
27392,1,0,33,0,-33
27393,1,0,4,0,-4
27394,0,0,34,0,-34
27395,1,0,27,0,-27
27396,1,0,36,0,-36
27397,1,1,77,1991,1914
27398,0,0,20,0,-20
27399,0,0,140,0,-140
27400,0,0,2,0,-2
27401,1,1,795,1226,431
27402,1,1,237,1409,1172
27403,1,1,31,1332,1301
27404,1,0,59,0,-59
27405,0,0,76,0,-76
27406,1,0,52,0,-52
27407,0,0,101,0,-101
27408,0,0,125,0,-125
27409,0,0,7,0,-7
27410,0,0,85,0,-85
27411,1,1,371,1485,1114
27412,0,0,13,0,-13
27413,1,1,1433,1205,-228
27414,0,0,53,0,-53
27415,0,0,167,0,-167
27416,1,0,0,0,0
27417,1,0,0,0,0
27418,1,1,1432,1204,-228
27419,1,0,225,0,-225
27420,1,0,72,0,-72
27421,0,0,53,0,-53
27422,1,1,448,2003,1555
27423,1,1,390,1465,1075
27424,1,1,236,2437,2201
27425,1,1,990,1457,467
27426,0,0,15,0,-15
27427,1,1,876,1279,403
27428,1,1,204,1232,1028
27429,1,0,67,0,-67
27430,1,0,1,0,-1
27431,1,0,28,0,-28
27432,0,0,44,0,-44
27433,0,0,22,0,-22
27434,1,1,1292,1406,114
27435,1,0,7,0,-7
27436,1,0,66,0,-66
27437,1,1,401,1206,805
27438,1,0,35,0,-35
27439,1,0,88,0,-88
27440,1,1,636,1554,918
27441,1,0,61,0,-61
27442,0,0,2,0,-2
27443,1,1,209,1285,1076
27444,1,1,13,1287,1274
27445,1,1,181,1204,1023
27446,1,1,1306,1344,38
27447,1,1,429,1335,906
27448,0,0,15,0,-15
27449,1,0,145,0,-145
27450,0,0,1,0,-1
27451,0,0,4,0,-4
27452,1,0,45,0,-45
27453,1,0,6,0,-6
27454,1,1,550,1362,812
27455,0,0,1,0,-1
27456,1,1,790,1334,544
27457,0,0,85,0,-85
27458,1,0,71,0,-71
27459,0,0,2,0,-2
27460,1,0,62,0,-62
27461,0,0,39,0,-39
27462,1,0,150,0,-150
27463,1,1,724,1280,556
27464,0,0,151,0,-151
27465,1,0,22,0,-22
27466,1,1,92,2443,2351
27467,1,0,101,0,-101
27468,1,1,727,1324,597
27469,0,0,64,0,-64
27470,0,0,107,0,-107
27471,1,1,319,1497,1178
27472,1,0,58,0,-58
27473,1,1,772,1396,624
27474,1,1,183,1206,1023
27475,1,1,1600,1710,110
27476,1,1,204,1664,1460
27477,1,1,590,1319,729
27478,0,0,9,0,-9
27479,1,0,0,0,0
27480,0,0,6,0,-6
27481,0,0,108,0,-108
27482,0,0,46,0,-46
27483,0,0,64,0,-64
27484,0,0,81,0,-81
27485,1,0,40,0,-40
27486,0,0,414,0,-414
27487,0,0,77,0,-77
27488,0,0,108,0,-108
27489,0,0,38,0,-38
27490,1,1,290,1349,1059
27491,1,0,23,0,-23
27492,0,0,16,0,-16
27493,1,1,190,1497,1307
27494,0,0,201,0,-201
27495,0,0,31,0,-31
27496,1,0,40,0,-40
27497,1,0,5,0,-5
27498,1,1,702,1830,1128
27499,1,1,1395,1705,310
27500,1,1,192,1412,1220
27501,1,1,1469,1549,80
27502,0,0,25,0,-25
27503,0,0,32,0,-32
27504,1,0,32,0,-32
27505,1,1,95,1283,1188
27506,0,0,14,0,-14
27507,1,0,1,0,-1
27508,1,0,77,0,-77
27509,1,0,68,0,-68
27510,0,0,31,0,-31
27511,0,0,1,0,-1
27512,0,0,26,0,-26
27513,1,0,42,0,-42
27514,0,0,0,0,0
27515,1,0,76,0,-76
27516,1,1,348,1528,1180
27517,0,0,1,0,-1
27518,0,0,58,0,-58
27519,0,0,39,0,-39
27520,1,1,337,1567,1230
27521,1,0,66,0,-66
27522,0,0,33,0,-33
27523,0,0,10,0,-10
27524,0,0,77,0,-77
27525,0,0,55,0,-55
27526,0,0,89,0,-89
27527,1,1,127,1457,1330
27528,0,0,34,0,-34
27529,0,0,2,0,-2
27530,1,0,11,0,-11
27531,0,0,61,0,-61
27532,0,0,37,0,-37
27533,1,0,14,0,-14
27534,1,1,641,1797,1156
27535,0,0,45,0,-45
27536,0,0,1,0,-1
27537,0,0,3,0,-3
27538,1,0,58,0,-58
27539,1,0,12,0,-12
27540,1,1,484,1330,846
27541,0,0,96,0,-96
27542,1,0,29,0,-29
27543,1,1,63,1932,1869
27544,1,1,353,1200,847
27545,0,0,42,0,-42
27546,1,1,1245,1808,563
27547,1,1,570,1521,951
27548,1,0,5,0,-5
27549,1,0,45,0,-45
27550,1,0,31,0,-31
27551,0,0,0,0,0
27552,1,0,23,0,-23
27553,1,0,26,0,-26
27554,0,0,4,0,-4
27555,1,0,18,0,-18
27556,1,0,115,0,-115
27557,1,0,67,0,-67
27558,0,0,9,0,-9
27559,1,0,163,0,-163
27560,1,0,143,0,-143
27561,1,1,597,1763,1166
27562,1,0,54,0,-54
27563,1,0,59,0,-59
27564,0,0,63,0,-63
27565,1,0,36,0,-36
27566,1,0,49,0,-49
27567,0,0,108,0,-108
27568,1,0,86,0,-86
27569,1,1,143,1243,1100
27570,0,0,6,0,-6
27571,0,0,42,0,-42
27572,1,0,40,0,-40
27573,1,1,483,1358,875
27574,0,0,48,0,-48
27575,0,0,42,0,-42
27576,0,0,7,0,-7
27577,1,1,249,1339,1090
27578,0,0,7,0,-7
27579,1,0,96,0,-96
27580,0,0,119,0,-119
27581,1,0,13,0,-13
27582,0,0,214,0,-214
27583,0,0,67,0,-67
27584,0,0,63,0,-63
27585,1,1,327,1282,955
27586,1,0,17,0,-17
27587,1,1,177,2153,1976
27588,1,0,59,0,-59
27589,1,1,346,2068,1722
27590,1,0,7,0,-7
27591,1,1,1228,1638,410
27592,0,0,55,0,-55
27593,0,0,20,0,-20
27594,1,1,1000,1439,439
27595,0,0,30,0,-30
27596,0,0,79,0,-79
27597,1,1,1591,1224,-367
27598,1,0,109,0,-109
27599,1,0,38,0,-38
27600,0,0,17,0,-17
27601,1,1,615,3716,3101
27602,1,0,41,0,-41
27603,0,0,68,0,-68
27604,1,1,380,1451,1071
27605,1,1,1086,1228,142
27606,1,1,115,1871,1756
27607,0,0,96,0,-96
27608,0,0,257,0,-257
27609,1,1,969,1402,433
27610,0,0,13,0,-13
27611,0,0,32,0,-32
27612,1,0,78,0,-78
27613,0,0,9,0,-9
27614,1,0,20,0,-20
27615,1,0,93,0,-93
27616,0,0,93,0,-93
27617,1,1,315,1475,1160
27618,1,1,186,1373,1187
27619,0,0,8,0,-8
27620,1,1,987,1334,347
27621,0,0,56,0,-56
27622,1,1,544,1357,813
27623,0,0,65,0,-65
27624,1,1,226,1455,1229
27625,1,1,33,1786,1753
27626,1,1,383,2115,1732
27627,1,1,459,1927,1468
27628,1,0,67,0,-67
27629,0,0,119,0,-119
27630,0,0,5,0,-5
27631,0,0,10,0,-10
27632,0,0,6,0,-6
27633,0,0,49,0,-49
27634,0,0,35,0,-35
27635,1,1,85,1519,1434
27636,0,0,19,0,-19
27637,1,0,2,0,-2
27638,1,0,3,0,-3
27639,0,0,74,0,-74
27640,1,0,46,0,-46
27641,1,1,183,1532,1349
27642,0,0,93,0,-93
27643,0,0,9,0,-9
27644,0,0,2,0,-2
27645,1,0,7,0,-7
27646,1,1,480,1764,1284
27647,0,0,70,0,-70
27648,1,0,17,0,-17
27649,0,0,13,0,-13
27650,0,0,82,0,-82
27651,1,1,288,1211,923
27652,1,1,76,2021,1945
27653,0,0,43,0,-43
27654,1,0,7,0,-7
27655,1,1,883,1689,806
27656,0,0,67,0,-67
27657,0,0,8,0,-8
27658,1,1,325,1219,894
27659,1,0,40,0,-40
27660,1,1,448,1459,1011
27661,1,1,179,1214,1035
27662,1,0,3,0,-3
27663,0,0,6,0,-6
27664,0,0,42,0,-42
27665,1,1,398,1235,837
27666,1,1,756,1572,816
27667,0,0,49,0,-49
27668,0,0,45,0,-45
27669,1,0,60,0,-60
27670,1,0,73,0,-73
27671,1,0,61,0,-61
27672,1,0,35,0,-35
27673,0,0,5,0,-5
27674,1,0,75,0,-75
27675,1,1,512,1502,990
27676,0,0,40,0,-40
27677,0,0,5,0,-5
27678,1,0,40,0,-40
27679,1,1,1445,1944,499
27680,1,0,16,0,-16
27681,1,0,22,0,-22
27682,1,0,18,0,-18
27683,0,0,92,0,-92
27684,1,0,57,0,-57
27685,0,0,18,0,-18
27686,1,0,0,0,0
27687,0,0,7,0,-7
27688,0,0,72,0,-72
27689,0,0,44,0,-44
27690,0,0,50,0,-50
27691,0,0,41,0,-41
27692,0,0,10,0,-10
27693,1,1,250,1355,1105
27694,1,0,39,0,-39
27695,1,0,180,0,-180
27696,1,0,69,0,-69
27697,1,0,54,0,-54
27698,0,0,38,0,-38
27699,0,0,37,0,-37
27700,1,0,111,0,-111
27701,1,0,95,0,-95
27702,1,1,784,1335,551
27703,0,0,110,0,-110
27704,1,1,876,1998,1122
27705,1,1,618,1370,752
27706,0,0,11,0,-11
27707,1,0,16,0,-16
27708,0,0,11,0,-11
27709,0,0,21,0,-21
27710,1,0,3,0,-3
27711,0,0,62,0,-62
27712,1,1,376,1561,1185
27713,1,1,1159,1261,102
27714,1,1,8,1358,1350
27715,1,1,226,3327,3101
27716,1,1,297,1737,1440
27717,0,0,58,0,-58
27718,1,1,1458,2174,716
27719,0,0,230,0,-230
27720,1,1,80,1334,1254
27721,0,0,65,0,-65
27722,0,0,19,0,-19
27723,1,1,580,2171,1591
27724,1,1,299,1480,1181
27725,1,1,294,2237,1943
27726,0,0,4,0,-4
27727,0,0,14,0,-14
27728,1,0,9,0,-9
27729,0,0,27,0,-27
27730,0,0,32,0,-32
27731,1,1,167,1214,1047
27732,1,1,200,1420,1220
27733,0,0,107,0,-107
27734,1,1,278,1405,1127
27735,0,0,45,0,-45
27736,0,0,98,0,-98
27737,0,0,146,0,-146
27738,1,1,1182,1258,76
27739,0,0,8,0,-8
27740,0,0,300,0,-300
27741,1,0,76,0,-76
27742,1,0,4,0,-4
27743,1,0,62,0,-62
27744,0,0,50,0,-50
27745,1,1,76,1316,1240
27746,1,0,25,0,-25
27747,1,0,14,0,-14
27748,0,0,82,0,-82
27749,1,1,1731,1211,-520
27750,1,0,3,0,-3
27751,1,0,9,0,-9
27752,1,1,1704,1499,-205
27753,0,0,22,0,-22
27754,1,1,528,1655,1127
27755,0,0,56,0,-56
27756,1,1,1233,1664,431
27757,1,0,159,0,-159
27758,1,1,849,1634,785
27759,1,0,2,0,-2
27760,1,0,13,0,-13
27761,1,1,638,1285,647
27762,0,0,46,0,-46
27763,1,1,387,1358,971
27764,1,0,8,0,-8
27765,1,1,1179,1856,677
27766,0,0,3,0,-3
27767,1,0,91,0,-91
27768,1,1,731,1415,684
27769,0,0,213,0,-213
27770,1,1,310,1209,899
27771,1,1,1676,1279,-397
27772,1,0,55,0,-55
27773,0,0,60,0,-60
27774,1,1,136,3090,2954
27775,0,0,86,0,-86
27776,1,0,75,0,-75
27777,1,0,45,0,-45
27778,0,0,7,0,-7
27779,1,1,182,1828,1646
27780,1,1,64,2508,2444
27781,1,1,81,1262,1181
27782,1,1,278,2768,2490
27783,0,0,9,0,-9
27784,1,1,752,1276,524
27785,0,0,25,0,-25
27786,1,1,1354,1209,-145
27787,1,1,763,1309,546
27788,0,0,83,0,-83
27789,1,0,28,0,-28
27790,1,1,722,1890,1168
27791,1,1,386,1324,938
27792,1,1,383,1749,1366
27793,1,1,104,1557,1453
27794,1,0,14,0,-14
27795,0,0,5,0,-5
27796,0,0,41,0,-41
27797,1,0,1,0,-1
27798,1,0,35,0,-35
27799,1,0,136,0,-136
27800,1,0,118,0,-118
27801,1,1,889,2076,1187
27802,1,1,543,1464,921
27803,1,1,24,1340,1316
27804,1,0,1,0,-1
27805,0,0,20,0,-20
27806,1,1,938,1617,679
27807,1,0,2,0,-2
27808,0,0,86,0,-86
27809,0,0,57,0,-57
27810,1,0,42,0,-42
27811,1,0,43,0,-43
27812,0,0,77,0,-77
27813,0,0,30,0,-30
27814,1,1,870,1614,744
27815,1,0,265,0,-265
27816,0,0,10,0,-10
27817,1,1,2762,1430,-1332
27818,1,0,175,0,-175
27819,1,1,456,1241,785
27820,0,0,171,0,-171
27821,0,0,64,0,-64
27822,1,0,20,0,-20
27823,1,1,227,1353,1126
27824,0,0,98,0,-98
27825,1,0,201,0,-201
27826,0,0,20,0,-20
27827,1,0,9,0,-9
27828,1,0,71,0,-71
27829,1,0,8,0,-8
27830,1,0,22,0,-22
27831,0,0,2,0,-2
27832,0,0,104,0,-104
27833,1,1,461,1234,773
27834,1,0,58,0,-58
27835,1,1,206,1429,1223
27836,1,0,16,0,-16
27837,0,0,74,0,-74
27838,0,0,40,0,-40
27839,0,0,390,0,-390
27840,0,0,49,0,-49
27841,0,0,68,0,-68
27842,0,0,4,0,-4
27843,1,0,22,0,-22
27844,0,0,2,0,-2
27845,1,1,1262,1218,-44
27846,1,0,39,0,-39
27847,0,0,12,0,-12
27848,1,0,73,0,-73
27849,1,1,35,1227,1192
27850,1,0,82,0,-82
27851,1,1,138,1723,1585
27852,0,0,17,0,-17
27853,0,0,16,0,-16
27854,1,0,29,0,-29
27855,0,0,40,0,-40
27856,0,0,31,0,-31
27857,0,0,20,0,-20
27858,0,0,201,0,-201
27859,1,1,1383,1300,-83
27860,1,1,106,1421,1315
27861,0,0,139,0,-139
27862,0,0,19,0,-19
27863,1,0,27,0,-27
27864,1,0,0,0,0
27865,1,1,163,1319,1156
27866,1,0,88,0,-88
27867,1,0,102,0,-102
27868,1,0,71,0,-71
27869,1,1,971,1213,242
27870,1,0,10,0,-10
27871,1,0,36,0,-36
27872,0,0,8,0,-8
27873,0,0,7,0,-7
27874,0,0,15,0,-15
27875,0,0,19,0,-19
27876,0,0,15,0,-15
27877,0,0,37,0,-37
27878,1,1,26,1255,1229
27879,1,0,19,0,-19
27880,1,0,128,0,-128
27881,0,0,42,0,-42
27882,1,1,622,1544,922
27883,1,0,17,0,-17
27884,0,0,0,0,0
27885,1,0,56,0,-56
27886,1,1,174,1775,1601
27887,1,1,175,1610,1435
27888,0,0,15,0,-15
27889,0,0,23,0,-23
27890,1,0,49,0,-49
27891,1,1,59,1576,1517
27892,1,1,946,2110,1164
27893,1,1,454,1534,1080
27894,1,0,79,0,-79
27895,1,0,1,0,-1
27896,0,0,30,0,-30
27897,0,0,63,0,-63
27898,0,0,142,0,-142
27899,0,0,29,0,-29
27900,0,0,3,0,-3
27901,1,1,125,1552,1427
27902,1,0,173,0,-173
27903,0,0,52,0,-52
27904,0,0,22,0,-22
27905,1,1,619,1363,744
27906,0,0,4,0,-4
27907,0,0,10,0,-10
27908,1,1,24,1578,1554
27909,1,0,25,0,-25
27910,1,1,874,1370,496
27911,0,0,33,0,-33
27912,1,1,337,1563,1226
27913,0,0,10,0,-10
27914,0,0,381,0,-381
27915,1,0,9,0,-9
27916,0,0,26,0,-26
27917,1,0,112,0,-112
27918,1,1,96,1588,1492
27919,0,0,43,0,-43
27920,0,0,13,0,-13
27921,1,1,747,1573,826
27922,0,0,43,0,-43
27923,1,0,14,0,-14
27924,1,0,65,0,-65
27925,0,0,6,0,-6
27926,1,1,84,2178,2094
27927,0,0,73,0,-73
27928,1,0,12,0,-12
27929,1,0,78,0,-78
27930,1,1,385,2271,1886
27931,0,0,69,0,-69
27932,0,0,117,0,-117
27933,1,1,782,1345,563
27934,1,1,124,1344,1220
27935,1,1,586,1419,833
27936,1,1,1280,1347,67
27937,0,0,59,0,-59
27938,1,0,57,0,-57
27939,0,0,23,0,-23
27940,0,0,37,0,-37
27941,1,1,1050,1222,172
27942,0,0,15,0,-15
27943,0,0,208,0,-208
27944,1,0,18,0,-18
27945,1,0,55,0,-55
27946,1,0,0,0,0
27947,1,0,18,0,-18
27948,1,1,331,3110,2779
27949,1,0,17,0,-17
27950,1,0,26,0,-26
27951,1,1,533,1217,684
27952,0,0,24,0,-24
27953,0,0,34,0,-34
27954,0,0,15,0,-15
27955,1,1,142,1986,1844
27956,0,0,14,0,-14
27957,0,0,144,0,-144
27958,1,1,719,1491,772
27959,1,0,82,0,-82
27960,1,0,44,0,-44
27961,0,0,23,0,-23
27962,1,0,108,0,-108
27963,1,1,342,1321,979
27964,1,0,41,0,-41
27965,1,1,99,2066,1967
27966,0,0,18,0,-18
27967,0,0,5,0,-5
27968,1,1,185,1306,1121
27969,0,0,2,0,-2
27970,1,1,1095,1267,172
27971,0,0,68,0,-68
27972,1,0,42,0,-42
27973,0,0,84,0,-84
27974,1,1,281,2053,1772
27975,0,0,10,0,-10
27976,1,0,0,0,0
27977,1,0,20,0,-20
27978,1,0,47,0,-47
27979,1,0,12,0,-12
27980,1,0,84,0,-84
27981,1,1,483,1476,993
27982,1,1,1035,1311,276
27983,1,0,49,0,-49
27984,1,0,76,0,-76
27985,1,1,496,2166,1670
27986,1,0,34,0,-34
27987,1,1,106,1872,1766
27988,1,0,19,0,-19
27989,0,0,4,0,-4
27990,1,0,65,0,-65
27991,1,1,132,1296,1164
27992,1,1,288,1323,1035
27993,0,0,6,0,-6
27994,0,0,9,0,-9
27995,1,1,1200,2763,1563
27996,1,1,593,1279,686
27997,1,0,0,0,0
27998,0,0,20,0,-20
27999,1,1,275,1518,1243
28000,0,0,28,0,-28
28001,0,0,45,0,-45
28002,0,0,54,0,-54
28003,1,0,0,0,0
28004,0,0,38,0,-38
28005,0,0,35,0,-35
28006,0,0,154,0,-154
28007,0,0,12,0,-12
28008,0,0,2,0,-2
28009,0,0,69,0,-69
28010,1,0,45,0,-45
28011,1,0,27,0,-27
28012,1,0,131,0,-131
28013,0,0,23,0,-23
28014,1,0,10,0,-10
28015,1,0,55,0,-55
28016,1,1,81,2039,1958
28017,0,0,42,0,-42
28018,0,0,41,0,-41
28019,1,1,1324,2367,1043
28020,0,0,20,0,-20
28021,1,0,15,0,-15
28022,1,1,479,1298,819
28023,1,1,117,1326,1209
28024,1,1,395,2022,1627
28025,0,0,153,0,-153
28026,0,0,7,0,-7
28027,1,1,525,1769,1244
28028,1,0,65,0,-65
28029,1,1,1000,1684,684
28030,1,0,8,0,-8
28031,1,0,50,0,-50
28032,1,0,35,0,-35
28033,0,0,102,0,-102
28034,0,0,26,0,-26
28035,1,1,129,1274,1145
28036,1,1,788,4830,4042
28037,1,1,95,1209,1114
28038,1,1,1395,2358,963
28039,1,1,122,2367,2245
28040,1,0,327,0,-327
28041,1,0,67,0,-67
28042,1,1,559,1358,799
28043,1,1,415,1498,1083
28044,1,0,38,0,-38
28045,1,0,30,0,-30
28046,1,1,454,1518,1064
28047,1,0,2,0,-2
28048,1,1,821,1536,715
28049,1,0,21,0,-21
28050,0,0,74,0,-74
28051,0,0,23,0,-23
28052,1,1,120,2726,2606
28053,1,1,603,1454,851
28054,0,0,115,0,-115
28055,1,1,300,1461,1161
28056,1,0,22,0,-22
28057,0,0,45,0,-45
28058,1,0,25,0,-25
28059,1,0,67,0,-67
28060,0,0,132,0,-132
28061,1,1,310,1413,1103
28062,1,1,419,1309,890
28063,0,0,16,0,-16
28064,1,1,161,2736,2575
28065,1,1,135,2815,2680
28066,1,0,88,0,-88
28067,1,1,80,1655,1575
28068,1,0,247,0,-247
28069,1,1,71,1579,1508
28070,0,0,9,0,-9
28071,1,1,368,1405,1037
28072,1,0,125,0,-125
28073,0,0,71,0,-71
28074,0,0,111,0,-111
28075,1,1,878,1459,581
28076,1,0,67,0,-67
28077,1,1,136,1675,1539
28078,1,1,71,1913,1842
28079,1,1,43,1225,1182
28080,0,0,1,0,-1
28081,1,1,408,1445,1037
28082,1,1,280,1583,1303
28083,0,0,2,0,-2
28084,1,1,514,1290,776
28085,1,0,0,0,0
28086,0,0,11,0,-11
28087,0,0,21,0,-21
28088,1,1,447,1513,1066
28089,0,0,12,0,-12
28090,0,0,85,0,-85
28091,0,0,0,0,0
28092,0,0,10,0,-10
28093,1,0,170,0,-170
28094,1,0,21,0,-21
28095,0,0,178,0,-178
28096,0,0,123,0,-123
28097,1,1,499,1304,805
28098,0,0,19,0,-19
28099,0,0,34,0,-34
28100,0,0,0,0,0
28101,1,0,45,0,-45
28102,1,0,16,0,-16
28103,0,0,69,0,-69
28104,1,1,689,1245,556
28105,1,1,82,1285,1203
28106,1,0,18,0,-18
28107,0,0,28,0,-28
28108,1,0,0,0,0
28109,0,0,19,0,-19
28110,1,0,56,0,-56
28111,0,0,19,0,-19
28112,1,1,1614,1211,-403
28113,1,1,422,1547,1125
28114,1,1,283,1240,957
28115,1,0,22,0,-22
28116,0,0,50,0,-50
28117,1,0,104,0,-104
28118,1,0,44,0,-44
28119,1,1,349,1581,1232
28120,0,0,78,0,-78
28121,1,1,8,3083,3075
28122,1,0,20,0,-20
28123,1,1,190,1456,1266
28124,0,0,29,0,-29
28125,1,0,43,0,-43
28126,0,0,71,0,-71
28127,1,0,1,0,-1
28128,0,0,55,0,-55
28129,0,0,14,0,-14
28130,0,0,61,0,-61
28131,0,0,3,0,-3
28132,1,1,354,1488,1134
28133,0,0,180,0,-180
28134,1,0,1,0,-1
28135,1,0,34,0,-34
28136,0,0,290,0,-290
28137,1,0,14,0,-14
28138,1,0,24,0,-24
28139,1,0,13,0,-13
28140,1,0,119,0,-119
28141,1,0,2,0,-2
28142,1,1,71,1399,1328
28143,1,1,379,1464,1085
28144,0,0,29,0,-29
28145,0,0,96,0,-96
28146,0,0,50,0,-50
28147,1,0,39,0,-39
28148,0,0,12,0,-12
28149,1,0,4,0,-4
28150,1,1,677,1279,602
28151,1,1,1003,1736,733
28152,1,0,122,0,-122
28153,1,1,733,1449,716
28154,0,0,13,0,-13
28155,1,0,26,0,-26
28156,0,0,22,0,-22
28157,1,0,90,0,-90
28158,1,1,163,1309,1146
28159,1,0,12,0,-12
28160,1,0,15,0,-15
28161,0,0,37,0,-37
28162,0,0,35,0,-35
28163,1,0,16,0,-16
28164,1,0,136,0,-136
28165,1,0,46,0,-46
28166,0,0,5,0,-5
28167,1,0,61,0,-61
28168,0,0,130,0,-130
28169,1,1,337,1271,934
28170,1,0,77,0,-77
28171,1,0,76,0,-76
28172,1,0,44,0,-44
28173,0,0,5,0,-5
28174,0,0,60,0,-60
28175,0,0,1,0,-1
28176,1,1,1178,2022,844
28177,0,0,6,0,-6
28178,1,1,708,2892,2184
28179,1,0,18,0,-18
28180,0,0,114,0,-114
28181,1,1,83,1242,1159
28182,0,0,83,0,-83
28183,1,0,6,0,-6
28184,0,0,101,0,-101
28185,1,0,7,0,-7
28186,0,0,51,0,-51
28187,1,1,75,1397,1322
28188,0,0,50,0,-50
28189,0,0,53,0,-53
28190,1,0,1,0,-1
28191,1,1,94,2588,2494
28192,0,0,9,0,-9
28193,1,1,623,1376,753
28194,1,1,648,1679,1031
28195,1,1,105,1331,1226
28196,0,0,145,0,-145
28197,1,1,985,1406,421
28198,1,1,514,1208,694
28199,1,1,378,1231,853
28200,0,0,10,0,-10
28201,0,0,23,0,-23
28202,0,0,51,0,-51
28203,0,0,25,0,-25
28204,0,0,51,0,-51
28205,1,0,29,0,-29
28206,1,1,255,1208,953
28207,1,1,514,1210,696
28208,0,0,15,0,-15
28209,1,0,22,0,-22
28210,0,0,107,0,-107
28211,0,0,71,0,-71
28212,1,0,41,0,-41
28213,0,0,32,0,-32
28214,1,1,207,1570,1363
28215,1,0,42,0,-42
28216,0,0,52,0,-52
28217,1,0,1,0,-1
28218,1,1,653,1400,747
28219,1,1,772,1293,521
28220,0,0,51,0,-51
28221,0,0,33,0,-33
28222,1,1,129,1717,1588
28223,1,0,29,0,-29
28224,1,0,5,0,-5
28225,1,1,321,1516,1195
28226,1,0,50,0,-50
28227,1,0,3,0,-3
28228,1,0,24,0,-24
28229,1,0,101,0,-101
28230,0,0,264,0,-264
28231,1,1,336,1503,1167
28232,0,0,81,0,-81
28233,1,1,319,1210,891
28234,0,0,5,0,-5
28235,0,0,105,0,-105
28236,1,1,73,1426,1353
28237,0,0,38,0,-38
28238,0,0,18,0,-18
28239,1,1,84,1451,1367
28240,0,0,67,0,-67
28241,1,1,266,1226,960
28242,1,0,36,0,-36
28243,1,0,33,0,-33
28244,0,0,20,0,-20
28245,1,0,75,0,-75
28246,1,0,403,0,-403
28247,0,0,26,0,-26
28248,0,0,110,0,-110
28249,1,1,1350,1261,-89
28250,1,1,366,1453,1087
28251,0,0,55,0,-55
28252,1,0,22,0,-22
28253,0,0,59,0,-59
28254,1,0,95,0,-95
28255,1,1,916,1255,339
28256,1,0,52,0,-52
28257,0,0,22,0,-22
28258,1,1,358,1782,1424
28259,0,0,78,0,-78
28260,1,1,190,1482,1292
28261,1,0,8,0,-8
28262,0,0,13,0,-13
28263,1,0,72,0,-72
28264,0,0,17,0,-17
28265,0,0,10,0,-10
28266,1,0,42,0,-42
28267,1,1,486,1273,787
28268,0,0,0,0,0
28269,1,1,510,1489,979
28270,1,1,615,1379,764
28271,1,0,11,0,-11
28272,0,0,167,0,-167
28273,1,1,272,1433,1161
28274,0,0,56,0,-56
28275,1,1,95,1530,1435
28276,1,1,498,2725,2227
28277,1,0,143,0,-143
28278,1,0,71,0,-71
28279,1,1,155,1620,1465
28280,1,0,69,0,-69
28281,0,0,6,0,-6
28282,1,0,293,0,-293
28283,1,1,297,1522,1225
28284,1,1,741,3419,2678
28285,0,0,120,0,-120
28286,1,0,17,0,-17
28287,1,1,1648,1381,-267
28288,1,0,41,0,-41
28289,1,0,2,0,-2
28290,1,1,703,2092,1389
28291,0,0,7,0,-7
28292,1,1,1182,1352,170
28293,1,0,105,0,-105
28294,0,0,5,0,-5
28295,1,0,83,0,-83
28296,1,1,1259,3555,2296
28297,0,0,35,0,-35
28298,0,0,69,0,-69
28299,1,0,124,0,-124
28300,0,0,40,0,-40
28301,1,0,43,0,-43
28302,0,0,39,0,-39
28303,0,0,59,0,-59
28304,0,0,1,0,-1
28305,1,1,187,1369,1182
28306,0,0,15,0,-15
28307,0,0,29,0,-29
28308,1,1,374,2195,1821
28309,0,0,40,0,-40
28310,0,0,39,0,-39
28311,1,1,138,1258,1120
28312,0,0,117,0,-117
28313,1,1,168,2024,1856
28314,1,1,286,1259,973
28315,0,0,9,0,-9
28316,0,0,12,0,-12
28317,1,0,41,0,-41
28318,1,0,40,0,-40
28319,1,1,748,1474,726
28320,1,0,55,0,-55
28321,1,1,92,1842,1750
28322,1,1,2833,1533,-1300
28323,0,0,136,0,-136
28324,1,0,72,0,-72
28325,1,0,9,0,-9
28326,1,1,2268,1340,-928
28327,1,1,447,1236,789
28328,0,0,60,0,-60
28329,0,0,16,0,-16
28330,0,0,51,0,-51
28331,0,0,176,0,-176
28332,1,1,4,1632,1628
28333,0,0,113,0,-113
28334,1,0,31,0,-31
28335,0,0,7,0,-7
28336,1,1,1053,1702,649
28337,0,0,46,0,-46
28338,0,0,9,0,-9
28339,0,0,47,0,-47
28340,1,1,114,1316,1202
28341,1,0,20,0,-20
28342,1,0,25,0,-25
28343,1,1,1351,3235,1884
28344,0,0,5,0,-5
28345,1,1,2737,1406,-1331
28346,0,0,71,0,-71
28347,0,0,7,0,-7
28348,0,0,30,0,-30
28349,1,1,2269,1830,-439
28350,1,1,490,1446,956
28351,0,0,11,0,-11
28352,0,0,55,0,-55
28353,0,0,1,0,-1
28354,1,0,15,0,-15
28355,1,1,631,1279,648
28356,1,0,113,0,-113
28357,1,0,28,0,-28
28358,1,1,330,1365,1035
28359,1,0,12,0,-12
28360,0,0,15,0,-15
28361,0,0,42,0,-42
28362,0,0,7,0,-7
28363,1,0,51,0,-51
28364,0,0,39,0,-39
28365,1,1,1163,2013,850
28366,0,0,35,0,-35
28367,1,0,20,0,-20
28368,1,1,279,1520,1241
28369,0,0,9,0,-9
28370,0,0,7,0,-7
28371,1,1,1913,1797,-116
28372,1,1,973,1527,554
28373,1,0,126,0,-126
28374,1,0,2,0,-2
28375,1,0,57,0,-57
28376,1,1,1056,3062,2006
28377,0,0,164,0,-164
28378,1,1,486,1272,786
28379,0,0,13,0,-13
28380,1,1,717,1696,979
28381,0,0,43,0,-43
28382,0,0,156,0,-156
28383,1,0,20,0,-20
28384,0,0,1,0,-1
28385,1,1,548,1203,655
28386,1,0,276,0,-276
28387,0,0,14,0,-14
28388,0,0,28,0,-28
28389,1,1,521,1682,1161
28390,0,0,56,0,-56
28391,0,0,2,0,-2
28392,1,0,22,0,-22
28393,0,0,8,0,-8
28394,1,1,514,1478,964
28395,0,0,27,0,-27
28396,1,0,72,0,-72
28397,1,0,85,0,-85
28398,1,0,7,0,-7
28399,1,1,1561,1897,336
28400,1,0,2,0,-2
28401,1,0,19,0,-19
28402,1,1,1934,1461,-473
28403,1,1,435,1229,794
28404,0,0,103,0,-103
28405,1,0,11,0,-11
28406,1,0,16,0,-16
28407,1,1,144,1499,1355
28408,0,0,110,0,-110
28409,0,0,17,0,-17
28410,1,1,112,1409,1297
28411,1,0,3,0,-3
28412,1,1,30,1614,1584
28413,0,0,106,0,-106
28414,1,1,764,1425,661
28415,0,0,27,0,-27
28416,0,0,41,0,-41
28417,1,0,6,0,-6
28418,1,1,73,2081,2008
28419,0,0,9,0,-9
28420,0,0,166,0,-166
28421,0,0,47,0,-47
28422,1,1,954,1224,270
28423,1,1,1230,1666,436
28424,1,1,59,1414,1355
28425,0,0,5,0,-5
28426,1,1,716,1262,546
28427,0,0,22,0,-22
28428,1,0,5,0,-5
28429,1,1,196,1487,1291
28430,1,0,12,0,-12
28431,1,0,1,0,-1
28432,0,0,161,0,-161
28433,1,0,39,0,-39
28434,1,1,809,1331,522
28435,0,0,7,0,-7
28436,1,0,5,0,-5
28437,1,0,69,0,-69
28438,1,1,408,1447,1039
28439,0,0,80,0,-80
28440,0,0,116,0,-116
28441,1,0,80,0,-80
28442,1,1,204,1473,1269
28443,1,0,118,0,-118
28444,1,1,150,1362,1212
28445,1,0,10,0,-10
28446,1,1,972,1458,486
28447,1,1,679,1203,524
28448,1,1,43,1461,1418
28449,1,0,4,0,-4
28450,1,1,905,1431,526
28451,0,0,27,0,-27
28452,1,0,10,0,-10
28453,0,0,58,0,-58
28454,1,1,1114,1268,154
28455,1,0,127,0,-127
28456,0,0,63,0,-63
28457,1,0,44,0,-44
28458,1,1,803,1573,770
28459,1,0,112,0,-112
28460,1,0,98,0,-98
28461,1,0,38,0,-38
28462,1,0,49,0,-49
28463,1,1,252,1336,1084
28464,0,0,43,0,-43
28465,0,0,2,0,-2
28466,1,1,298,1490,1192
28467,0,0,19,0,-19
28468,1,1,77,1334,1257
28469,1,1,153,2918,2765
28470,1,1,72,1652,1580
28471,0,0,30,0,-30
28472,0,0,50,0,-50
28473,0,0,168,0,-168
28474,1,0,9,0,-9
28475,0,0,90,0,-90
28476,1,1,891,1257,366
28477,1,0,9,0,-9
28478,1,1,104,2350,2246
28479,0,0,75,0,-75
28480,1,0,68,0,-68
28481,1,1,951,1214,263
28482,1,0,56,0,-56
28483,1,0,8,0,-8
28484,1,1,2135,2234,99
28485,1,1,939,1206,267
28486,1,1,1014,1361,347
28487,1,1,49,2640,2591
28488,1,0,8,0,-8
28489,1,0,35,0,-35
28490,0,0,18,0,-18
28491,0,0,9,0,-9
28492,1,1,617,1781,1164
28493,1,0,53,0,-53
28494,0,0,13,0,-13
28495,0,0,62,0,-62
28496,1,0,49,0,-49
28497,1,0,6,0,-6
28498,1,1,36,1274,1238
28499,1,1,612,1416,804
28500,1,1,63,1217,1154
28501,1,0,0,0,0
28502,1,1,201,1481,1280
28503,1,0,178,0,-178
28504,1,1,44,1303,1259
28505,0,0,55,0,-55
28506,0,0,14,0,-14
28507,0,0,17,0,-17
28508,0,0,15,0,-15
28509,0,0,27,0,-27
28510,1,1,154,1353,1199
28511,1,1,335,1315,980
28512,0,0,24,0,-24
28513,1,1,22,1738,1716
28514,0,0,5,0,-5
28515,1,0,73,0,-73
28516,1,0,54,0,-54
28517,1,0,23,0,-23
28518,0,0,48,0,-48
28519,1,1,47,2311,2264
28520,0,0,3,0,-3
28521,0,0,4,0,-4
28522,1,0,7,0,-7
28523,0,0,82,0,-82
28524,0,0,52,0,-52
28525,0,0,42,0,-42
28526,1,0,60,0,-60
28527,1,0,63,0,-63
28528,0,0,112,0,-112
28529,1,0,21,0,-21
28530,1,1,77,1817,1740
28531,0,0,2,0,-2
28532,0,0,16,0,-16
28533,1,1,464,1748,1284
28534,0,0,39,0,-39
28535,0,0,68,0,-68
28536,0,0,23,0,-23
28537,0,0,131,0,-131
28538,0,0,83,0,-83
28539,1,1,357,1724,1367
28540,1,1,204,1245,1041
28541,0,0,33,0,-33
28542,1,0,33,0,-33
28543,1,0,60,0,-60
28544,1,0,40,0,-40
28545,0,0,39,0,-39
28546,0,0,102,0,-102
28547,0,0,59,0,-59
28548,0,0,110,0,-110
28549,1,0,11,0,-11
28550,1,0,118,0,-118
28551,0,0,44,0,-44
28552,0,0,59,0,-59
28553,1,0,52,0,-52
28554,0,0,24,0,-24
28555,0,0,78,0,-78
28556,1,0,63,0,-63
28557,1,0,48,0,-48
28558,1,0,60,0,-60
28559,0,0,64,0,-64
28560,1,1,31,1603,1572
28561,1,0,82,0,-82
28562,0,0,22,0,-22
28563,1,0,72,0,-72
28564,0,0,52,0,-52
28565,1,1,113,1228,1115
28566,1,1,319,1760,1441
28567,1,1,680,2094,1414
28568,0,0,37,0,-37
28569,0,0,28,0,-28
28570,1,0,114,0,-114
28571,0,0,91,0,-91
28572,1,1,470,1218,748
28573,0,0,88,0,-88
28574,0,0,29,0,-29
28575,1,0,41,0,-41
28576,1,0,22,0,-22
28577,0,0,51,0,-51
28578,1,0,179,0,-179
28579,0,0,5,0,-5
28580,1,0,7,0,-7
28581,0,0,15,0,-15
28582,1,1,55,1315,1260
28583,1,0,23,0,-23
28584,1,1,99,2682,2583
28585,1,1,972,2007,1035
28586,1,1,618,2376,1758
28587,0,0,84,0,-84
28588,1,0,28,0,-28
28589,1,0,40,0,-40
28590,0,0,210,0,-210
28591,1,0,5,0,-5
28592,1,0,10,0,-10
28593,1,1,391,1452,1061
28594,1,1,683,1550,867
28595,0,0,7,0,-7
28596,1,0,11,0,-11
28597,1,0,17,0,-17
28598,1,0,34,0,-34
28599,1,0,94,0,-94
28600,0,0,135,0,-135
28601,1,1,122,1564,1442
28602,1,0,35,0,-35
28603,1,1,1378,1350,-28
28604,1,1,1608,1287,-321
28605,1,1,385,1224,839
28606,1,0,83,0,-83
28607,0,0,62,0,-62
28608,1,1,2371,1483,-888
28609,1,1,926,1292,366
28610,1,1,549,1979,1430
28611,1,1,837,2061,1224
28612,1,1,132,1288,1156
28613,1,1,3226,1224,-2002
28614,1,1,240,1750,1510
28615,0,0,17,0,-17
28616,1,1,1243,1462,219
28617,0,0,36,0,-36
28618,1,1,1540,1238,-302
28619,1,1,1574,1605,31
28620,1,0,14,0,-14
28621,1,0,37,0,-37
28622,1,1,719,1809,1090
28623,0,0,8,0,-8
28624,1,0,24,0,-24
28625,1,0,30,0,-30
28626,1,1,499,2031,1532
28627,1,0,21,0,-21
28628,1,0,19,0,-19
28629,0,0,17,0,-17
28630,1,1,299,1280,981
28631,1,1,276,1575,1299
28632,0,0,237,0,-237
28633,1,0,23,0,-23
28634,1,1,181,1525,1344
28635,1,0,3,0,-3
28636,1,0,23,0,-23
28637,1,0,39,0,-39
28638,1,0,36,0,-36
28639,1,0,19,0,-19
28640,1,0,62,0,-62
28641,1,0,14,0,-14
28642,1,0,37,0,-37
28643,0,0,25,0,-25
28644,1,1,298,1263,965
28645,1,1,179,1299,1120
28646,1,1,40,1316,1276
28647,1,1,320,1530,1210
28648,1,0,44,0,-44
28649,1,0,1,0,-1
28650,0,0,102,0,-102
28651,1,1,1505,2723,1218
28652,0,0,29,0,-29
28653,1,1,1281,2038,757
28654,0,0,168,0,-168
28655,1,1,494,1836,1342
28656,0,0,40,0,-40
28657,0,0,25,0,-25
28658,1,1,708,1440,732
28659,1,1,1137,2255,1118
28660,1,0,82,0,-82
28661,1,0,83,0,-83
28662,1,1,742,1283,541
28663,0,0,22,0,-22
28664,0,0,5,0,-5
28665,1,0,61,0,-61
28666,1,0,0,0,0
28667,0,0,96,0,-96
28668,0,0,87,0,-87
28669,1,1,36,6335,6299
28670,0,0,6,0,-6
28671,1,0,9,0,-9
28672,0,0,31,0,-31
28673,1,0,104,0,-104
28674,0,0,28,0,-28
28675,1,0,74,0,-74
28676,1,1,230,2427,2197
28677,0,0,35,0,-35
28678,1,0,178,0,-178
28679,0,0,13,0,-13
28680,0,0,67,0,-67
28681,1,0,73,0,-73
28682,0,0,35,0,-35
28683,1,0,9,0,-9
28684,1,1,389,2340,1951
28685,1,0,54,0,-54
28686,1,1,44,1282,1238
28687,1,1,142,2114,1972
28688,0,0,211,0,-211
28689,1,1,918,1328,410
28690,1,0,96,0,-96
28691,0,0,31,0,-31
28692,0,0,182,0,-182
28693,1,1,185,1275,1090
28694,1,1,161,2166,2005
28695,1,1,749,1285,536
28696,1,1,289,1296,1007
28697,0,0,118,0,-118
28698,1,0,159,0,-159
28699,1,0,75,0,-75
28700,1,0,18,0,-18
28701,0,0,45,0,-45
28702,1,1,254,2171,1917
28703,1,1,511,1898,1387
28704,1,0,45,0,-45
28705,1,1,1264,1329,65
28706,0,0,47,0,-47
28707,0,0,42,0,-42
28708,0,0,56,0,-56
28709,1,0,79,0,-79
28710,1,1,203,1906,1703
28711,1,0,19,0,-19
28712,1,0,10,0,-10
28713,1,0,8,0,-8
28714,1,0,49,0,-49
28715,0,0,80,0,-80
28716,0,0,14,0,-14
28717,0,0,20,0,-20
28718,0,0,25,0,-25
28719,1,0,25,0,-25
28720,1,0,43,0,-43
28721,1,1,151,2788,2637
28722,0,0,6,0,-6
28723,1,1,19,1286,1267
28724,1,1,331,1391,1060
28725,1,0,68,0,-68
28726,0,0,29,0,-29
28727,1,1,354,1220,866
28728,1,0,6,0,-6
28729,0,0,122,0,-122
28730,1,0,7,0,-7
28731,1,0,165,0,-165
28732,1,1,80,1644,1564
28733,0,0,7,0,-7
28734,1,1,257,1793,1536
28735,0,0,36,0,-36
28736,1,0,20,0,-20
28737,0,0,56,0,-56
28738,1,1,320,1520,1200
28739,0,0,5,0,-5
28740,1,1,1251,1269,18
28741,1,0,1,0,-1
28742,0,0,55,0,-55
28743,0,0,67,0,-67
28744,0,0,58,0,-58
28745,1,1,149,1351,1202
28746,0,0,28,0,-28
28747,0,0,75,0,-75
28748,0,0,13,0,-13
28749,0,0,30,0,-30
28750,0,0,143,0,-143
28751,1,1,261,1289,1028
28752,0,0,24,0,-24
28753,0,0,54,0,-54
28754,1,0,76,0,-76
28755,0,0,61,0,-61
28756,0,0,9,0,-9
28757,1,0,7,0,-7
28758,1,0,23,0,-23
28759,0,0,9,0,-9
28760,1,0,11,0,-11
28761,1,0,32,0,-32
28762,1,0,1,0,-1
28763,0,0,72,0,-72
28764,1,1,94,1624,1530
28765,1,0,17,0,-17
28766,1,0,4,0,-4
28767,0,0,8,0,-8
28768,1,1,46,1617,1571
28769,0,0,32,0,-32
28770,1,1,897,1404,507
28771,0,0,1,0,-1
28772,1,0,70,0,-70
28773,1,0,22,0,-22
28774,0,0,30,0,-30
28775,1,1,156,1211,1055
28776,1,1,425,1246,821
28777,1,0,43,0,-43
28778,0,0,2,0,-2
28779,1,0,89,0,-89
28780,0,0,28,0,-28
28781,0,0,17,0,-17
28782,1,0,81,0,-81
28783,0,0,13,0,-13
28784,0,0,96,0,-96
28785,1,0,12,0,-12
28786,1,0,74,0,-74
28787,1,1,308,1209,901
28788,1,1,12,1603,1591
28789,1,1,162,1206,1044
28790,1,0,38,0,-38
28791,1,1,1253,1207,-46
28792,1,0,76,0,-76
28793,0,0,36,0,-36
28794,0,0,67,0,-67
28795,0,0,21,0,-21
28796,1,0,217,0,-217
28797,0,0,93,0,-93
28798,0,0,69,0,-69
28799,1,0,23,0,-23
28800,1,0,42,0,-42
28801,1,1,385,1957,1572
28802,0,0,4,0,-4
28803,1,0,27,0,-27
28804,0,0,81,0,-81
28805,0,0,54,0,-54
28806,0,0,18,0,-18
28807,1,1,241,1354,1113
28808,1,1,1013,1349,336
28809,1,0,109,0,-109
28810,0,0,121,0,-121
28811,0,0,1,0,-1
28812,1,1,87,1310,1223
28813,1,1,1827,1562,-265
28814,0,0,27,0,-27
28815,1,1,316,1348,1032
28816,1,1,157,2126,1969
28817,0,0,56,0,-56
28818,1,1,277,1640,1363
28819,0,0,0,0,0
28820,1,0,32,0,-32
28821,1,0,60,0,-60
28822,0,0,18,0,-18
28823,0,0,35,0,-35
28824,0,0,2,0,-2
28825,1,0,16,0,-16
28826,1,1,91,1997,1906
28827,0,0,122,0,-122
28828,1,0,56,0,-56
28829,0,0,12,0,-12
28830,1,0,20,0,-20
28831,1,1,184,1745,1561
28832,1,1,299,1618,1319
28833,1,0,3,0,-3
28834,1,1,1638,1313,-325
28835,1,0,27,0,-27
28836,0,0,40,0,-40
28837,0,0,18,0,-18
28838,0,0,39,0,-39
28839,0,0,34,0,-34
28840,0,0,202,0,-202
28841,0,0,142,0,-142
28842,1,0,2,0,-2
28843,0,0,43,0,-43
28844,0,0,40,0,-40
28845,0,0,72,0,-72
28846,1,0,21,0,-21
28847,1,0,18,0,-18
28848,1,1,338,1784,1446
28849,1,1,354,1338,984
28850,0,0,3,0,-3
28851,0,0,32,0,-32
28852,0,0,22,0,-22
28853,1,0,36,0,-36
28854,0,0,28,0,-28
28855,1,1,1320,1665,345
28856,0,0,158,0,-158
28857,1,0,170,0,-170
28858,0,0,37,0,-37
28859,1,1,1342,1339,-3
28860,0,0,16,0,-16
28861,1,0,49,0,-49
28862,0,0,20,0,-20
28863,0,0,8,0,-8
28864,1,1,358,1503,1145
28865,0,0,36,0,-36
28866,0,0,44,0,-44
28867,1,0,56,0,-56
28868,1,1,420,2274,1854
28869,1,1,1713,1488,-225
28870,1,1,908,1258,350
28871,0,0,82,0,-82
28872,1,1,246,1412,1166
28873,1,0,31,0,-31
28874,1,1,373,1298,925
28875,0,0,138,0,-138
28876,1,0,97,0,-97
28877,0,0,53,0,-53
28878,0,0,2,0,-2
28879,1,1,794,1200,406
28880,1,0,54,0,-54
28881,1,0,13,0,-13
28882,1,0,14,0,-14
28883,0,0,27,0,-27
28884,1,1,10,1353,1343
28885,0,0,100,0,-100
28886,0,0,3,0,-3
28887,1,1,595,1445,850
28888,0,0,3,0,-3
28889,1,1,131,1441,1310
28890,1,1,90,1342,1252
28891,1,1,151,1406,1255
28892,0,0,7,0,-7
28893,0,0,22,0,-22
28894,1,0,33,0,-33
28895,1,1,214,1246,1032
28896,1,1,387,1303,916
28897,1,1,166,1481,1315
28898,1,1,622,1831,1209
28899,0,0,79,0,-79
28900,0,0,16,0,-16
28901,1,0,93,0,-93
28902,1,1,882,1322,440
28903,1,1,171,1380,1209
28904,1,1,357,3354,2997
28905,1,1,139,1323,1184
28906,1,1,718,1673,955
28907,0,0,40,0,-40
28908,1,1,163,1549,1386
28909,0,0,46,0,-46
28910,1,0,25,0,-25
28911,1,0,32,0,-32
28912,1,0,30,0,-30
28913,0,0,40,0,-40
28914,1,1,613,1242,629
28915,1,0,72,0,-72
28916,0,0,52,0,-52
28917,1,1,1454,1310,-144
28918,0,0,18,0,-18
28919,1,0,27,0,-27
28920,1,1,984,1272,288
28921,1,0,66,0,-66
28922,1,0,43,0,-43
28923,0,0,29,0,-29
28924,0,0,53,0,-53
28925,1,1,324,2942,2618
28926,1,1,112,1360,1248
28927,1,1,637,1865,1228
28928,1,0,23,0,-23
28929,1,1,332,1521,1189
28930,1,0,20,0,-20
28931,1,1,954,1222,268
28932,1,1,414,1551,1137
28933,1,0,17,0,-17
28934,1,0,12,0,-12
28935,0,0,58,0,-58
28936,0,0,134,0,-134
28937,0,0,11,0,-11
28938,1,0,57,0,-57
28939,1,0,22,0,-22
28940,0,0,13,0,-13
28941,1,1,149,1575,1426
28942,0,0,5,0,-5
28943,0,0,50,0,-50
28944,0,0,28,0,-28
28945,1,0,44,0,-44
28946,1,0,80,0,-80
28947,0,0,3,0,-3
28948,0,0,62,0,-62
28949,1,0,32,0,-32
28950,1,1,1024,1532,508
28951,1,1,222,1389,1167
28952,0,0,57,0,-57
28953,1,0,99,0,-99
28954,1,1,192,1303,1111
28955,1,0,101,0,-101
28956,0,0,15,0,-15
28957,0,0,135,0,-135
28958,1,0,9,0,-9
28959,1,0,20,0,-20
28960,0,0,93,0,-93
28961,1,0,19,0,-19
28962,1,1,1181,1318,137
28963,0,0,24,0,-24
28964,1,1,816,1689,873
28965,1,1,1055,1364,309
28966,1,0,19,0,-19
28967,0,0,24,0,-24
28968,0,0,3,0,-3
28969,1,0,28,0,-28
28970,0,0,62,0,-62
28971,1,1,151,1242,1091
28972,0,0,74,0,-74
28973,1,1,488,1535,1047
28974,1,1,1213,1234,21
28975,1,1,174,1840,1666
28976,0,0,257,0,-257
28977,1,0,40,0,-40
28978,1,0,11,0,-11
28979,1,1,310,1282,972
28980,1,1,49,1410,1361
28981,0,0,83,0,-83
28982,1,0,65,0,-65
28983,1,1,46,1236,1190
28984,0,0,156,0,-156
28985,0,0,76,0,-76
28986,1,1,70,1329,1259
28987,1,0,186,0,-186
28988,0,0,146,0,-146
28989,0,0,74,0,-74
28990,0,0,15,0,-15
28991,1,0,58,0,-58
28992,1,0,24,0,-24
28993,1,0,16,0,-16
28994,1,0,76,0,-76
28995,0,0,145,0,-145
28996,0,0,52,0,-52
28997,0,0,10,0,-10
28998,1,0,64,0,-64
28999,0,0,14,0,-14
